from,to,in_degree_from,in_degree_to,out_degree_from,out_degree_to,overall_degree_from,overall_degree_to,label
3260961,886206,288,545,7637,0,7925,545,1
1497278,4476719,1869,456,35111,0,36980,456,1
3561502,2835006,1144,615,68800,0,69944,615,1
1301602,4460340,2,3,408,0,410,3,1
748019,3035066,675,113,18480,0,19155,113,1
2405789,3525370,1010,83,93387,0,94397,83,1
703912,1495914,119,3,5153,0,5272,3,1
1250021,4552946,4637,11,85913,0,90550,11,1
1654099,4591592,1180,268,26347,0,27527,268,1
276216,4621510,312,19,12600,0,12912,19,1
932720,1343701,1411,19,111323,0,112734,19,1
1215626,418476,74,209,921,0,995,209,1
1135323,1586531,169,189,12240,0,12409,189,1
985610,4706421,109,81,2336,199,2445,280,1
1301815,3647360,752,3,48944,0,49696,3,1
4628096,2951354,219,76,5074,0,5293,76,1
4360960,630567,1642,85,110084,0,111726,85,1
765601,1487259,1485,53,101510,0,102995,53,1
307250,4459307,919,37,35588,0,36507,37,1
3387987,403862,268,14,19035,0,19303,14,1
462298,1955941,414,68,10933,0,11347,68,1
987626,3376319,238,92,1743,0,1981,92,1
2729885,2500918,79,5,1096,0,1175,5,1
687713,141751,436,1,47160,0,47596,1,1
159285,535092,240,37,4650,0,4890,37,1
1301815,2604378,752,35,48944,0,49696,35,1
3676295,1365589,374,1,70881,0,71255,1,1
427805,817733,483,1,156906,0,157389,1,1
4853234,2664356,1256,2,29554,0,30810,2,1
1533546,1635650,703,77,22095,0,22798,77,1
2827436,3662716,882,18,271525,0,272407,18,1
3509903,298874,1530,1,509445,0,510975,1,1
3942994,4392198,138,334,2039,0,2177,334,1
1039890,2518830,8,9,122,0,130,9,1
4417253,2708590,1130,27,68389,0,69519,27,1
448517,2206798,625,68,12450,0,13075,68,1
1497278,3636714,1869,2,35111,0,36980,2,1
2353951,1243960,29,2,164,0,193,2,1
378943,686846,340,893,12563,0,12903,893,1
3898535,2527667,59,79,9303,0,9362,79,1
3513476,1426579,24,45,1746,0,1770,45,1
2897926,4396370,565,10,25983,0,26548,10,1
4360960,4199019,1642,17,110084,0,111726,17,1
3841840,1927845,195,38,2931,0,3126,38,1
1527599,479393,176,29,3575,0,3751,29,1
1221958,4228929,51,314,1736,0,1787,314,1
4106142,2549160,306,298,3436,0,3742,298,1
85156,3389431,73,114,1273,0,1346,114,1
1163500,750653,398,269,9540,0,9938,269,1
1588705,2319186,1000,130,11879,0,12879,130,1
4836036,1387430,73,24,501,0,574,24,1
1785615,3845119,153,461,2575,28609,2728,29070,1
4183784,1272254,931,501,59894,0,60825,501,1
1541866,3142272,542,32,16481,0,17023,32,1
1121799,2052537,61,4,367,0,428,4,1
532681,82132,433,49,35023,0,35456,49,1
2375878,2616784,248,623,14925,0,15173,623,1
1086912,345889,907,29,33396,0,34303,29,1
781211,1303796,976,155,51781,0,52757,155,1
3889645,76128,89,45,186,234,275,279,1
3085744,4598624,125,118,345,2264,470,2382,1
1664044,4718619,150,15,1719,0,1869,15,1
817090,4684905,188,237,4245,0,4433,237,1
551730,4288281,25,8,1271,0,1296,8,1
805360,4651011,1514,6,119306,0,120820,6,1
2950311,1943014,807,10,85116,0,85923,10,1
2827436,509499,882,5,271525,0,272407,5,1
670587,3575518,651,6,9779,0,10430,6,1
4451491,1253056,817,63,8836,0,9653,63,1
3431613,882930,234,1,1959,0,2193,1,1
3352799,1890348,227,19,378,14,605,33,1
1103332,1163180,732,606,59415,5885,60147,6491,1
4615777,1105172,31,11,296,0,327,11,1
3361377,251253,4841,2,761793,0,766634,2,1
1588705,1647316,1000,42,11879,0,12879,42,1
1222206,8546,256,9,1387,0,1643,9,1
2522799,2768414,253,216,3062,80,3315,296,1
3633019,3913270,746,34,32317,0,33063,34,1
3361377,37299,4841,2,761793,0,766634,2,1
1117046,1894060,188,154,2115,0,2303,154,1
1123367,1173719,387,1,3721,0,4108,1,1
3361377,3234925,4841,89,761793,0,766634,89,1
765601,2155619,1485,38,101510,0,102995,38,1
2629632,316795,97,70,828,0,925,70,1
4777191,3562120,86,32,3938,0,4024,32,1
3280389,2968158,1101,5,411419,0,412520,5,1
2490914,839842,570,1,22965,0,23535,1,1
2950311,4738862,807,16,85116,0,85923,16,1
3914135,1554412,2152,54,60084,0,62236,54,1
3003173,1325540,111,8,1004,0,1115,8,1
2696500,4316830,267,42,4128,0,4395,42,1
3638272,3355703,2022,1,370904,0,372926,1,1
805258,1848053,167,114,2933,0,3100,114,1
4011264,4009148,1360,2,116777,0,118137,2,1
2668463,3137585,116,1196,1922,77354,2038,78550,1
1145179,1588330,50,694,133,10280,183,10974,1
817090,3025618,188,134,4245,0,4433,134,1
3137585,2561059,1196,139,77354,0,78550,139,1
111729,4209806,134,2,584,0,718,2,1
4680990,3773705,36,76,240,0,276,76,1
3509903,290979,1530,1,509445,0,510975,1,1
3676295,2886398,374,2,70881,0,71255,2,1
2882832,3533041,146,68,887,0,1033,68,1
573641,794602,253,10,5074,0,5327,10,1
1839283,3985852,765,62,36658,0,37423,62,1
3449530,1943538,717,64,73648,0,74365,64,1
4219126,2088360,60,114,1362,0,1422,114,1
4574571,3058267,186,125,6965,0,7151,125,1
4108836,2394976,97,335,4234,10973,4331,11308,1
2961801,2648084,1483,28,101962,0,103445,28,1
3509903,3190563,1530,19,509445,0,510975,19,1
733639,3036996,259,3,3744,0,4003,3,1
811214,1550553,176,4,675,0,851,4,1
380998,4199725,200,7,8943,0,9143,7,1
2405789,570487,1010,33,93387,0,94397,33,1
3676295,4853310,374,8,70881,0,71255,8,1
4180345,2772113,83,792,868,42907,951,43699,1
4333770,2246365,100,83,4077,0,4177,83,1
3930937,2728114,225,119,8777,0,9002,119,1
1580988,40066,2821,2,400133,0,402954,2,1
2075015,2587613,2664,45,85781,0,88445,45,1
2274892,2416627,24,104,579,0,603,104,1
1478080,1101894,593,150,7009,0,7602,150,1
4189798,991196,140,66,1874,0,2014,66,1
3280389,1810158,1101,1,411419,0,412520,1,1
841308,1918740,102,96,3967,0,4069,96,1
3278135,2426489,358,521,7252,2911,7610,3432,1
1234540,4745279,1071,117,75251,0,76322,117,1
3566847,1868559,155,121,1106,27,1261,148,1
3638272,1998212,2022,47,370904,586,372926,633,1
2968462,2887012,105,60,814,331,919,391,1
3229735,482139,283,601,1354,0,1637,601,1
3569179,2651177,1064,78,40015,0,41079,78,1
3844858,4730430,1591,57,28974,0,30565,57,1
1533546,2403993,703,3,22095,0,22798,3,1
2206273,1010682,235,35,4892,0,5127,35,1
3031851,2299632,84,30,291,0,375,30,1
2502456,3655613,719,46,50725,0,51444,46,1
755739,385706,1117,20,58043,0,59160,20,1
1534362,3235623,1531,33,105859,0,107390,33,1
3638272,3046802,2022,2,370904,0,372926,2,1
3072769,936451,187,48,3430,0,3617,48,1
3638272,1603045,2022,5,370904,0,372926,5,1
4209323,2253058,1630,17,89460,0,91090,17,1
2406672,393123,22,2,1754,0,1776,2,1
1225580,1001208,159,203,2943,0,3102,203,1
2516076,4359443,1455,3,77782,0,79237,3,1
4619326,1628057,539,343,22721,0,23260,343,1
1389617,4072026,482,29,2070,0,2552,29,1
4637355,2507284,150,22,1032,0,1182,22,1
3316788,4679642,20,100,1710,0,1730,100,1
1937293,1609804,434,1,16761,0,17195,1,1
3438576,3676150,3424,125,137753,7579,141177,7704,1
1968010,928476,786,95,10371,0,11157,95,1
4023687,2774170,69,1,7295,0,7364,1,1
2853969,1741339,1051,2,42591,0,43642,2,1
1560049,3697894,1121,85,12468,0,13589,85,1
4672596,1598357,107,56,3286,0,3393,56,1
2281658,4268239,38,1117,943,124,981,1241,1
2405789,811772,1010,9,93387,0,94397,9,1
2405789,3389546,1010,47,93387,0,94397,47,1
954784,4289249,567,1,14450,0,15017,1,1
2998026,342726,919,3,24182,0,25101,3,1
615890,4428958,239,320,2229,0,2468,320,1
4209323,1902115,1630,64,89460,0,91090,64,1
3262492,500365,113,32,387,0,500,32,1
3668051,3129302,89,16,3044,0,3133,16,1
2887240,963959,1143,1,118405,0,119548,1,1
2052930,3170365,407,15,8479,0,8886,15,1
3235479,2854284,999,80,66486,0,67485,80,1
3134846,2819729,69,143,5634,0,5703,143,1
4653941,4169680,951,2,45883,0,46834,2,1
1580988,1871567,2821,2,400133,0,402954,2,1
3294702,1046968,991,38,68888,0,69879,38,1
500752,553502,14,4,166,0,180,4,1
4782707,3247153,513,27,31665,0,32178,27,1
1575009,3950322,429,10,37745,0,38174,10,1
4653941,2627176,951,4,45883,0,46834,4,1
354788,4423435,203,1,5964,0,6167,1,1
2122741,2808028,190,168,6085,0,6275,168,1
3509903,4165071,1530,10,509445,0,510975,10,1
3644757,4729020,21,1,244,0,265,1,1
3065808,3429221,1235,15,82317,0,83552,15,1
2569009,4177920,424,34,13423,0,13847,34,1
681618,1912869,75,198,8789,0,8864,198,1
3914135,553720,2152,62,60084,0,62236,62,1
1580988,3678069,2821,1,400133,0,402954,1,1
1341178,2355727,899,154,16829,0,17728,154,1
1031334,4070033,459,1,16840,0,17299,1,1
3280389,1242266,1101,1,411419,0,412520,1,1
2891522,2385930,18,7,75,0,93,7,1
427805,1340854,483,1,156906,0,157389,1,1
318090,1879576,74,25,1957,0,2031,25,1
3610598,3753334,380,115,17343,0,17723,115,1
2403192,3088656,163,128,5302,0,5465,128,1
4258870,3139463,336,21,4963,0,5299,21,1
1901834,2410198,32,4,289,0,321,4,1
2148937,978783,672,2,47361,0,48033,2,1
3449337,2866572,34,2,1668,0,1702,2,1
427805,507409,483,1,156906,0,157389,1,1
4443577,3126851,509,73,11936,0,12445,73,1
1331940,509380,802,127,32617,0,33419,127,1
4272102,2588809,1608,18,104171,0,105779,18,1
2822651,3951791,25,1,3794,0,3819,1,1
3280389,4189582,1101,2,411419,0,412520,2,1
3954325,4549877,1743,22,16616,0,18359,22,1
501914,4494271,217,249,5217,0,5434,249,1
3065808,3198896,1235,157,82317,1397,83552,1554,1
2439199,1126233,631,67,5929,0,6560,67,1
3509903,4285163,1530,2,509445,0,510975,2,1
4527062,2707789,12,56,478,0,490,56,1
4272102,4706387,1608,63,104171,0,105779,63,1
226540,1670840,463,23,10650,0,11113,23,1
3509903,2922784,1530,2,509445,0,510975,2,1
3257465,988618,541,2,27614,0,28155,2,1
3361377,2600814,4841,7,761793,0,766634,7,1
1934836,4721796,284,38,2471,0,2755,38,1
354904,152540,3193,8,105780,0,108973,8,1
1580988,1983593,2821,1,400133,0,402954,1,1
646587,4534501,122,297,5819,0,5941,297,1
635909,1556400,179,16,6949,0,7128,16,1
3844858,4840802,1591,40,28974,0,30565,40,1
2853969,874646,1051,2,42591,0,43642,2,1
4762830,4835980,1043,19,2352,0,3395,19,1
915390,1534088,1345,2,5262,0,6607,2,1
2641557,186349,154,4,1750,0,1904,4,1
4492248,2490898,237,58,17127,0,17364,58,1
551730,2148937,25,672,1271,47361,1296,48033,1
2827436,4736069,882,2,271525,0,272407,2,1
3201367,3304867,260,217,1742,1983,2002,2200,1
3280389,625135,1101,1,411419,0,412520,1,1
4191410,1359076,1590,96,96434,0,98024,96,1
3946789,135766,261,9,5606,0,5867,9,1
4828511,1924385,113,1,2641,0,2754,1,1
2527654,1318079,39,30,1740,0,1779,30,1
988087,3846486,322,448,3765,0,4087,448,1
1774382,3227883,111,25,501,0,612,25,1
2893334,789349,889,65,30148,0,31037,65,1
4582129,537618,1231,7,10356,0,11587,7,1
3361377,1959551,4841,2,761793,0,766634,2,1
3854592,2213172,108,5,3483,0,3591,5,1
3672238,3183555,518,90,12172,0,12690,90,1
755739,891714,1117,58,58043,0,59160,58,1
4314280,4560190,568,1,9552,0,10120,1,1
3280389,936523,1101,1,411419,0,412520,1,1
1733957,2261953,554,115,15185,0,15739,115,1
2595727,4041270,125,125,1928,211,2053,336,1
2950311,2929358,807,720,85116,0,85923,720,1
3478545,4308096,72,197,572,0,644,197,1
445996,205549,1175,2,12828,0,14003,2,1
4417253,605874,1130,145,68389,3312,69519,3457,1
6618,2699578,892,86,68849,0,69741,86,1
3509903,442401,1530,8,509445,0,510975,8,1
2429949,1506213,27,47,293,0,320,47,1
4532707,699875,214,8,956,0,1170,8,1
2704966,2401410,139,10,560,0,699,10,1
2281149,184509,282,70,28082,0,28364,70,1
55855,4044880,245,88,5888,0,6133,88,1
665164,3995559,396,239,12610,0,13006,239,1
3280389,3062224,1101,2,411419,0,412520,2,1
1588705,3328761,1000,55,11879,0,12879,55,1
1330432,4472110,12,84,1926,0,1938,84,1
3127090,3444777,678,9,10017,0,10695,9,1
2361966,112765,149,25,1585,0,1734,25,1
1794526,1156464,169,100,1730,0,1899,100,1
3245012,4436269,8,11,301,0,309,11,1
3104095,1777363,16,1,742,0,758,1,1
2723674,1995058,134,128,558,0,692,128,1
2827436,1899503,882,2,271525,0,272407,2,1
1930227,4249983,90,679,400,16076,490,16755,1
3361377,2941160,4841,3,761793,0,766634,3,1
3509903,802700,1530,1,509445,0,510975,1,1
4708835,1134905,190,6,7539,0,7729,6,1
3115867,2472748,1350,28,61232,0,62582,28,1
1494665,3243872,668,57,37638,0,38306,57,1
1199507,3387761,38,1,242,0,280,1,1
6618,3317523,892,2,68849,0,69741,2,1
1558355,2568727,51,39,73,156,124,195,1
1560049,4551372,1121,7,12468,0,13589,7,1
1580988,3429078,2821,234,400133,0,402954,234,1
3361377,3616284,4841,48,761793,0,766634,48,1
3764177,2387567,1036,22,64563,0,65599,22,1
1580988,806090,2821,3,400133,0,402954,3,1
898068,4715972,138,247,3174,0,3312,247,1
3509214,2479787,263,33,14139,0,14402,33,1
3638272,2167454,2022,6,370904,0,372926,6,1
1560049,112973,1121,39,12468,0,13589,39,1
3881566,688982,781,110,14176,0,14957,110,1
3764177,3572839,1036,12,64563,0,65599,12,1
370123,1772721,110,64,7231,0,7341,64,1
1431189,4737139,167,47,3075,0,3242,47,1
932720,4588597,1411,79,111323,0,112734,79,1
1151593,2710449,231,8,5501,0,5732,8,1
3360582,411892,132,390,1119,0,1251,390,1
3169031,1958259,74,1,3887,0,3961,1,1
2464401,507299,577,423,23681,0,24258,423,1
3361377,2464227,4841,3,761793,0,766634,3,1
3815269,4380838,213,86,7440,0,7653,86,1
201249,2711703,323,130,621,406,944,536,1
2790006,2716050,367,47,14747,0,15114,47,1
866357,4657857,825,60,18479,0,19304,60,1
4395121,4691664,37,111,551,0,588,111,1
3638272,3941191,2022,1,370904,0,372926,1,1
3280389,1298622,1101,1,411419,0,412520,1,1
3280389,4487084,1101,3,411419,0,412520,3,1
4099305,3803209,118,103,5174,0,5292,103,1
1887709,3682912,217,23,28983,0,29200,23,1
4400969,368018,33,69,1123,0,1156,69,1
1339664,3388130,228,81,6682,0,6910,81,1
633851,2950557,6,499,72,199,78,698,1
4330391,272501,773,202,32759,0,33532,202,1
1633022,3028722,246,1,23530,0,23776,1,1
933859,963360,206,23,1051,0,1257,23,1
3361377,4617376,4841,1,761793,0,766634,1,1
2911269,1017318,740,91,20606,0,21346,91,1
3065808,1883793,1235,43,82317,0,83552,43,1
755739,4604786,1117,31,58043,0,59160,31,1
2862203,1784911,290,380,506,0,796,380,1
2781817,3715361,704,28,24613,0,25317,28,1
3936039,741268,799,44,23884,0,24683,44,1
4220190,533975,320,36,15994,0,16314,36,1
427805,4643081,483,1,156906,0,157389,1,1
3638272,3260776,2022,1,370904,0,372926,1,1
1071094,3056533,31,1117,203,25,234,1142,1
2851109,594561,450,2,98552,0,99002,2,1
3128197,2356028,122,242,6176,0,6298,242,1
3054732,1045016,310,46,4246,0,4556,46,1
3933095,301627,304,10,2162,0,2466,10,1
4738916,1285895,1165,2,34124,0,35289,2,1
932720,1480051,1411,14,111323,0,112734,14,1
3638272,2060913,2022,1,370904,0,372926,1,1
2779329,1366176,217,98,6021,0,6238,98,1
1713569,4227428,56,8,265,0,321,8,1
3280389,3241008,1101,3,411419,0,412520,3,1
2198338,3401331,72,20,826,0,898,20,1
3638272,1827747,2022,4,370904,0,372926,4,1
2260014,3935649,2466,2,98622,0,101088,2,1
2783132,1288562,13,11,258,0,271,11,1
815493,3918501,152,14,444,0,596,14,1
1580988,2308597,2821,15,400133,0,402954,15,1
2772113,525667,792,31,42907,0,43699,31,1
3509903,2633831,1530,3,509445,0,510975,3,1
4198771,528326,207,2,8543,0,8750,2,1
1475591,240363,178,2,3828,0,4006,2,1
2040859,786175,14,16,139,0,153,16,1
919120,2048936,205,87,2831,0,3036,87,1
378943,1549597,340,103,12563,0,12903,103,1
2490914,4265021,570,42,22965,0,23535,42,1
4208653,1456205,1820,8,21104,0,22924,8,1
3914135,3101416,2152,100,60084,0,62236,100,1
1927211,634001,1668,13,113322,0,114990,13,1
3540105,1450321,83,2,4179,0,4262,2,1
6618,3555419,892,645,68849,0,69741,645,1
532681,456889,433,41,35023,0,35456,41,1
2999451,4718005,227,2,107,0,334,2,1
4198771,1514529,207,41,8543,0,8750,41,1
4604311,4314515,29,1,7472,0,7501,1,1
3361377,2074763,4841,1,761793,0,766634,1,1
3280389,3456103,1101,2,411419,0,412520,2,1
1926857,3832364,20,1353,195,0,215,1353,1
4642569,1052032,872,72,27586,0,28458,72,1
3638272,440797,2022,2,370904,0,372926,2,1
1723506,4521813,733,69,21835,0,22568,69,1
1903752,213636,506,59,10494,0,11000,59,1
2494898,969900,58,18,551,0,609,18,1
4295952,4649289,808,516,57369,0,58177,516,1
3914135,2071013,2152,4,60084,0,62236,4,1
269982,3764661,351,374,9019,0,9370,374,1
2981537,4490031,1252,4,118718,0,119970,4,1
3676295,4571120,374,6,70881,0,71255,6,1
2856484,2094118,48,340,202,0,250,340,1
2827436,4487455,882,1,271525,0,272407,1,1
4612316,3247441,9,86,84,0,93,86,1
3214227,1234130,27,71,1890,0,1917,71,1
1927211,1516250,1668,63,113322,0,114990,63,1
4238001,3401659,869,40,61161,0,62030,40,1
3361377,4824704,4841,1,761793,0,766634,1,1
354904,3814128,3193,1,105780,0,108973,1,1
2772113,4058678,792,34,42907,0,43699,34,1
3280389,3338329,1101,1,411419,0,412520,1,1
1847461,3479808,1211,140,51149,0,52360,140,1
2536472,4641161,344,2,9725,0,10069,2,1
3361377,989676,4841,51,761793,0,766634,51,1
151693,119001,436,17,12181,0,12617,17,1
3211788,3769579,92,23,675,0,767,23,1
748019,1779071,675,9,18480,0,19155,9,1
3906136,837084,387,5,41169,0,41556,5,1
3280389,1922204,1101,1,411419,0,412520,1,1
2887240,2492156,1143,9,118405,0,119548,9,1
4503880,2982350,72,59,1028,0,1100,59,1
3610143,4496464,187,105,1057,193,1244,298,1
2659272,3311544,28,32,183,0,211,32,1
2518926,518809,9,3,305,0,314,3,1
2851109,2593733,450,3,98552,0,99002,3,1
2147720,1758006,1608,100,78786,0,80394,100,1
948375,1443939,113,33,4186,0,4299,33,1
1103332,857635,732,145,59415,0,60147,145,1
3881634,411313,641,6,8471,0,9112,6,1
2075015,4005333,2664,77,85781,0,88445,77,1
3638272,2626993,2022,1,370904,0,372926,1,1
1391852,431517,83,9,549,0,632,9,1
3654066,1982379,8,8,42,0,50,8,1
2969895,3553299,103,1,734,0,837,1,1
3584971,869439,22,2,416,0,438,2,1
501914,4554696,217,364,5217,0,5434,364,1
1580988,3811666,2821,2,400133,0,402954,2,1
3638272,1898912,2022,1,370904,0,372926,1,1
2911269,1009793,740,204,20606,0,21346,204,1
1580988,50617,2821,8,400133,0,402954,8,1
3115867,2552883,1350,28,61232,0,62582,28,1
1621606,250475,559,40,4228,0,4787,40,1
2866109,2106513,26,2,372,0,398,2,1
3060030,660795,81,34,1508,0,1589,34,1
781211,1360850,976,189,51781,0,52757,189,1
1493489,2971054,523,41,17512,0,18035,41,1
4838376,3617474,606,320,26838,0,27444,320,1
4210063,1975281,68,3,575,0,643,3,1
530200,781371,2035,1,62809,0,64844,1,1
1539837,74744,1127,125,62979,0,64106,125,1
1847461,3446647,1211,84,51149,0,52360,84,1
3052059,4173523,164,21,1173,171,1337,192,1
4208653,1028990,1820,5,21104,0,22924,5,1
750999,3380947,400,526,176,367,576,893,1
3449530,1234064,717,18,73648,0,74365,18,1
3842148,3860541,719,34,11430,0,12149,34,1
3509903,1575915,1530,3,509445,0,510975,3,1
17330,633257,154,59,972,0,1126,59,1
1250021,3432463,4637,8,85913,0,90550,8,1
1792979,905894,76,268,1075,1162,1151,1430,1
3837587,2296266,30,262,409,0,439,262,1
3922194,1524033,175,557,1847,0,2022,557,1
1117046,2163804,188,25,2115,0,2303,25,1
3361377,2843896,4841,1,761793,0,766634,1,1
1580988,1936404,2821,1,400133,0,402954,1,1
1190415,2070980,54,140,719,73,773,213,1
4301252,3677457,118,34,2905,0,3023,34,1
4330391,3315294,773,98,32759,0,33532,98,1
932720,2628324,1411,17,111323,0,112734,17,1
3676295,4311530,374,1,70881,0,71255,1,1
1792816,2499514,246,31,1522,0,1768,31,1
2514271,837904,387,32,19070,0,19457,32,1
2897926,2162817,565,74,25983,0,26548,74,1
4636168,4765802,215,242,1967,0,2182,242,1
4002395,719051,62,13,416,0,478,13,1
2405789,994161,1010,134,93387,0,94397,134,1
2998026,3363329,919,15,24182,0,25101,15,1
1960138,2270766,181,21,722,0,903,21,1
873006,845215,375,23,33630,0,34005,23,1
494210,2888600,26,1,1024,0,1050,1,1
2827436,1716434,882,14,271525,0,272407,14,1
3385289,3886125,648,487,7232,0,7880,487,1
2856965,2232013,23,9,892,0,915,9,1
2883055,3586956,286,2,13198,0,13484,2,1
3225310,4197964,320,108,10537,0,10857,108,1
3361377,148363,4841,2,761793,0,766634,2,1
3361377,934822,4841,1,761793,0,766634,1,1
4698411,3835328,85,45,388,0,473,45,1
3759853,1173891,451,71,16330,0,16781,71,1
1084944,2037402,119,44,282,0,401,44,1
1475591,155065,178,74,3828,0,4006,74,1
905729,996045,57,134,238,0,295,134,1
3428306,824048,103,2,2173,0,2276,2,1
1534362,58954,1531,26,105859,0,107390,26,1
3683235,1161284,311,9,23110,0,23421,9,1
4838376,2849533,606,310,26838,0,27444,310,1
3836080,4609649,1197,76,59457,0,60654,76,1
1047192,2261050,90,5,131,0,221,5,1
755739,1725796,1117,30,58043,0,59160,30,1
1927211,164547,1668,39,113322,0,114990,39,1
4649206,4779119,566,38,31367,0,31933,38,1
4272102,4266749,1608,7,104171,0,105779,7,1
484672,2554448,276,32,1985,0,2261,32,1
427805,987595,483,1,156906,0,157389,1,1
4255252,3029199,176,967,991,0,1167,967,1
515290,4748953,285,94,34080,0,34365,94,1
4385783,3973842,290,19,10995,0,11285,19,1
393185,3260238,591,86,7719,0,8310,86,1
661744,1293953,35,101,145,0,180,101,1
1318501,4037466,117,151,1335,0,1452,151,1
4011264,1602318,1360,20,116777,0,118137,20,1
1638027,1462500,60,760,422,0,482,760,1
1580988,1116526,2821,2,400133,0,402954,2,1
2853969,3487419,1051,97,42591,0,43642,97,1
4238001,2762826,869,14,61161,0,62030,14,1
3088808,9452,227,34,7820,0,8047,34,1
3509903,2400482,1530,21,509445,0,510975,21,1
4744892,3413134,340,873,353,501,693,1374,1
2751572,213380,481,2,44036,0,44517,2,1
3979742,2458622,9,6,86,0,95,6,1
2088561,2105745,20,27,908,0,928,27,1
755739,3930611,1117,333,58043,0,59160,333,1
4209323,2880500,1630,16,89460,0,91090,16,1
3509903,3701613,1530,2,509445,0,510975,2,1
3509903,1509297,1530,1,509445,0,510975,1,1
1968010,2842285,786,155,10371,0,11157,155,1
855906,3793452,81,129,995,0,1076,129,1
805360,3453690,1514,45,119306,0,120820,45,1
3633019,98881,746,16,32317,0,33063,16,1
4360960,3475011,1642,14,110084,0,111726,14,1
4579906,1064609,90,894,1938,0,2028,894,1
4290840,1650297,118,155,661,416,779,571,1
2260014,2615778,2466,9,98622,0,101088,9,1
863643,1699751,517,18,1804,0,2321,18,1
2439199,1803520,631,71,5929,0,6560,71,1
3509214,1246081,263,1,14139,0,14402,1,1
1178312,4776325,1213,405,2028,0,3241,405,1
581535,4167969,1283,1,8414,0,9697,1,1
1580988,3286833,2821,1,400133,0,402954,1,1
3633019,2710110,746,131,32317,0,33063,131,1
2513691,4220524,244,13,17485,0,17729,13,1
3441019,3117551,68,801,628,75,696,876,1
3980505,1906654,255,141,6464,0,6719,141,1
3509903,3693856,1530,2,509445,0,510975,2,1
1575009,4453755,429,1,37745,0,38174,1,1
3438576,190239,3424,6,137753,0,141177,6,1
1608466,2336155,18,1,178,0,196,1,1
375387,626037,29,33,293,0,322,33,1
3361377,2466118,4841,1,761793,0,766634,1,1
522588,4803975,496,2,20091,0,20587,2,1
2516076,1262812,1455,163,77782,0,79237,163,1
3457745,4203615,219,46,1864,0,2083,46,1
3803324,2589752,2,675,191,0,193,675,1
1086912,4255252,907,176,33396,991,34303,1167,1
1943259,3912972,78,4,1765,0,1843,4,1
4417253,4762680,1130,54,68389,0,69519,54,1
3557565,3821868,143,22,717,0,860,22,1
2147720,4066509,1608,20,78786,0,80394,20,1
530200,4337603,2035,333,62809,9909,64844,10242,1
4596817,79048,160,76,1879,267,2039,343,1
860473,3400746,751,1,20450,0,21201,1,1
4313572,1243007,930,142,16971,1185,17901,1327,1
2851109,4137440,450,3,98552,0,99002,3,1
4191410,4713595,1590,64,96434,0,98024,64,1
3137585,1781364,1196,32,77354,0,78550,32,1
2961552,2245947,562,267,16546,0,17108,267,1
920553,2574251,349,146,8968,0,9317,146,1
2028435,34966,157,62,4516,0,4673,62,1
3947176,854836,9,38,146,0,155,38,1
3361377,2847990,4841,1,761793,0,766634,1,1
3280389,4566256,1101,2,411419,0,412520,2,1
1717922,451569,432,255,6340,0,6772,255,1
1471685,522316,1681,16,25550,0,27231,16,1
2911269,4115546,740,144,20606,0,21346,144,1
2209136,2437871,620,33,33789,0,34409,33,1
2521113,3353305,67,31,985,0,1052,31,1
4110535,1772559,395,40,7311,0,7706,40,1
3509903,3952554,1530,5,509445,0,510975,5,1
3638272,3187878,2022,184,370904,0,372926,184,1
2950311,432202,807,62,85116,0,85923,62,1
544230,311403,1532,8,60768,0,62300,8,1
1962884,3899424,404,10,3358,0,3762,10,1
108486,4137283,225,80,3045,0,3270,80,1
3102873,3804998,341,4,15098,0,15439,4,1
3280389,3365039,1101,6,411419,0,412520,6,1
2516076,4647375,1455,7,77782,0,79237,7,1
4360960,2332423,1642,22,110084,0,111726,22,1
837553,1531445,1249,106,61665,0,62914,106,1
4014826,107981,244,8,288,0,532,8,1
495630,1879968,4,16,36,0,40,16,1
3387402,4751300,137,1,307,0,444,1,1
625391,72816,44,106,558,393,602,499,1
4099624,2476585,129,77,734,0,863,77,1
3676150,2590223,125,40,7579,0,7704,40,1
4816740,1982497,141,34,7750,0,7891,34,1
2148937,1750528,672,1,47361,0,48033,1,1
3438576,1090126,3424,109,137753,0,141177,109,1
4751453,101694,520,45,27570,0,28090,45,1
1501723,2518731,21,116,58,384,79,500,1
2426529,1093743,58,9,196,0,254,9,1
2405789,1344160,1010,25,93387,0,94397,25,1
454446,1077696,103,159,624,0,727,159,1
948768,844546,587,10,14768,0,15355,10,1
805360,3984246,1514,67,119306,0,120820,67,1
593740,3305655,1107,88,62807,0,63914,88,1
4528103,4267965,268,31,14258,0,14526,31,1
153377,279412,154,7,589,0,743,7,1
2173241,343833,708,624,430,1274,1138,1898,1
4297315,692427,195,72,7446,0,7641,72,1
1580988,4818168,2821,1,400133,0,402954,1,1
2887240,2196735,1143,1,118405,0,119548,1,1
2961801,4264758,1483,24,101962,0,103445,24,1
1580988,4375456,2821,4,400133,0,402954,4,1
966267,2640228,39,1,637,0,676,1,1
3638272,386567,2022,1,370904,0,372926,1,1
2260014,3984342,2466,5,98622,0,101088,5,1
2405789,3155183,1010,3,93387,0,94397,3,1
3150561,2583328,157,4,2631,0,2788,4,1
2962038,1509224,495,6,14236,0,14731,6,1
4111807,2096270,57,970,216,26018,273,26988,1
4780428,956312,94,65,2777,0,2871,65,1
765601,3764766,1485,47,101510,0,102995,47,1
2109216,4053059,386,74,4712,831,5098,905,1
3764177,1575960,1036,225,64563,0,65599,225,1
3235479,3525700,999,156,66486,0,67485,156,1
1984622,66317,145,2,20659,0,20804,2,1
2827436,2301401,882,1,271525,0,272407,1,1
1503116,4835069,415,5,37079,0,37494,5,1
408965,3277287,903,60,38623,0,39526,60,1
354904,3984302,3193,85,105780,0,108973,85,1
3140664,3074289,268,22,16099,0,16367,22,1
4440160,4450944,736,12,20522,0,21258,12,1
3280389,3417733,1101,1,411419,0,412520,1,1
1039932,1628133,147,21,813,70,960,91,1
1887669,3960069,733,57,23145,0,23878,57,1
3449530,1739059,717,42,73648,0,74365,42,1
2631627,4208653,183,1820,3743,21104,3926,22924,1
3765475,4559108,873,31,107914,0,108787,31,1
2307868,4845257,1131,160,38777,0,39908,160,1
3632293,4185458,570,126,21294,0,21864,126,1
3361377,4862590,4841,1,761793,0,766634,1,1
2314038,4215374,456,51,16347,0,16803,51,1
3423256,2522322,289,60,2138,0,2427,60,1
1497278,2952205,1869,8,35111,0,36980,8,1
917130,4623385,325,1,7017,0,7342,1,1
4488849,1509778,136,64,4704,0,4840,64,1
4552666,3597973,341,225,9279,0,9620,225,1
207864,1898217,252,17,3646,0,3898,17,1
2950311,702070,807,24,85116,0,85923,24,1
4751453,2657474,520,10,27570,0,28090,10,1
2751572,2630819,481,263,44036,0,44517,263,1
354904,3008963,3193,2,105780,0,108973,2,1
4101514,618436,511,118,1676,0,2187,118,1
4460693,4145196,403,3,2596,0,2999,3,1
978341,802741,604,428,10065,0,10669,428,1
3509903,4302334,1530,1,509445,0,510975,1,1
792037,715979,57,1,16445,0,16502,1,1
3280389,1518291,1101,2,411419,0,412520,2,1
1580988,2558938,2821,2,400133,0,402954,2,1
4140712,3600593,106,2,235,0,341,2,1
401282,189895,21,2,911,0,932,2,1
429643,3092352,767,195,19668,0,20435,195,1
1628647,481221,200,4,181,0,381,4,1
2369849,336665,298,40,371,0,669,40,1
3019092,2880763,108,9,8595,0,8703,9,1
2304515,871042,27,29,925,0,952,29,1
4755188,4676809,75,64,1893,0,1968,64,1
1486758,2318311,337,31,11346,0,11683,31,1
4737522,205217,111,3,939,0,1050,3,1
1534362,3098046,1531,60,105859,0,107390,60,1
3540753,1253300,140,4,1499,0,1639,4,1
1913445,2288459,564,10,47943,0,48507,10,1
17308,3103972,11,3,170,0,181,3,1
1839283,1721676,765,1,36658,0,37423,1,1
2031305,982340,396,41,23435,0,23831,41,1
1062967,335885,260,1,15276,0,15536,1,1
4784674,4346490,57,4,432,0,489,4,1
2627841,2465901,418,15,12342,0,12760,15,1
1486758,4081348,337,21,11346,0,11683,21,1
3346033,2780885,320,114,9541,0,9861,114,1
2516076,2142122,1455,24,77782,0,79237,24,1
2470160,521265,103,20,4362,0,4465,20,1
4320056,194090,56,46,1873,0,1929,46,1
3438576,763418,3424,3,137753,0,141177,3,1
1615261,114921,955,129,12715,0,13670,129,1
4624595,3569218,722,36,53368,0,54090,36,1
628258,1806281,155,27,4650,0,4805,27,1
1356415,3216789,40,44,521,0,561,44,1
3708922,3345323,42,11,1414,0,1456,11,1
3914135,1304928,2152,80,60084,0,62236,80,1
819769,356129,43,1,194,0,237,1,1
3873768,1382971,449,24,35424,0,35873,24,1
3960049,3571568,140,10,2418,0,2558,10,1
4708541,2275899,981,293,15678,0,16659,293,1
3638272,2640115,2022,4,370904,0,372926,4,1
93533,4280254,64,52,310,0,374,52,1
837553,3621085,1249,154,61665,0,62914,154,1
772649,4381900,19,117,116,445,135,562,1
4191410,740731,1590,18,96434,0,98024,18,1
1022123,2346260,126,6,8212,0,8338,6,1
4360960,3509931,1642,4,110084,0,111726,4,1
3449530,1087106,717,18,73648,0,74365,18,1
2958239,836684,101,1,3638,0,3739,1,1
4208653,1037268,1820,5,21104,0,22924,5,1
2861639,1057425,481,110,10848,0,11329,110,1
3215649,3547186,106,69,1393,0,1499,69,1
3031712,1545036,6,254,30,47,36,301,1
483251,2736898,154,2,5257,0,5411,2,1
1554762,3683401,24,974,184,0,208,974,1
675623,4356778,50,84,760,0,810,84,1
1819017,2597521,46,9,762,0,808,9,1
4586218,4701094,47,23,444,0,491,23,1
3175944,2576528,324,88,7415,0,7739,88,1
1534362,3180044,1531,26,105859,0,107390,26,1
3280389,3101905,1101,5,411419,0,412520,5,1
3870376,4309578,195,102,511,1066,706,1168,1
3280389,2003733,1101,3,411419,0,412520,3,1
392779,2295441,148,1,2136,0,2284,1,1
939769,3798245,132,178,385,0,517,178,1
3912913,3590546,65,411,514,382,579,793,1
2308819,4019970,141,62,5491,0,5632,62,1
1140134,2851717,311,5,11111,0,11422,5,1
3765475,283898,873,112,107914,0,108787,112,1
860473,561541,751,192,20450,728,21201,920,1
595757,3361480,340,87,26738,0,27078,87,1
3638272,242980,2022,5,370904,0,372926,5,1
3170292,4260711,75,20,651,0,726,20,1
1549445,2832992,138,262,1227,0,1365,262,1
2885394,4414667,174,43,3481,0,3655,43,1
4731722,3971694,151,3,1196,0,1347,3,1
3246724,252083,194,6,669,0,863,6,1
4272102,3187394,1608,27,104171,0,105779,27,1
2101710,2407081,152,19,6934,0,7086,19,1
3906136,238837,387,75,41169,0,41556,75,1
3361377,1018368,4841,1,761793,0,766634,1,1
873006,1114331,375,77,33630,0,34005,77,1
2490914,874176,570,79,22965,0,23535,79,1
3765475,599048,873,2,107914,0,108787,2,1
3257653,2477789,100,1,5222,0,5322,1,1
681618,682279,75,1,8789,0,8864,1,1
1465606,4050852,14,97,296,0,310,97,1
1847461,1097108,1211,10,51149,0,52360,10,1
3509903,4220197,1530,1,509445,0,510975,1,1
1276253,3395024,407,1,46534,0,46941,1,1
317253,2364030,27,4,97,0,124,4,1
883775,1968010,202,786,2409,10371,2611,11157,1
837553,352718,1249,19,61665,0,62914,19,1
4384375,3062850,129,88,4747,0,4876,88,1
3117421,800729,64,21,162,0,226,21,1
4272102,412028,1608,27,104171,0,105779,27,1
3509903,3169450,1530,1,509445,0,510975,1,1
4247115,888434,26,5,102,0,128,5,1
3561502,212688,1144,12,68800,0,69944,12,1
315254,4741445,99,110,3983,0,4082,110,1
2893353,2105844,204,1,1051,0,1255,1,1
3280389,1575084,1101,9,411419,0,412520,9,1
3676295,1078153,374,1,70881,0,71255,1,1
427805,2307508,483,1,156906,0,157389,1,1
3705070,665845,740,3,14938,0,15678,3,1
755739,473979,1117,28,58043,0,59160,28,1
781211,3407528,976,36,51781,0,52757,36,1
4191410,3236285,1590,25,96434,0,98024,25,1
3058068,3449832,124,1,12734,0,12858,1,1
1120955,580501,13,1,989,0,1002,1,1
4624595,2416073,722,33,53368,0,54090,33,1
4417253,2521169,1130,28,68389,0,69519,28,1
4119493,2477373,80,645,4077,0,4157,645,1
3065808,825265,1235,36,82317,0,83552,36,1
530200,3338779,2035,58,62809,0,64844,58,1
1580988,1783565,2821,7,400133,0,402954,7,1
998622,2738905,66,2,792,0,858,2,1
8722,4177549,210,19,1258,0,1468,19,1
805360,4596927,1514,208,119306,0,120820,208,1
2405789,3355992,1010,17,93387,0,94397,17,1
4167572,1349461,81,3,6924,0,7005,3,1
2107861,3535653,535,2,25743,0,26278,2,1
4636168,2248340,215,114,1967,0,2182,114,1
1629019,1098678,351,189,5823,0,6174,189,1
2543703,430884,75,19,1037,0,1112,19,1
4496752,4392224,554,16,16258,0,16812,16,1
4417253,1813107,1130,25,68389,0,69519,25,1
4077365,443303,122,5,301,0,423,5,1
2280871,372659,11,54,156,0,167,54,1
765601,146567,1485,52,101510,0,102995,52,1
2671123,3803478,148,7,2053,0,2201,7,1
3638272,3226082,2022,1,370904,0,372926,1,1
4191410,1297455,1590,73,96434,0,98024,73,1
1545237,1020925,381,204,14327,3339,14708,3543,1
4011264,1343492,1360,18,116777,0,118137,18,1
3764177,1924257,1036,19,64563,0,65599,19,1
1063358,1447138,1350,55,63494,0,64844,55,1
4198409,57315,36,30,302,0,338,30,1
4411870,4187980,948,69,60517,0,61465,69,1
4777127,4848968,53,8,2347,0,2400,8,1
276216,4353205,312,76,12600,0,12912,76,1
4838376,1988359,606,106,26838,0,27444,106,1
4519069,1637344,387,14,20799,0,21186,14,1
946854,2565312,22,3,2951,0,2973,3,1
1455058,3438576,129,3424,3856,137753,3985,141177,1
2120963,4720001,136,1,1318,0,1454,1,1
1653998,1692929,24,41,1986,0,2010,41,1
837553,4697252,1249,114,61665,0,62914,114,1
2981537,3068627,1252,2,118718,0,119970,2,1
3671141,1423048,1444,17,48400,0,49844,17,1
4649206,4384424,566,73,31367,0,31933,73,1
2208689,1087776,298,51,4017,0,4315,51,1
2494800,3084665,752,194,5329,0,6081,194,1
408965,1150043,903,23,38623,0,39526,23,1
4140712,648031,106,7,235,108,341,115,1
2853969,2899345,1051,7,42591,0,43642,7,1
3500268,1568369,45,3,257,0,302,3,1
439557,2085865,2090,21,61744,0,63834,21,1
4043108,3181183,77,22,2001,0,2078,22,1
708440,1621731,302,319,9329,0,9631,319,1
1185597,2163284,64,43,1501,0,1565,43,1
3742930,2372389,410,6,22242,0,22652,6,1
3509214,1194428,263,100,14139,0,14402,100,1
3361377,1919384,4841,6,761793,0,766634,6,1
4662055,2638573,155,332,2918,1538,3073,1870,1
4209323,2790606,1630,23,89460,0,91090,23,1
2482338,3251624,712,810,24222,0,24934,810,1
3361377,722953,4841,226,761793,0,766634,226,1
502082,2416352,589,60,16428,0,17017,60,1
957197,2146121,614,18,37109,0,37723,18,1
424769,4014626,50,5,435,0,485,5,1
4411870,3329925,948,44,60517,0,61465,44,1
3075692,1369137,327,294,1182,0,1509,294,1
2055544,3428313,141,35,2577,0,2718,35,1
4680723,2113324,69,7,961,0,1030,7,1
2905501,711963,95,33,256,0,351,33,1
3765475,405450,873,2,107914,0,108787,2,1
3764177,3180228,1036,42,64563,0,65599,42,1
3911304,3121295,87,1277,982,0,1069,1277,1
1533314,1296546,361,64,6007,0,6368,64,1
4619326,717761,539,154,22721,0,23260,154,1
1898822,1109800,114,158,3885,0,3999,158,1
4193534,1221174,82,1,6961,0,7043,1,1
573101,1871999,781,314,12750,0,13531,314,1
3836080,3891319,1197,4,59457,0,60654,4,1
2375878,1959271,248,2,14925,0,15173,2,1
1148799,2448174,275,72,1325,0,1600,72,1
1580988,2307462,2821,2,400133,0,402954,2,1
3765475,3717354,873,95,107914,0,108787,95,1
3501270,4178778,214,38,2145,0,2359,38,1
1418431,4805935,24,1,190,0,214,1,1
471706,1730144,794,2,65616,0,66410,2,1
2348093,4326311,335,243,12064,0,12399,243,1
2784572,4854126,69,351,3478,0,3547,351,1
3973293,4662055,325,155,2788,2918,3113,3073,1
3472081,158808,79,57,227,0,306,57,1
1500491,3809951,78,91,1369,0,1447,91,1
3361377,408175,4841,3,761793,0,766634,3,1
67996,4143597,39,35,374,0,413,35,1
3824547,4695138,1075,7,14337,0,15412,7,1
3638272,1101358,2022,141,370904,0,372926,141,1
4176284,2916996,192,73,342,0,534,73,1
3144238,4336536,326,394,28455,0,28781,394,1
2998026,2469184,919,47,24182,0,25101,47,1
2109919,146264,46,1,5772,0,5818,1,1
1462592,1220125,80,8,1198,0,1278,8,1
4738916,4622554,1165,15,34124,0,35289,15,1
3992144,337699,402,16,23683,0,24085,16,1
2075015,3904459,2664,54,85781,0,88445,54,1
4642569,4336179,872,48,27586,0,28458,48,1
957197,157348,614,1,37109,0,37723,1,1
3280389,508699,1101,1,411419,0,412520,1,1
1958044,2697008,30,129,2133,0,2163,129,1
2075015,3342610,2664,7,85781,0,88445,7,1
3837347,1317583,169,122,2761,0,2930,122,1
1539837,4551435,1127,37,62979,0,64106,37,1
3765475,4162907,873,5,107914,0,108787,5,1
1834577,329702,84,12,1213,0,1297,12,1
1937293,487935,434,116,16761,0,17195,116,1
3361377,2247174,4841,1,761793,0,766634,1,1
1521082,3141828,766,38,6562,343,7328,381,1
471706,2903356,794,22,65616,0,66410,22,1
1436216,98249,1068,1,68770,0,69838,1,1
2314038,3397516,456,5,16347,0,16803,5,1
427805,3923818,483,1,156906,0,157389,1,1
2598661,1062302,165,13,739,0,904,13,1
3065808,1305452,1235,17,82317,0,83552,17,1
1196844,365765,548,108,36289,0,36837,108,1
3361377,853519,4841,7,761793,0,766634,7,1
3854592,331243,108,43,3483,0,3591,43,1
4016796,2911604,17,22,191,0,208,22,1
544230,3372464,1532,19,60768,0,62300,19,1
3995817,426523,34,1,231,0,265,1,1
1580988,3708746,2821,1,400133,0,402954,1,1
2263130,1018831,712,198,14043,0,14755,198,1
2950311,4476146,807,83,85116,0,85923,83,1
3569179,4040275,1064,6,40015,0,41079,6,1
3316620,4130572,214,13,5083,0,5297,13,1
1603289,2962391,360,2532,873,241,1233,2773,1
932720,3070917,1411,52,111323,0,112734,52,1
2865405,2921557,79,3,1486,0,1565,3,1
687713,2941059,436,3,47160,0,47596,3,1
1633100,56172,163,1,8737,0,8900,1,1
1249967,191295,207,328,11933,0,12140,328,1
2428341,2222858,826,57,10151,0,10977,57,1
4183784,2016149,931,7,59894,0,60825,7,1
920553,3050123,349,1,8968,0,9317,1,1
1588705,366509,1000,17,11879,0,12879,17,1
2243304,1819928,60,15,382,0,442,15,1
2343253,2391387,1882,5,86401,0,88283,5,1
2827436,2973030,882,2,271525,0,272407,2,1
4641966,3052896,25,20,314,0,339,20,1
3215439,3879839,164,6,1054,0,1218,6,1
1251567,522590,71,46,387,0,458,46,1
828060,4150194,166,25,333,0,499,25,1
273363,3495156,768,153,11045,0,11813,153,1
3814892,2845862,60,11,3420,0,3480,11,1
2106653,3357648,100,60,2586,0,2686,60,1
3437068,4660944,295,44,1597,0,1892,44,1
3399872,1748446,38,45,806,0,844,45,1
2781817,538460,704,2,24613,0,25317,2,1
1310800,797160,200,66,6100,0,6300,66,1
1847461,1490707,1211,17,51149,0,52360,17,1
2961801,1562960,1483,19,101962,0,103445,19,1
4727207,3569492,925,3,84581,0,85506,3,1
67454,1428477,515,255,5700,15459,6215,15714,1
408965,1865174,903,15,38623,0,39526,15,1
4238001,1720988,869,112,61161,0,62030,112,1
1881008,1421216,141,14,1934,0,2075,14,1
3294702,703930,991,30,68888,0,69879,30,1
1937293,4186249,434,7,16761,0,17195,7,1
618869,3254592,40,31,228,137,268,168,1
489584,4470002,421,2,12098,0,12519,2,1
52948,1911690,7,7,108,0,115,7,1
2102302,52666,71,66,283,139,354,205,1
1588705,2397177,1000,22,11879,0,12879,22,1
3361377,1964481,4841,3,761793,0,766634,3,1
2147720,550379,1608,38,78786,0,80394,38,1
3714061,4536329,84,4,3348,0,3432,4,1
2985909,381300,706,114,43348,1986,44054,2100,1
3104095,2778813,16,111,742,4665,758,4776,1
3765475,2786000,873,2,107914,0,108787,2,1
3683235,448602,311,65,23110,0,23421,65,1
1723506,369710,733,18,21835,0,22568,18,1
3898535,1234744,59,19,9303,0,9362,19,1
4302921,2402216,509,16,13289,0,13798,16,1
1353265,3476549,128,2,6709,0,6837,2,1
873241,1197858,616,46,22633,0,23249,46,1
920553,3552364,349,28,8968,0,9317,28,1
471706,292602,794,1,65616,0,66410,1,1
3672238,3496589,518,392,12172,0,12690,392,1
1696872,2447177,9,2,582,0,591,2,1
1580988,1567647,2821,1,400133,0,402954,1,1
997639,740370,149,97,136,613,285,710,1
4108836,728103,97,127,4234,0,4331,127,1
1132938,1353200,206,259,1979,0,2185,259,1
4117427,1282340,329,35,9639,0,9968,35,1
755739,1589409,1117,54,58043,0,59160,54,1
4451122,4232600,985,54,41669,0,42654,54,1
752618,3234522,169,25,5929,0,6098,25,1
957197,2682112,614,68,37109,0,37723,68,1
3692657,3756957,33,37,2350,0,2383,37,1
4145062,2824495,46,8,356,0,402,8,1
3616842,3505803,317,312,3201,0,3518,312,1
1847461,2307654,1211,64,51149,0,52360,64,1
427805,4772628,483,3,156906,0,157389,3,1
2961801,4233154,1483,57,101962,0,103445,57,1
2961801,932320,1483,113,101962,0,103445,113,1
2981537,815876,1252,14,118718,0,119970,14,1
3137585,1466329,1196,42,77354,0,78550,42,1
3387987,2367057,268,75,19035,0,19303,75,1
1500966,2234788,233,18,2493,0,2726,18,1
593740,2231783,1107,44,62807,0,63914,44,1
4209323,4306761,1630,7,89460,0,91090,7,1
3561502,4537148,1144,41,68800,0,69944,41,1
1130763,880495,294,414,254,210,548,624,1
2893334,776992,889,9,30148,0,31037,9,1
2498087,2656058,1630,67,32582,0,34212,67,1
152481,3903975,12,26,571,0,583,26,1
4619326,1241906,539,25,22721,0,23260,25,1
3361377,2152736,4841,3,761793,0,766634,3,1
1195811,3298580,89,52,1995,0,2084,52,1
3065808,866119,1235,45,82317,0,83552,45,1
1831774,2497113,228,22,1883,0,2111,22,1
3718020,2612330,305,56,6132,0,6437,56,1
354904,2017489,3193,155,105780,0,108973,155,1
4208653,3270688,1820,60,21104,0,22924,60,1
3638272,194498,2022,2,370904,0,372926,2,1
3561502,1578126,1144,105,68800,0,69944,105,1
60980,2190991,649,2,20708,0,21357,2,1
3361377,2327326,4841,12,761793,0,766634,12,1
337208,1008433,174,10,1581,0,1755,10,1
1580988,945468,2821,2,400133,0,402954,2,1
4090769,445212,79,52,469,0,548,52,1
4141746,3741369,61,2,917,0,978,2,1
1637447,1695918,555,33,8549,0,9104,33,1
1276253,1300695,407,1,46534,0,46941,1,1
2217245,2292554,205,57,239,0,444,57,1
1588330,818876,694,163,10280,0,10974,163,1
3993347,2866621,434,124,3778,0,4212,124,1
3509903,1530718,1530,1,509445,0,510975,1,1
3836080,1264801,1197,78,59457,0,60654,78,1
2958239,4555013,101,161,3638,0,3739,161,1
842476,821163,898,38,12479,0,13377,38,1
3294702,3060846,991,25,68888,0,69879,25,1
2897926,1374934,565,286,25983,0,26548,286,1
2851109,1580212,450,2,98552,0,99002,2,1
4317718,3545983,111,2,3149,0,3260,2,1
3674250,4347654,155,1278,2204,0,2359,1278,1
3842148,76249,719,55,11430,0,12149,55,1
1358075,3493052,37,1,228,0,265,1,1
1633022,4850953,246,1,23530,0,23776,1,1
2443764,2693583,260,88,6836,0,7096,88,1
2405789,1629596,1010,36,93387,0,94397,36,1
445996,1236075,1175,344,12828,2346,14003,2690,1
4440160,2010243,736,105,20522,0,21258,105,1
3298299,1957009,181,186,4843,0,5024,186,1
1534362,35798,1531,45,105859,0,107390,45,1
2687552,4844177,238,418,25574,0,25812,418,1
2535203,3183888,138,45,271,0,409,45,1
519175,1344547,173,10,7221,0,7394,10,1
2482338,2116500,712,145,24222,0,24934,145,1
3514446,3084168,92,19,3233,0,3325,19,1
3280389,2411896,1101,1,411419,0,412520,1,1
837553,2291775,1249,87,61665,0,62914,87,1
2394976,3773366,335,3,10973,0,11308,3,1
3873768,4415559,449,181,35424,0,35873,181,1
3845119,1238862,461,2,28609,0,29070,2,1
2655966,550908,81,297,2804,0,2885,297,1
3963149,2928178,33,106,487,2200,520,2306,1
4853234,1625352,1256,5,29554,0,30810,5,1
1151593,2010903,231,46,5501,0,5732,46,1
3106700,1179983,157,122,1980,180,2137,302,1
3361377,3122116,4841,1,761793,0,766634,1,1
1125432,4272102,298,1608,2434,104171,2732,105779,1
1787075,4339956,894,35,28305,0,29199,35,1
4828511,3757142,113,55,2641,0,2754,55,1
153871,1388179,333,11,3892,0,4225,11,1
2751572,1250616,481,23,44036,0,44517,23,1
3875080,3869842,285,322,5153,0,5438,322,1
3294702,3452164,991,6,68888,0,69879,6,1
2119841,1454821,272,135,1846,0,2118,135,1
4701737,3120180,98,2,4855,0,4953,2,1
3257465,4064593,541,15,27614,0,28155,15,1
307250,4127320,919,3,35588,0,36507,3,1
3074145,4726377,205,772,5623,17,5828,789,1
1761428,3509164,112,385,2469,0,2581,385,1
3865635,814471,94,2,1026,0,1120,2,1
1937293,1175773,434,10,16761,0,17195,10,1
3065808,4515167,1235,59,82317,0,83552,59,1
724650,2846485,248,68,906,0,1154,68,1
4179267,3203872,14,21,304,0,318,21,1
1388042,4066545,47,2,175,0,222,2,1
4528103,3159215,268,170,14258,0,14526,170,1
3408676,2367856,262,79,3778,0,4040,79,1
3509903,2797743,1530,2,509445,0,510975,2,1
3242275,1255200,551,102,17400,0,17951,102,1
892512,840940,1505,13,11757,0,13262,13,1
1478234,3723446,13,14,167,0,180,14,1
573325,935434,266,43,2664,0,2930,43,1
4372315,2306181,29,4,397,0,426,4,1
3739473,2419457,448,2,13226,0,13674,2,1
3509903,2845291,1530,12,509445,0,510975,12,1
474172,3614140,471,23,38713,0,39184,23,1
3588630,3415925,351,101,7803,0,8154,101,1
4689808,4364225,280,3,14220,0,14500,3,1
3989108,2498662,372,91,7033,535,7405,626,1
3361377,1816725,4841,3,761793,0,766634,3,1
2961552,3679517,562,33,16546,0,17108,33,1
858791,167846,110,13,2663,0,2773,13,1
1494665,3100503,668,72,37638,0,38306,72,1
4209323,1612785,1630,397,89460,0,91090,397,1
3509903,4072693,1530,2,509445,0,510975,2,1
2649958,219242,40,3,378,0,418,3,1
2631724,2380590,16,1,4171,0,4187,1,1
2950311,4415557,807,6,85116,0,85923,6,1
2851109,3499192,450,1,98552,0,99002,1,1
3361377,2108380,4841,1,761793,0,766634,1,1
3454888,4173185,162,1,7886,0,8048,1,1
3873117,3235455,51,82,377,0,428,82,1
1121120,752358,25,7,556,0,581,7,1
4473143,2837713,126,21,472,0,598,21,1
370123,2822457,110,329,7231,0,7341,329,1
2790006,1381629,367,39,14747,0,15114,39,1
573281,784376,139,83,1990,0,2129,83,1
4297498,1970472,55,1,1240,0,1295,1,1
2896906,61553,1193,907,7172,0,8365,907,1
3881634,1760055,641,253,8471,0,9112,253,1
3438576,871116,3424,2,137753,0,141177,2,1
1731071,587712,72,20,948,0,1020,20,1
1276253,4516599,407,1,46534,0,46941,1,1
111922,2406215,303,461,6879,0,7182,461,1
3280389,1120122,1101,3,411419,0,412520,3,1
2922412,197552,464,63,3629,0,4093,63,1
2781817,2944073,704,238,24613,0,25317,238,1
3638272,2476651,2022,2,370904,0,372926,2,1
1943259,4338948,78,21,1765,0,1843,21,1
4619326,551349,539,42,22721,0,23260,42,1
4327096,4786739,234,97,2944,0,3178,97,1
2961801,2244174,1483,5,101962,0,103445,5,1
3765475,2994013,873,1,107914,0,108787,1,1
3280389,931268,1101,2,411419,0,412520,2,1
3361377,3264184,4841,39,761793,0,766634,39,1
765601,2901575,1485,65,101510,0,102995,65,1
2931617,116471,93,21,426,0,519,21,1
3692057,2472681,10,208,28,528,38,736,1
1059680,2025248,79,138,3854,0,3933,138,1
2981537,1140894,1252,5,118718,0,119970,5,1
414608,3349613,50,86,5531,0,5581,86,1
4671746,3143421,512,2,4544,0,5056,2,1
954252,2344734,25,1,382,0,407,1,1
4738916,3023255,1165,5,34124,0,35289,5,1
532681,2326344,433,18,35023,0,35456,18,1
4330391,4593780,773,605,32759,0,33532,605,1
3549674,2598780,602,5,38542,0,39144,5,1
1202049,254046,151,8,465,0,616,8,1
2075015,4122298,2664,5,85781,0,88445,5,1
920553,814159,349,76,8968,0,9317,76,1
2496454,4145084,320,473,2769,0,3089,473,1
787416,4529718,115,4,9954,0,10069,4,1
3280389,3029879,1101,2,411419,0,412520,2,1
2147720,3847097,1608,6,78786,0,80394,6,1
4238001,2342263,869,88,61161,0,62030,88,1
1016223,4759036,1,1,1950,0,1951,1,1
2998026,3107987,919,2,24182,0,25101,2,1
3638272,2499743,2022,2,370904,0,372926,2,1
2182964,4632994,214,3,6975,0,7189,3,1
3361377,1081835,4841,1,761793,0,766634,1,1
3361377,3034637,4841,1,761793,0,766634,1,1
2343253,238580,1882,128,86401,0,88283,128,1
4653941,3638682,951,3,45883,0,46834,3,1
3280389,1843241,1101,4,411419,0,412520,4,1
3361377,1131416,4841,10,761793,0,766634,10,1
1478080,137574,593,37,7009,0,7602,37,1
1196844,1284560,548,3,36289,0,36837,3,1
293665,860135,139,63,1817,0,1956,63,1
1591435,1572025,387,113,31245,0,31632,113,1
2757156,3178593,237,252,8153,0,8390,252,1
1022123,1677509,126,51,8212,0,8338,51,1
3509903,4114779,1530,2,509445,0,510975,2,1
2130979,1396174,452,116,4717,0,5169,116,1
3768366,580920,334,80,12403,0,12737,80,1
765601,4683801,1485,14,101510,0,102995,14,1
4272102,4566150,1608,21,104171,0,105779,21,1
1534362,1959920,1531,109,105859,0,107390,109,1
1580508,4652948,720,58,19611,0,20331,58,1
4195192,3761999,14,2,371,0,385,2,1
3206499,443051,1337,1,32033,0,33370,1,1
3638272,1643664,2022,1,370904,0,372926,1,1
1588330,912439,694,157,10280,0,10974,157,1
1787075,540864,894,65,28305,0,29199,65,1
4360960,4183070,1642,30,110084,0,111726,30,1
1196844,1446722,548,13,36289,0,36837,13,1
3249609,3403497,45,138,149,0,194,138,1
3734245,2984249,915,3,34965,0,35880,3,1
53878,2369373,284,21,2344,0,2628,21,1
1984622,4813365,145,1,20659,0,20804,1,1
3454888,1133018,162,9,7886,0,8048,9,1
2148937,4346419,672,18,47361,0,48033,18,1
3898535,4417235,59,116,9303,0,9362,116,1
3438576,1084128,3424,4,137753,0,141177,4,1
60980,3584698,649,2,20708,0,21357,2,1
3509903,4199292,1530,2,509445,0,510975,2,1
1654099,1670679,1180,89,26347,0,27527,89,1
4230144,935958,216,36,4435,0,4651,36,1
3514277,2865211,1338,417,13269,0,14607,417,1
4417253,896894,1130,48,68389,0,69519,48,1
765601,3099460,1485,47,101510,0,102995,47,1
2260014,1486779,2466,6,98622,0,101088,6,1
396393,3972101,41,2,92,0,133,2,1
1815739,1893405,248,396,6590,0,6838,396,1
1575009,4762720,429,44,37745,0,38174,44,1
4656285,3236248,1446,7,35428,0,36874,7,1
970793,2063078,4,78,88,0,92,78,1
4417253,233354,1130,16,68389,0,69519,16,1
2881425,2990794,102,351,5272,0,5374,351,1
3509903,4135531,1530,3,509445,0,510975,3,1
4045699,877654,126,1838,1522,1348,1648,3186,1
1649520,2083996,2,13,131,0,133,13,1
1927211,4502314,1668,56,113322,0,114990,56,1
2266491,4717522,81,913,1909,395,1990,1308,1
471706,2526935,794,2,65616,0,66410,2,1
3759853,2683122,451,18,16330,0,16781,18,1
2096270,3325596,970,104,26018,0,26988,104,1
4050480,1650875,422,1881,4311,162,4733,2043,1
493062,3877637,34,57,2722,0,2756,57,1
4209323,861729,1630,41,89460,0,91090,41,1
4653941,1254548,951,1,45883,0,46834,1,1
2723351,1281003,135,363,149,2000,284,2363,1
1500966,3697764,233,37,2493,0,2726,37,1
670587,4202432,651,598,9779,0,10430,598,1
4175120,644301,78,442,258,511,336,953,1
4416945,4675713,417,136,33228,0,33645,136,1
2827436,2186290,882,1,271525,0,272407,1,1
2961801,4642620,1483,19,101962,0,103445,19,1
1733957,2299733,554,63,15185,0,15739,63,1
3361377,180502,4841,2,761793,0,766634,2,1
3438576,1957894,3424,93,137753,0,141177,93,1
1913445,2043372,564,50,47943,0,48507,50,1
1103332,3674119,732,34,59415,0,60147,34,1
1383571,4654641,91,1,1112,0,1203,1,1
3123201,3289494,126,10,5539,0,5665,10,1
256934,3488918,287,31,11635,0,11922,31,1
4119493,1614260,80,26,4077,0,4157,26,1
4516604,4316458,314,201,13314,0,13628,201,1
4782707,4472649,513,4,31665,0,32178,4,1
713414,3356145,106,64,213,147,319,211,1
250102,1619598,189,51,4350,0,4539,51,1
299865,4195100,409,277,1612,0,2021,277,1
393185,3297873,591,149,7719,0,8310,149,1
611927,1207046,305,8,8695,0,9000,8,1
1676904,3847046,301,164,1455,958,1756,1122,1
1234540,360437,1071,57,75251,0,76322,57,1
2260014,4099275,2466,34,98622,0,101088,34,1
3914135,234306,2152,1,60084,0,62236,1,1
3768187,3090567,84,200,243,0,327,200,1
4451122,4441566,985,12,41669,0,42654,12,1
3764475,4011208,301,122,9092,0,9393,122,1
3272790,513328,40,3,3168,0,3208,3,1
847782,4776962,364,37,1411,0,1775,37,1
4295952,2453524,808,90,57369,0,58177,90,1
4360960,2656483,1642,13,110084,0,111726,13,1
573101,326816,781,185,12750,0,13531,185,1
1659017,2692696,817,6,13055,0,13872,6,1
1710474,2405502,154,39,1649,0,1803,39,1
2405789,1766965,1010,59,93387,0,94397,59,1
372359,3082889,48,1,1323,0,1371,1,1
386424,1225563,131,96,7871,0,8002,96,1
1652056,2598147,326,1,66845,0,67171,1,1
1762768,3764600,451,42,3478,0,3929,42,1
2896906,2865938,1193,37,7172,0,8365,37,1
4272102,3222002,1608,199,104171,0,105779,199,1
4451501,3155345,59,1,243,0,302,1,1
3023130,3069582,778,235,6402,0,7180,235,1
1539837,3017860,1127,24,62979,0,64106,24,1
954784,4397209,567,118,14450,507,15017,625,1
1503741,1252564,56,3,947,0,1003,3,1
3125762,4063300,254,2,8285,0,8539,2,1
2362241,1240444,324,198,7732,0,8056,198,1
873241,4753953,616,49,22633,0,23249,49,1
78836,1591293,86,44,3525,0,3611,44,1
4100923,4009848,260,179,7743,0,8003,179,1
3361377,585759,4841,3,761793,0,766634,3,1
1301815,3228654,752,10,48944,0,49696,10,1
1652056,1405144,326,2,66845,0,67171,2,1
3765475,110572,873,2,107914,0,108787,2,1
1339664,4791731,228,78,6682,269,6910,347,1
1250021,519631,4637,168,85913,0,90550,168,1
2704966,1623852,139,85,560,495,699,580,1
3397281,1641404,743,119,15050,866,15793,985,1
1154430,1684921,155,87,1425,0,1580,87,1
25871,324108,214,113,1848,618,2062,731,1
3582961,639066,12,2,275,0,287,2,1
3386106,4592122,36,1748,279,8,315,1756,1
2961801,1304323,1483,36,101962,0,103445,36,1
3906136,2712099,387,32,41169,0,41556,32,1
2169041,4628797,16,392,342,30,358,422,1
573641,3840255,253,33,5074,0,5327,33,1
4853234,1046427,1256,1,29554,0,30810,1,1
2439199,3568660,631,63,5929,0,6560,63,1
427805,84187,483,43,156906,0,157389,43,1
859694,1621347,433,24,4244,0,4677,24,1
1223115,2957726,20,38,252,0,272,38,1
871344,1311817,263,175,1863,667,2126,842,1
3561502,2151811,1144,55,68800,0,69944,55,1
465946,4108715,258,632,1468,1257,1726,1889,1
3742930,3855274,410,217,22242,0,22652,217,1
1079835,2469105,42,4,273,0,315,4,1
158219,2127245,50,4,1043,0,1093,4,1
1575009,3658936,429,56,37745,0,38174,56,1
4272102,1727702,1608,35,104171,0,105779,35,1
1943259,3029597,78,1,1765,0,1843,1,1
593740,4540817,1107,197,62807,4499,63914,4696,1
3509903,512787,1530,2,509445,0,510975,2,1
4801471,4396397,585,27,17979,0,18564,27,1
687713,4735748,436,4,47160,0,47596,4,1
898068,2950064,138,8,3174,0,3312,8,1
209767,3735127,40,187,137,14,177,201,1
2107861,1956821,535,4,25743,0,26278,4,1
162605,266434,74,25,378,0,452,25,1
2685897,1251693,38,31,4789,0,4827,31,1
686496,3597150,290,49,2526,0,2816,49,1
2348093,4788592,335,16,12064,0,12399,16,1
2496454,4209323,320,1630,2769,89460,3089,91090,1
4727207,2781076,925,2,84581,0,85506,2,1
866888,3793505,391,6,2049,0,2440,6,1
593740,1225533,1107,215,62807,0,63914,215,1
4451122,697029,985,47,41669,0,42654,47,1
4385783,1549317,290,303,10995,0,11285,303,1
1331940,1610696,802,1,32617,0,33419,1,1
3509903,1781656,1530,6,509445,0,510975,6,1
2247657,1976955,306,12,7138,0,7444,12,1
1785615,4485215,153,20,2575,0,2728,20,1
932720,263812,1411,33,111323,0,112734,33,1
4777191,39585,86,5,3938,0,4024,5,1
3196195,4244603,289,295,1305,460,1594,755,1
1652056,1094338,326,2,66845,0,67171,2,1
2307868,2073276,1131,1,38777,0,39908,1,1
2516076,2687873,1455,27,77782,0,79237,27,1
2953791,1283023,40,74,1278,0,1318,74,1
615485,3545300,70,1134,378,0,448,1134,1
1971223,4467852,338,7,5185,0,5523,7,1
4319972,21650,640,72,35279,0,35919,72,1
3098318,3681922,230,79,1307,0,1537,79,1
1973082,2914315,1036,52,18915,815,19951,867,1
2307868,1207983,1131,3,38777,0,39908,3,1
3906136,507580,387,1,41169,0,41556,1,1
3361377,3583322,4841,1,761793,0,766634,1,1
1580988,445649,2821,3,400133,0,402954,3,1
2482338,2384630,712,1,24222,0,24934,1,1
2581956,3067214,41,40,2268,0,2309,40,1
1534362,3763338,1531,42,105859,0,107390,42,1
929454,3361377,75,4841,1399,761793,1474,766634,1
3559552,265568,145,104,2863,0,3008,104,1
1355516,2306941,315,2,2436,0,2751,2,1
2212117,791874,43,1,6252,0,6295,1,1
4011264,160599,1360,26,116777,0,118137,26,1
501914,1400585,217,45,5217,0,5434,45,1
2981537,1958656,1252,43,118718,0,119970,43,1
2687552,2031386,238,17,25574,0,25812,17,1
3509903,3325406,1530,1,509445,0,510975,1,1
765601,3972941,1485,51,101510,0,102995,51,1
1652056,1233626,326,1,66845,0,67171,1,1
1227855,2555849,157,332,4545,0,4702,332,1
4629176,12701,2058,21,9211,0,11269,21,1
4596817,4202648,160,2,1879,0,2039,2,1
1580988,4621719,2821,306,400133,4102,402954,4408,1
3361377,2757547,4841,1,761793,0,766634,1,1
3280484,52661,424,37,2345,0,2769,37,1
3768366,4509581,334,9,12403,0,12737,9,1
1635717,2015788,174,37,1173,321,1347,358,1
4846817,1534537,76,15,5055,0,5131,15,1
1580988,3868983,2821,4,400133,0,402954,4,1
4656285,152720,1446,134,35428,0,36874,134,1
3509903,3562200,1530,3,509445,0,510975,3,1
4140279,1877027,337,1,49384,0,49721,1,1
805360,1921889,1514,34,119306,0,120820,34,1
1503116,2580705,415,1,37079,0,37494,1,1
3645402,810497,153,56,7400,0,7553,56,1
3531730,3514277,334,1338,9763,13269,10097,14607,1
1550824,249983,165,102,3841,64,4006,166,1
3438576,1558143,3424,34,137753,0,141177,34,1
1621849,1790123,201,53,1877,0,2078,53,1
3392698,4710970,132,58,1402,0,1534,58,1
1580988,819807,2821,1,400133,0,402954,1,1
1086912,1327139,907,340,33396,0,34303,340,1
3509903,3255472,1530,4,509445,0,510975,4,1
1339861,4267589,200,198,1212,0,1412,198,1
781211,2316785,976,32,51781,0,52757,32,1
2757305,1452976,8,31,39,0,47,31,1
133821,3427625,1294,774,58,196,1352,970,1
3842148,2171454,719,428,11430,0,12149,428,1
2620287,2317398,78,5,2306,0,2384,5,1
3514277,2605958,1338,15,13269,0,14607,15,1
1880135,4569338,810,90,71924,0,72734,90,1
2120733,2547798,819,202,20803,0,21622,202,1
2522799,3806216,253,81,3062,0,3315,81,1
765601,2761522,1485,13,101510,0,102995,13,1
752618,1259568,169,242,5929,0,6098,242,1
3280389,968995,1101,2,411419,0,412520,2,1
2905848,4007158,29,420,262,0,291,420,1
427805,3080976,483,1,156906,0,157389,1,1
1501241,755739,121,1117,880,58043,1001,59160,1
1659017,4555169,817,70,13055,0,13872,70,1
2007635,3612460,9,2,205,0,214,2,1
3361377,3841840,4841,195,761793,2931,766634,3126,1
1633022,3779204,246,2,23530,0,23776,2,1
381300,1150997,114,14,1986,0,2100,14,1
3549674,3576487,602,1,38542,0,39144,1,1
1913445,1393398,564,49,47943,0,48507,49,1
4011264,2868268,1360,4,116777,0,118137,4,1
3758692,816871,711,99,34731,0,35442,99,1
3469653,1629576,32,5,2818,0,2850,5,1
1659017,4607783,817,9,13055,0,13872,9,1
4209323,507912,1630,4,89460,0,91090,4,1
4507127,2227054,47,83,1288,0,1335,83,1
1875,882717,656,88,61388,0,62044,88,1
2502456,3937832,719,179,50725,0,51444,179,1
1063358,3273761,1350,37,63494,0,64844,37,1
990798,1952190,194,7,2812,0,3006,7,1
957197,3388056,614,39,37109,0,37723,39,1
544230,4141480,1532,10,60768,0,62300,10,1
3141828,4630598,38,1,343,0,381,1,1
1591435,3962578,387,113,31245,0,31632,113,1
1580988,953145,2821,1,400133,0,402954,1,1
607449,2998210,380,102,19369,0,19749,102,1
1927211,4127053,1668,14,113322,0,114990,14,1
713416,2129386,120,50,1953,0,2073,50,1
4154740,1589691,68,4,1352,0,1420,4,1
2851109,3750872,450,2,98552,0,99002,2,1
2074294,44777,29,685,335,450,364,1135,1
4015080,3542488,144,90,1337,0,1481,90,1
408965,4368094,903,77,38623,0,39526,77,1
4202576,2886224,600,4,10697,0,11297,4,1
957197,1834661,614,2,37109,0,37723,2,1
521586,1735993,782,184,18489,0,19271,184,1
1196844,1504211,548,31,36289,0,36837,31,1
4507659,4091650,115,182,1270,1399,1385,1581,1
3638272,402959,2022,1,370904,0,372926,1,1
3496038,2566114,215,12,1116,0,1331,12,1
4389081,2723040,64,3,1426,0,1490,3,1
496260,2723674,177,134,880,558,1057,692,1
3198742,3553357,551,7,5252,0,5803,7,1
3569179,726055,1064,68,40015,0,41079,68,1
1875,3804502,656,76,61388,0,62044,76,1
1537492,2477539,175,3,6621,0,6796,3,1
3561502,3077119,1144,74,68800,0,69944,74,1
2745433,3884127,36,70,1914,0,1950,70,1
354904,2051774,3193,3,105780,0,108973,3,1
3144238,1012583,326,33,28455,0,28781,33,1
363750,3550882,1001,3,10994,0,11995,3,1
4727207,3074360,925,41,84581,0,85506,41,1
1549445,238046,138,52,1227,590,1365,642,1
2727581,4079798,757,19,7394,0,8151,19,1
3119726,3799243,299,123,11573,0,11872,123,1
3765475,4529885,873,4,107914,0,108787,4,1
4606184,1687593,265,41,4466,0,4731,41,1
1988347,2245562,205,15,3660,0,3865,15,1
3638272,2267326,2022,1,370904,0,372926,1,1
1065411,4300463,19,213,480,0,499,213,1
2255162,3908711,92,123,1209,0,1301,123,1
4492248,577916,237,1086,17127,0,17364,1086,1
3764177,439877,1036,1,64563,0,65599,1,1
2399369,4762830,71,1043,857,2352,928,3395,1
3438576,4288363,3424,32,137753,0,141177,32,1
4295952,1298061,808,73,57369,0,58177,73,1
3361377,2832607,4841,5,761793,0,766634,5,1
805360,3061369,1514,50,119306,0,120820,50,1
3651179,339563,1752,1999,2979,7561,4731,9560,1
2120140,1039769,453,649,6305,0,6758,649,1
3638272,3237488,2022,12,370904,0,372926,12,1
2751572,943759,481,75,44036,0,44517,75,1
2494800,4192603,752,47,5329,85,6081,132,1
2529661,2186492,493,324,27309,0,27802,324,1
3361377,4071221,4841,24,761793,0,766634,24,1
3065808,3943934,1235,3,82317,0,83552,3,1
3509903,4582879,1530,3,509445,0,510975,3,1
3112136,1693272,406,81,41366,0,41772,81,1
2827436,2927918,882,1,271525,0,272407,1,1
3980540,3123639,152,538,1918,181,2070,719,1
4233503,2270499,224,39,7867,0,8091,39,1
2164178,2280906,574,52,6134,0,6708,52,1
3734245,3747107,915,25,34965,0,35880,25,1
3875114,3154892,233,46,3154,0,3387,46,1
4817410,3297299,31,2,1422,0,1453,2,1
2897926,13338,565,14,25983,0,26548,14,1
2993436,1282350,39,1,2550,0,2589,1,1
765601,3341203,1485,235,101510,0,102995,235,1
3814892,1403900,60,68,3420,0,3480,68,1
949229,610862,274,2,251,0,525,2,1
281939,3803459,80,58,2031,0,2111,58,1
4418909,4025415,266,110,2172,0,2438,110,1
2462210,3829304,96,77,1606,0,1702,77,1
285124,2106815,135,403,4250,0,4385,403,1
4693230,1670601,118,68,288,0,406,68,1
4099305,3160450,118,98,5174,0,5292,98,1
2502456,207591,719,283,50725,0,51444,283,1
2827436,2314835,882,2,271525,0,272407,2,1
2755798,350111,494,12,24862,0,25356,12,1
1425141,4548983,19,33,139,0,158,33,1
4789203,485695,355,10,11315,0,11670,10,1
1580988,253825,2821,5,400133,0,402954,5,1
648163,4266670,238,106,1998,0,2236,106,1
1539837,1171990,1127,47,62979,0,64106,47,1
3361377,3700393,4841,1,761793,0,766634,1,1
1436216,817893,1068,67,68770,0,69838,67,1
1847461,1980250,1211,18,51149,0,52360,18,1
2773460,4155819,151,93,158,456,309,549,1
386424,2164023,131,43,7871,0,8002,43,1
1353265,3480697,128,898,6709,0,6837,898,1
1697778,2921635,125,1,3760,0,3885,1,1
957197,2724069,614,1,37109,0,37723,1,1
929454,2237180,75,31,1399,0,1474,31,1
4191410,4758044,1590,11,96434,0,98024,11,1
1140134,1454466,311,2,11111,0,11422,2,1
4738394,2573526,113,222,1053,539,1166,761,1
860473,4674109,751,143,20450,0,21201,143,1
595757,2361101,340,63,26738,0,27078,63,1
2616927,1365521,184,11,2688,0,2872,11,1
6618,3706804,892,217,68849,0,69741,217,1
1652056,4788544,326,358,66845,0,67171,358,1
3361377,1784340,4841,1,761793,0,766634,1,1
747739,4752166,45,57,1955,0,2000,57,1
2677334,2455512,377,1,6774,0,7151,1,1
3361377,26072,4841,1,761793,0,766634,1,1
3055481,224691,135,31,1883,0,2018,31,1
765601,2181828,1485,70,101510,0,102995,70,1
2394976,4136839,335,253,10973,0,11308,253,1
1306260,1305736,233,132,3200,0,3433,132,1
2046124,3435520,289,8,1436,0,1725,8,1
917130,363178,325,98,7017,0,7342,98,1
3509903,3784005,1530,19,509445,0,510975,19,1
2502456,3857516,719,36,50725,0,51444,36,1
3361377,1753983,4841,1,761793,0,766634,1,1
1490274,4076021,25,1,276,0,301,1,1
525109,4300204,70,122,1943,0,2013,122,1
1600857,1663901,324,24,10576,0,10900,24,1
765601,233328,1485,27,101510,0,102995,27,1
3854592,3832372,108,3,3483,0,3591,3,1
1913445,432371,564,26,47943,0,48507,26,1
1843507,1374120,537,165,11729,0,12266,165,1
3112136,791127,406,23,41366,0,41772,23,1
1494918,264213,248,2,972,0,1220,2,1
2189067,690460,356,210,6408,0,6764,210,1
3102873,4706218,341,13,15098,0,15439,13,1
3579221,2015961,31,18,179,0,210,18,1
3361377,1138796,4841,5,761793,0,766634,5,1
189347,4059283,87,91,2001,0,2088,91,1
439557,745779,2090,30,61744,0,63834,30,1
544230,4003652,1532,89,60768,0,62300,89,1
1250021,2746209,4637,4,85913,0,90550,4,1
3509903,3835953,1530,2,509445,0,510975,2,1
2956957,959621,79,129,655,0,734,129,1
1809371,4264081,47,4,100,0,147,4,1
544230,1256911,1532,5,60768,0,62300,5,1
2774493,613147,551,542,12712,0,13263,542,1
4191410,2187827,1590,53,96434,0,98024,53,1
4658252,2596346,21,1,151,0,172,1,1
3079649,920070,549,35,2116,0,2665,35,1
1681927,453193,123,25,865,0,988,25,1
1033808,459928,9,4,2000,0,2009,4,1
3509903,3473503,1530,1,509445,0,510975,1,1
2260014,1065146,2466,5,98622,0,101088,5,1
1014412,2962391,216,2532,218,241,434,2773,1
1167124,4347654,23,1278,122,0,145,1278,1
4416945,2795303,417,9,33228,0,33645,9,1
4731914,973809,257,213,1886,0,2143,213,1
948768,2697008,587,129,14768,0,15355,129,1
2281149,2864680,282,120,28082,0,28364,120,1
3906136,3471912,387,27,41169,0,41556,27,1
1887709,125424,217,6,28983,0,29200,6,1
1727464,1228480,267,22,1073,0,1340,22,1
4416945,2112454,417,83,33228,0,33645,83,1
530200,3264957,2035,2,62809,0,64844,2,1
1539837,341069,1127,99,62979,0,64106,99,1
2307868,2895033,1131,164,38777,2870,39908,3034,1
646688,988133,115,18,243,0,358,18,1
4360799,399821,910,93,10476,0,11386,93,1
1829442,4782707,62,513,543,31665,605,32178,1
3443229,3627558,152,328,1959,0,2111,328,1
1312847,4494463,418,104,1699,0,2117,104,1
3638272,61879,2022,17,370904,0,372926,17,1
805360,1187714,1514,25,119306,0,120820,25,1
837553,1774769,1249,226,61665,0,62914,226,1
4140279,3744358,337,1,49384,0,49721,1,1
3361377,3238974,4841,1,761793,0,766634,1,1
627537,4011992,47,14,290,0,337,14,1
2827436,844348,882,2,271525,0,272407,2,1
2715611,3608649,73,85,1227,0,1300,85,1
3638272,3290373,2022,14,370904,0,372926,14,1
4503880,3366831,72,25,1028,0,1100,25,1
1110514,4674504,68,1,3569,0,3637,1,1
932720,1338753,1411,51,111323,0,112734,51,1
3242275,218499,551,107,17400,0,17951,107,1
3321628,3870249,90,7,1979,0,2069,7,1
3216427,1040794,262,22,6471,0,6733,22,1
593740,1874235,1107,55,62807,0,63914,55,1
4519069,3041216,387,54,20799,0,21186,54,1
1812281,2864806,150,5,815,0,965,5,1
3412500,3976141,41,1,733,0,774,1,1
2203170,4742523,363,58,2475,0,2838,58,1
2950311,4538696,807,19,85116,0,85923,19,1
3235479,1092584,999,72,66486,0,67485,72,1
1293056,1428477,29,255,178,15459,207,15714,1
3310125,1830476,90,70,330,0,420,70,1
1103332,838631,732,33,59415,0,60147,33,1
1652056,919222,326,8,66845,0,67171,8,1
3280389,2987862,1101,4,411419,0,412520,4,1
4846817,1090257,76,688,5055,0,5131,688,1
4249983,3004153,679,81,16076,0,16755,81,1
4653941,113418,951,76,45883,0,46834,76,1
805360,919942,1514,121,119306,0,120820,121,1
532681,4552568,433,40,35023,0,35456,40,1
4727207,3845419,925,1,84581,0,85506,1,1
4789203,3744392,355,1,11315,0,11670,1,1
932720,634198,1411,82,111323,0,112734,82,1
2096270,1433311,970,7,26018,0,26988,7,1
1847461,4276773,1211,74,51149,0,52360,74,1
1652056,183623,326,3,66845,0,67171,3,1
320344,4688964,351,1,3831,0,4182,1,1
2052930,2883507,407,1,8479,0,8886,1,1
1471685,1566903,1681,18,25550,0,27231,18,1
245479,1826570,473,64,4348,0,4821,64,1
3449530,279785,717,12,73648,0,74365,12,1
1330101,2543166,193,4,1999,0,2192,4,1
1063358,2445134,1350,28,63494,0,64844,28,1
1580988,1475591,2821,178,400133,3828,402954,4006,1
3509903,3411383,1530,1,509445,0,510975,1,1
4443577,367621,509,43,11936,0,12445,43,1
3280389,16774,1101,2,411419,0,412520,2,1
3021639,3432288,81,222,1475,0,1556,222,1
3280389,1700235,1101,7,411419,0,412520,7,1
619144,2016899,252,6,834,0,1086,6,1
1250021,2462714,4637,20,85913,0,90550,20,1
3509903,4066094,1530,2,509445,0,510975,2,1
1392958,4660687,91,1097,241,0,332,1097,1
4257751,4839181,109,14,8420,0,8529,14,1
2751572,3444476,481,92,44036,0,44517,92,1
6618,1375276,892,38,68849,0,69741,38,1
1119016,991748,252,259,1457,0,1709,259,1
1639434,2618910,587,13,8053,0,8640,13,1
4853234,2534534,1256,64,29554,0,30810,64,1
1554382,4119505,57,344,214,1991,271,2335,1
91116,1471506,239,44,2466,0,2705,44,1
1705425,66395,248,9,6280,0,6528,9,1
2405451,2690888,124,1,2161,0,2285,1,1
1887669,2397532,733,72,23145,0,23878,72,1
2981537,2116481,1252,1,118718,0,119970,1,1
401947,2927949,367,83,7890,0,8257,83,1
290670,2256637,252,118,3851,0,4103,118,1
3361377,609480,4841,21,761793,0,766634,21,1
3787285,521035,28,29,591,0,619,29,1
64357,1736841,309,269,6329,0,6638,269,1
515290,246985,285,41,34080,0,34365,41,1
2498087,225756,1630,45,32582,0,34212,45,1
2856965,2101251,23,17,892,0,915,17,1
3509903,1356499,1530,1,509445,0,510975,1,1
4751453,1829170,520,39,27570,0,28090,39,1
1580988,4143240,2821,3,400133,0,402954,3,1
3361377,2673964,4841,1,761793,0,766634,1,1
3509903,85107,1530,1,509445,0,510975,1,1
4443577,4743079,509,82,11936,0,12445,82,1
4848766,4197047,124,2,482,0,606,2,1
4440160,465500,736,48,20522,0,21258,48,1
1330101,3494843,193,54,1999,1,2192,55,1
3280389,2517071,1101,1,411419,0,412520,1,1
4562361,2492020,19,400,202,58,221,458,1
4141461,55260,3,34,10,0,13,34,1
4330391,958882,773,5,32759,0,33532,5,1
1580988,2617786,2821,2,400133,0,402954,2,1
2260014,2864394,2466,56,98622,0,101088,56,1
427805,1313437,483,1,156906,0,157389,1,1
3119726,3510898,299,261,11573,0,11872,261,1
1966548,440186,208,104,53149,0,53357,104,1
1588716,1891218,137,1376,422,0,559,1376,1
429643,4429772,767,35,19668,0,20435,35,1
1474822,2259209,229,40,3952,0,4181,40,1
1250021,3721182,4637,90,85913,0,90550,90,1
1442657,1637742,24,64,3189,0,3213,64,1
1436216,2650132,1068,86,68770,0,69838,86,1
2981537,4400111,1252,5,118718,0,119970,5,1
3361377,3109999,4841,1,761793,0,766634,1,1
3335643,1558253,191,35,1944,0,2135,35,1
781211,3891012,976,14,51781,0,52757,14,1
3509903,1211015,1530,1,509445,0,510975,1,1
1580988,4604802,2821,1,400133,0,402954,1,1
276216,3393428,312,197,12600,0,12912,197,1
2685897,2293927,38,47,4789,0,4827,47,1
989993,2314286,205,96,1109,0,1314,96,1
3280389,1955495,1101,3,411419,0,412520,3,1
4039180,2961960,343,75,1714,0,2057,75,1
2405789,4551214,1010,90,93387,0,94397,90,1
665164,2817031,396,75,12610,0,13006,75,1
2680263,4066579,29,72,100,418,129,490,1
1580988,4537857,2821,1,400133,0,402954,1,1
1534362,4004778,1531,21,105859,0,107390,21,1
1250021,309047,4637,166,85913,0,90550,166,1
2120733,3436360,819,39,20803,0,21622,39,1
471706,2883712,794,24,65616,0,66410,24,1
1588705,3620402,1000,49,11879,0,12879,49,1
3269767,4670658,12,5,441,0,453,5,1
4295952,2195336,808,30,57369,0,58177,30,1
1580988,2557647,2821,5,400133,0,402954,5,1
3395938,3085729,546,12,39878,0,40424,12,1
1359393,2264744,104,157,96,0,200,157,1
1787075,2469538,894,122,28305,0,29199,122,1
1585197,293274,72,1272,812,0,884,1272,1
2656829,358765,84,1,1953,0,2037,1,1
878715,2743989,100,73,1976,0,2076,73,1
2343253,4830801,1882,14,86401,0,88283,14,1
153871,1923498,333,25,3892,0,4225,25,1
4547438,2451857,1291,71,25237,0,26528,71,1
3147347,4637355,172,150,1534,1032,1706,1182,1
1234540,1067404,1071,13,75251,0,76322,13,1
3294702,4269510,991,55,68888,0,69879,55,1
1880135,2957226,810,14,71924,0,72734,14,1
47194,554848,148,2,4662,0,4810,2,1
273363,1428728,768,44,11045,0,11813,44,1
1580988,161564,2821,1,400133,0,402954,1,1
781211,1415770,976,259,51781,0,52757,259,1
60980,2237622,649,2,20708,0,21357,2,1
755739,551140,1117,80,58043,0,59160,80,1
4192206,2754407,468,67,18229,0,18697,67,1
2946468,2243424,43,177,200,0,243,177,1
907654,3877092,798,33,24575,0,25373,33,1
2204800,646935,32,3,661,0,693,3,1
3567927,3121295,190,1277,1980,0,2170,1277,1
3987684,2670483,286,12,17372,0,17658,12,1
1534362,1568405,1531,16,105859,0,107390,16,1
1887669,2040668,733,70,23145,0,23878,70,1
4485769,189368,116,219,1290,155,1406,374,1
4040599,1713754,63,6,979,0,1042,6,1
4830192,4174328,78,82,1935,0,2013,82,1
2650412,3978325,931,90,29038,0,29969,90,1
2838024,656894,22,4,160,0,182,4,1
3509214,4537000,263,95,14139,0,14402,95,1
3361377,573039,4841,39,761793,0,766634,39,1
1494665,1311254,668,12,37638,0,38306,12,1
2031305,1913690,396,15,23435,0,23831,15,1
2075015,1462868,2664,44,85781,0,88445,44,1
4750855,824658,355,180,18880,0,19235,180,1
2723171,4055550,99,175,3999,0,4098,175,1
2362241,93371,324,2,7732,0,8056,2,1
3289311,3640419,107,46,2041,0,2148,46,1
3795221,4069991,332,385,5749,0,6081,385,1
1399174,164854,27,10,912,0,939,10,1
3638272,162046,2022,1,370904,0,372926,1,1
3476834,837574,29,1,353,0,382,1,1
3271484,2164470,1507,33,34093,0,35600,33,1
2853969,4444643,1051,38,42591,0,43642,38,1
1588705,4243641,1000,23,11879,0,12879,23,1
2827436,3326184,882,2,271525,0,272407,2,1
3361377,1937184,4841,5,761793,0,766634,5,1
4314111,3672238,110,518,1951,12172,2061,12690,1
3517811,229804,60,2,11929,0,11989,2,1
2893334,3536696,889,4,30148,0,31037,4,1
471706,326889,794,5,65616,0,66410,5,1
2897926,707708,565,29,25983,0,26548,29,1
4337603,1309798,333,9,9909,0,10242,9,1
2283004,2812639,143,1,2253,0,2396,1,1
3943091,4369375,53,1,10283,0,10336,1,1
2267633,3290789,422,30,13247,0,13669,30,1
4708835,4187070,190,56,7539,0,7729,56,1
488614,3438576,45,3424,78,137753,123,141177,1
1609659,1740940,523,120,29763,0,30286,120,1
4727207,3032470,925,3,84581,0,85506,3,1
595757,2437987,340,39,26738,0,27078,39,1
3395938,3026237,546,64,39878,0,40424,64,1
110570,1378987,68,94,891,0,959,94,1
2148937,3350597,672,2,47361,0,48033,2,1
2853969,789819,1051,176,42591,0,43642,176,1
841308,2550350,102,64,3967,0,4069,64,1
1063358,3773496,1350,202,63494,0,64844,202,1
1966548,2549568,208,1,53149,0,53357,1,1
4295952,969933,808,27,57369,0,58177,27,1
3679433,2385163,48,6,2001,0,2049,6,1
1927211,3325137,1668,34,113322,0,114990,34,1
2516076,4322609,1455,12,77782,0,79237,12,1
3144238,87075,326,33,28455,0,28781,33,1
1205168,1923925,662,16,7710,0,8372,16,1
448143,2659855,58,2,1919,0,1977,2,1
3765475,4112807,873,2,107914,0,108787,2,1
1534362,4106211,1531,18,105859,0,107390,18,1
4319972,1813428,640,139,35279,0,35919,139,1
3280389,3085011,1101,1,411419,0,412520,1,1
1580988,2483097,2821,14,400133,0,402954,14,1
1973082,1269022,1036,58,18915,0,19951,58,1
148308,1165639,15,25,1948,0,1963,25,1
573101,2171454,781,428,12750,0,13531,428,1
593740,3974792,1107,6,62807,0,63914,6,1
2674718,1888723,136,571,5233,0,5369,571,1
3549674,2926010,602,9,38542,0,39144,9,1
4692327,1539837,149,1127,2092,62979,2241,64106,1
2364842,1933964,161,45,1709,0,1870,45,1
462298,1483514,414,600,10933,0,11347,600,1
4181760,3041001,359,19,7855,0,8214,19,1
2592965,4547438,567,1291,1811,25237,2378,26528,1
2998026,1233186,919,11,24182,0,25101,11,1
1580988,4037024,2821,1,400133,0,402954,1,1
1600268,1533302,18,8,247,0,265,8,1
2580348,1498966,164,1,1662,0,1826,1,1
4191410,595094,1590,22,96434,0,98024,22,1
873006,4497707,375,29,33630,0,34005,29,1
4547438,1360054,1291,61,25237,0,26528,61,1
2342664,530200,1181,2035,26502,62809,27683,64844,1
3509903,4439462,1530,123,509445,0,510975,123,1
2961801,3113954,1483,43,101962,0,103445,43,1
1677231,1069705,97,105,572,0,669,105,1
2383388,4106202,80,284,212,0,292,284,1
3228493,3408548,19,1,2744,0,2763,1,1
2887240,1606577,1143,2,118405,0,119548,2,1
2781817,443049,704,16,24613,0,25317,16,1
796130,2976684,22,257,1456,3759,1478,4016,1
2822865,4012210,316,4,1330,0,1646,4,1
2851109,4091406,450,3,98552,0,99002,3,1
2631724,4457545,16,1,4171,0,4187,1,1
3280389,1044069,1101,1,411419,0,412520,1,1
3616661,431339,18,139,248,0,266,139,1
3115867,2394469,1350,8,61232,0,62582,8,1
2751572,3210513,481,46,44036,0,44517,46,1
765601,3784268,1485,59,101510,0,102995,59,1
1638032,1583958,91,97,3942,0,4033,97,1
471706,2691265,794,32,65616,0,66410,32,1
2497238,3480883,251,41,2806,0,3057,41,1
1476977,2581195,178,31,1993,0,2171,31,1
873006,1634056,375,35,33630,0,34005,35,1
3280389,1111740,1101,2,411419,0,412520,2,1
3522049,2294648,301,136,12347,0,12648,136,1
3935596,4326021,70,140,1624,0,1694,140,1
978797,4760768,599,110,12421,0,13020,110,1
4140279,577332,337,2,49384,0,49721,2,1
4686093,117107,181,7,1003,0,1184,7,1
4365300,732335,170,68,664,122,834,190,1
866357,4711415,825,15,18479,0,19304,15,1
1839283,1145205,765,25,36658,0,37423,25,1
3395938,3887181,546,66,39878,0,40424,66,1
3235479,894057,999,38,66486,0,67485,38,1
3271898,2015205,227,37,2028,0,2255,37,1
3437784,2462782,94,44,577,0,671,44,1
1973082,156455,1036,19,18915,0,19951,19,1
1494665,338412,668,190,37638,0,38306,190,1
3377075,136289,78,76,716,0,794,76,1
3361377,1430416,4841,2,761793,0,766634,2,1
4187681,867433,192,42,2368,0,2560,42,1
3118804,3743098,315,121,6025,0,6340,121,1
3734245,650427,915,13,34965,0,35880,13,1
4417253,2568016,1130,42,68389,0,69519,42,1
3294702,1917835,991,110,68888,0,69879,110,1
1591435,4278761,387,37,31245,0,31632,37,1
3361377,4195170,4841,3,761793,0,766634,3,1
4411870,1659814,948,164,60517,0,61465,164,1
1533546,3298899,703,10,22095,0,22798,10,1
3936039,2338518,799,3,23884,0,24683,3,1
2075015,4024321,2664,73,85781,0,88445,73,1
3739473,3787892,448,27,13226,0,13674,27,1
4525011,1700556,172,8,6076,0,6248,8,1
837553,4129834,1249,50,61665,0,62914,50,1
4479896,1807294,52,46,1132,0,1184,46,1
1471685,3979046,1681,142,25550,0,27231,142,1
3396408,3973293,118,325,2302,2788,2420,3113,1
3462923,409915,369,32,817,0,1186,32,1
3361377,2029271,4841,1,761793,0,766634,1,1
519175,1048874,173,54,7221,0,7394,54,1
130129,1835845,38,6,442,0,480,6,1
1031334,4394799,459,7,16840,0,17299,7,1
4191727,2379739,463,202,26315,0,26778,202,1
4653941,2068970,951,1,45883,0,46834,1,1
2981537,3928008,1252,2,118718,0,119970,2,1
813554,4779044,252,580,17214,0,17466,580,1
1192480,2352725,397,1,20737,0,21134,1,1
1196844,4674405,548,38,36289,0,36837,38,1
2887240,2205433,1143,6,118405,0,119548,6,1
80085,3520024,75,512,2925,0,3000,512,1
2851109,1290780,450,115,98552,0,99002,115,1
427805,345697,483,2,156906,0,157389,2,1
4080770,2542400,61,4,304,0,365,4,1
3823068,411982,166,42,206,0,372,42,1
3065808,477879,1235,76,82317,0,83552,76,1
3509903,4094093,1530,1,509445,0,510975,1,1
3509903,2698677,1530,1,509445,0,510975,1,1
1539837,288175,1127,32,62979,0,64106,32,1
2260014,3685069,2466,1,98622,0,101088,1,1
1633022,783857,246,91,23530,0,23776,91,1
3923156,2333159,261,131,1070,0,1331,131,1
2809094,3698822,143,163,1851,0,1994,163,1
3361377,2003474,4841,1,761793,0,766634,1,1
2405789,1815040,1010,10,93387,0,94397,10,1
1927211,3944302,1668,26,113322,0,114990,26,1
3645402,288249,153,339,7400,0,7553,339,1
1822179,365217,18,12,47,34,65,46,1
3429121,2695129,166,53,1829,0,1995,53,1
1819285,2940588,279,554,1596,9477,1875,10031,1
3845119,913402,461,166,28609,0,29070,166,1
4209323,3992865,1630,908,89460,0,91090,908,1
3531730,2321781,334,56,9763,0,10097,56,1
2529661,479607,493,3,27309,0,27802,3,1
439557,3817971,2090,12,61744,0,63834,12,1
530200,1716841,2035,3,62809,0,64844,3,1
1790685,4758904,111,219,425,0,536,219,1
4524689,2891995,491,6,3821,0,4312,6,1
1927211,3709685,1668,3,113322,0,114990,3,1
1192480,1075691,397,3,20737,0,21134,3,1
3435785,2469184,220,47,1519,0,1739,47,1
1539837,314078,1127,34,62979,0,64106,34,1
2535203,2544030,138,185,271,241,409,426,1
1927211,4131593,1668,32,113322,0,114990,32,1
487744,3554086,138,41,2488,0,2626,41,1
3368608,4116336,190,7,976,0,1166,7,1
2261139,3071916,2014,108,42851,0,44865,108,1
2638491,3940115,144,111,648,462,792,573,1
3734245,2931688,915,68,34965,0,35880,68,1
4011264,2662809,1360,303,116777,10704,118137,11007,1
3098318,1337853,230,1795,1307,107,1537,1902,1
781211,198101,976,9,51781,0,52757,9,1
2658383,4501658,28,1,57,0,85,1,1
2202415,999843,113,14,1713,0,1826,14,1
427805,3257896,483,1,156906,0,157389,1,1
2462345,4494827,68,17,1047,0,1115,17,1
4078755,3821127,239,62,833,0,1072,62,1
4114692,2170093,113,28,1885,0,1998,28,1
978797,1579534,599,71,12421,0,13020,71,1
253352,1533073,237,130,10413,0,10650,130,1
1327933,4800736,866,143,4229,0,5095,143,1
2961801,4057589,1483,59,101962,0,103445,59,1
752618,3221185,169,1,5929,0,6098,1,1
4009202,1094734,44,223,158,1328,202,1551,1
1534362,2406351,1531,29,105859,0,107390,29,1
501914,3615009,217,11,5217,0,5434,11,1
3765475,302498,873,1,107914,0,108787,1,1
1373960,3809886,34,1054,182,0,216,1054,1
2833090,2812333,22,61,654,0,676,61,1
3438576,1443370,3424,61,137753,0,141177,61,1
4624595,1795900,722,22,53368,0,54090,22,1
1580988,991155,2821,232,400133,0,402954,232,1
3449530,2183779,717,4,73648,0,74365,4,1
466167,4752751,76,2,876,0,952,2,1
1730758,2663866,82,193,1286,0,1368,193,1
380997,3685177,40,4,1999,0,2039,4,1
3235479,123892,999,35,66486,0,67485,35,1
4816740,3433195,141,64,7750,0,7891,64,1
4618437,1499466,372,208,743,0,1115,208,1
1055530,2506101,415,68,14969,0,15384,68,1
2147720,2135156,1608,71,78786,0,80394,71,1
1534362,3175654,1531,9,105859,0,107390,9,1
3857537,1698037,1008,621,5225,272,6233,893,1
4295952,307536,808,76,57369,0,58177,76,1
2343253,4364133,1882,8,86401,0,88283,8,1
1683313,3139725,267,58,223,61,490,119,1
1787075,4180166,894,2,28305,0,29199,2,1
1966548,753600,208,1,53149,0,53357,1,1
4866488,1436912,117,30,1117,0,1234,30,1
4653941,3703271,951,9,45883,0,46834,9,1
3129073,3334911,35,3,1847,0,1882,3,1
4809559,715237,297,41,3171,0,3468,41,1
1549334,1234630,81,16,6693,0,6774,16,1
3115867,1340999,1350,410,61232,0,62582,410,1
3906136,1212386,387,57,41169,0,41556,57,1
3206499,166726,1337,82,32033,165,33370,247,1
3765475,4783427,873,1,107914,0,108787,1,1
3638272,1955835,2022,1,370904,0,372926,1,1
4013601,1749384,653,60,14886,0,15539,60,1
1759632,2222373,98,29,837,0,935,29,1
2052930,153681,407,30,8479,0,8886,30,1
4138257,3496107,150,154,1542,0,1692,154,1
22275,4643553,34,15,180,0,214,15,1
805360,3891717,1514,135,119306,0,120820,135,1
752551,2167660,460,1,3526,0,3986,1,1
4433539,3360107,165,15,1642,0,1807,15,1
4055860,3616329,24,39,1999,0,2023,39,1
2464401,3219045,577,77,23681,0,24258,77,1
3514277,2025700,1338,56,13269,0,14607,56,1
2649949,2687892,79,35,866,0,945,35,1
3501482,2118450,522,2,28046,0,28568,2,1
4249273,2000752,225,1592,3063,162,3288,1754,1
3449530,1334016,717,76,73648,0,74365,76,1
2881894,4437424,211,157,7468,0,7679,157,1
2981537,1662689,1252,2,118718,0,119970,2,1
2031305,3082163,396,318,23435,0,23831,318,1
3280389,3826104,1101,1,411419,0,412520,1,1
1533546,2031058,703,2,22095,0,22798,2,1
3168320,365846,309,86,1904,0,2213,86,1
3765475,3954194,873,1,107914,0,108787,1,1
4160309,1177513,5,11,34,69,39,80,1
1151593,3987877,231,25,5501,0,5732,25,1
105414,1709532,201,26,2136,0,2337,26,1
873006,2642631,375,66,33630,0,34005,66,1
471706,1874006,794,6,65616,0,66410,6,1
4773965,3056240,22,60,357,0,379,60,1
2779329,335033,217,189,6021,0,6238,189,1
3765475,3382533,873,4,107914,0,108787,4,1
2881894,4225972,211,15,7468,0,7679,15,1
2528239,2427353,196,49,1630,158,1826,207,1
907654,4130891,798,70,24575,0,25373,70,1
4238001,3057213,869,25,61161,0,62030,25,1
3073465,3261493,80,23,1013,0,1093,23,1
2779329,502029,217,42,6021,0,6238,42,1
3509903,2109692,1530,2,509445,0,510975,2,1
4731849,1383024,455,123,10886,0,11341,123,1
4191410,1034993,1590,81,96434,0,98024,81,1
3645402,1179906,153,316,7400,14467,7553,14783,1
3280389,4020313,1101,2,411419,0,412520,2,1
1234540,679136,1071,29,75251,0,76322,29,1
2307868,2175192,1131,87,38777,0,39908,87,1
802229,1708634,168,2,3140,0,3308,2,1
4642569,4386986,872,31,27586,0,28458,31,1
3284566,3481133,112,78,215,0,327,78,1
1539837,3525370,1127,83,62979,0,64106,83,1
3065808,327161,1235,17,82317,0,83552,17,1
1516853,676755,426,1,10168,0,10594,1,1
866252,3049137,89,9,669,0,758,9,1
1276253,4176633,407,1,46534,0,46941,1,1
3361377,4777740,4841,1,761793,0,766634,1,1
3361377,4612582,4841,1,761793,0,766634,1,1
2608279,610015,139,84,1158,0,1297,84,1
2827436,3301515,882,116,271525,0,272407,116,1
4853234,1713652,1256,24,29554,0,30810,24,1
1100354,2414247,163,1,24439,0,24602,1,1
3866441,3024013,261,98,3655,0,3916,98,1
3671141,2969340,1444,21,48400,0,49844,21,1
439557,2067728,2090,88,61744,0,63834,88,1
3907996,4330391,485,773,18964,32759,19449,33532,1
2798865,2313585,25,28,2109,0,2134,28,1
3687184,2584855,8,27,170,0,178,27,1
1325245,2990868,144,133,5103,0,5247,133,1
3638272,3877203,2022,1,370904,0,372926,1,1
4314280,4767175,568,80,9552,0,10120,80,1
4087774,534491,578,112,10107,0,10685,112,1
2707591,3250735,162,196,2360,0,2522,196,1
214631,984515,319,40,2590,0,2909,40,1
4179343,2507635,119,183,9822,0,9941,183,1
670296,2409396,632,125,10586,0,11218,125,1
2827436,4362031,882,4,271525,0,272407,4,1
2553405,3532881,568,14,12913,0,13481,14,1
2940706,2601919,31,5,845,0,876,5,1
3705070,4115387,740,5,14938,0,15678,5,1
3397281,3433470,743,12,15050,0,15793,12,1
1659017,1765741,817,108,13055,0,13872,108,1
4385783,97992,290,2,10995,0,11285,2,1
4272102,1557498,1608,51,104171,0,105779,51,1
1250021,1657839,4637,116,85913,0,90550,116,1
2107861,680267,535,61,25743,0,26278,61,1
4619326,3910844,539,43,22721,0,23260,43,1
288324,1653115,90,1,1983,0,2073,1,1
31819,1174691,75,4,3334,0,3409,4,1
2827436,1446929,882,1,271525,0,272407,1,1
3449530,40702,717,23,73648,0,74365,23,1
1276425,2900646,102,1,8318,0,8420,1,1
1723494,2884705,13,649,164,10233,177,10882,1
474172,3730671,471,5,38713,0,39184,5,1
3271484,4142692,1507,12,34093,0,35600,12,1
3361377,3927277,4841,8,761793,0,766634,8,1
755739,4278860,1117,151,58043,0,59160,151,1
584906,1827486,253,42,6639,0,6892,42,1
4624595,2419195,722,63,53368,0,54090,63,1
4209323,4736929,1630,151,89460,0,91090,151,1
2781817,3713587,704,49,24613,0,25317,49,1
3734245,1637447,915,555,34965,8549,35880,9104,1
3836080,2407412,1197,200,59457,0,60654,200,1
3361377,2328510,4841,3,761793,0,766634,3,1
2827436,2505988,882,30,271525,0,272407,30,1
2989110,77141,1042,62,19283,0,20325,62,1
3943091,1326732,53,2,10283,0,10336,2,1
3765475,679631,873,1,107914,0,108787,1,1
3280389,3231289,1101,1,411419,0,412520,1,1
3361377,781908,4841,1,761793,0,766634,1,1
2263130,559100,712,53,14043,0,14755,53,1
4492248,4092142,237,22,17127,0,17364,22,1
4496449,2442931,174,184,4260,0,4434,184,1
141367,4525882,17,1,963,0,980,1,1
3884904,1029304,61,45,1946,0,2007,45,1
4238001,698643,869,140,61161,0,62030,140,1
3636190,3803049,119,164,4195,0,4314,164,1
4373497,2260014,10,2466,238,98622,248,101088,1
2632863,3259216,15,11,161,0,176,11,1
2263130,4460845,712,27,14043,0,14755,27,1
4269771,2535087,85,1,2600,0,2685,1,1
250177,2586149,330,826,3969,0,4299,826,1
3361377,4611686,4841,1,761793,0,766634,1,1
3361377,1698966,4841,3,761793,0,766634,3,1
4110535,35786,395,54,7311,0,7706,54,1
2985909,2048861,706,39,43348,0,44054,39,1
4140279,2731895,337,1,49384,0,49721,1,1
755739,139925,1117,80,58043,0,59160,80,1
2542968,591854,444,7,4728,0,5172,7,1
3361377,919041,4841,1,761793,0,766634,1,1
3426941,832523,77,2,552,0,629,2,1
3112136,3458496,406,227,41366,0,41772,227,1
2751572,1102499,481,54,44036,0,44517,54,1
630220,3992579,594,105,2886,0,3480,105,1
2339149,3989512,97,126,4258,0,4355,126,1
2516076,11624,1455,53,77782,0,79237,53,1
1355114,1402567,47,51,2747,0,2794,51,1
2945264,3012999,28,12,1524,0,1552,12,1
3395938,1992631,546,1,39878,0,40424,1,1
2698749,4017917,108,352,2511,0,2619,352,1
2727581,1713872,757,158,7394,0,8151,158,1
3038921,480196,240,83,1721,269,1961,352,1
279511,881600,50,1,397,0,447,1,1
763435,794830,100,49,673,0,773,49,1
3657968,4098265,22,1,4208,0,4230,1,1
151034,1180357,54,47,494,0,548,47,1
2827436,1932215,882,6,271525,0,272407,6,1
3398118,1382038,49,2,1466,0,1515,2,1
4011264,4529953,1360,81,116777,0,118137,81,1
333786,11821,18,3,982,0,1000,3,1
805360,4382381,1514,76,119306,0,120820,76,1
1926532,2718211,336,224,9127,0,9463,224,1
3961386,2307351,7,191,51,173,58,364,1
2940588,3042608,554,211,9477,0,10031,211,1
2516076,1927763,1455,66,77782,0,79237,66,1
3438576,2449479,3424,34,137753,0,141177,34,1
3280389,1048064,1101,21,411419,0,412520,21,1
3849054,1672646,417,42,13259,0,13676,42,1
3438576,4765846,3424,75,137753,0,141177,75,1
226540,2098276,463,48,10650,0,11113,48,1
1163500,3128197,398,122,9540,6176,9938,6298,1
1638032,1402008,91,119,3942,0,4033,119,1
4319972,1842777,640,36,35279,0,35919,36,1
3509903,2752944,1530,14,509445,0,510975,14,1
4492248,1572946,237,45,17127,0,17364,45,1
1575009,4238584,429,11,37745,0,38174,11,1
948768,4169205,587,63,14768,0,15355,63,1
3857366,1645457,4,8,42,0,46,8,1
1931826,1773894,25,42,160,184,185,226,1
4113414,923395,403,223,3521,0,3924,223,1
471706,2807888,794,5,65616,0,66410,5,1
1471685,259467,1681,45,25550,0,27231,45,1
3638272,1626983,2022,1,370904,0,372926,1,1
797068,4579906,46,90,926,1938,972,2028,1
4492248,622611,237,34,17127,0,17364,34,1
3872736,1951737,258,36,12660,0,12918,36,1
4387278,2785521,6,9,1963,0,1969,9,1
1533314,3889015,361,239,6007,0,6368,239,1
4423184,2458232,384,23,29809,0,30193,23,1
1652056,1186782,326,7,66845,0,67171,7,1
2205217,2336614,152,12,2768,0,2920,12,1
3914135,1921989,2152,88,60084,0,62236,88,1
4191727,423596,463,18,26315,0,26778,18,1
1880135,2388909,810,7,71924,0,72734,7,1
3699379,3501270,71,214,898,2145,969,2359,1
186619,2603193,12,12,229,0,241,12,1
3185258,4757925,77,54,435,0,512,54,1
1633022,424213,246,1,23530,0,23776,1,1
4011264,546013,1360,45,116777,0,118137,45,1
1086912,233611,907,127,33396,326,34303,453,1
2148937,3144190,672,5,47361,0,48033,5,1
1900620,845389,59,5,1163,0,1222,5,1
1611386,896759,187,4,10932,0,11119,4,1
3235479,2892433,999,46,66486,0,67485,46,1
2157608,2265275,50,2,528,0,578,2,1
4272102,1084623,1608,2,104171,0,105779,2,1
283907,1702203,401,48,1992,0,2393,48,1
3638272,4453267,2022,1,370904,0,372926,1,1
3734245,3062753,915,1,34965,0,35880,1,1
3638272,4676269,2022,1,370904,0,372926,1,1
584906,708091,253,237,6639,0,6892,237,1
883836,199099,421,66,1380,0,1801,66,1
2980119,4379876,154,10,2068,0,2222,10,1
3390049,2127348,106,1,730,0,836,1,1
1223970,2998856,45,1,1232,0,1277,1,1
3638272,1218706,2022,1,370904,0,372926,1,1
4485028,1885719,445,71,14565,0,15010,71,1
4011264,672855,1360,4,116777,0,118137,4,1
6618,351525,892,39,68849,0,69741,39,1
595757,3660554,340,97,26738,0,27078,97,1
4762204,3302638,2239,148,4518,512,6757,660,1
1201711,1263329,357,82,15948,0,16305,82,1
4488849,3684641,136,62,4704,0,4840,62,1
1983211,2108722,136,61,1225,0,1361,61,1
1769943,1241192,553,12,7901,0,8454,12,1
3361377,55055,4841,2,761793,0,766634,2,1
3384074,1822030,72,63,1677,0,1749,63,1
4423184,3055648,384,23,29809,0,30193,23,1
4624595,2076992,722,34,53368,0,54090,34,1
2377014,4471573,229,1218,1174,0,1403,1218,1
3375887,1752546,119,10,2874,0,2993,10,1
3646313,4070847,148,34,1632,0,1780,34,1
427805,4760573,483,2,156906,0,157389,2,1
1652056,799262,326,1,66845,0,67171,1,1
4603867,3060625,15,143,1132,0,1147,143,1
862958,4664024,87,240,4203,0,4290,240,1
3199242,4262880,210,50,197,0,407,50,1
1689502,3866609,63,7,3676,0,3739,7,1
917130,1845514,325,2,7017,0,7342,2,1
2307868,2819441,1131,91,38777,0,39908,91,1
2827436,1729225,882,3,271525,0,272407,3,1
2897926,877379,565,2,25983,0,26548,2,1
3906136,2086550,387,16,41169,0,41556,16,1
3144238,1139447,326,43,28455,0,28781,43,1
4411870,111171,948,582,60517,0,61465,582,1
4751453,4769528,520,469,27570,0,28090,469,1
3361377,2563030,4841,1,761793,0,766634,1,1
755739,922030,1117,15,58043,0,59160,15,1
65845,679176,411,40,4088,0,4499,40,1
2474070,3703387,102,7,2421,0,2523,7,1
4295952,2892061,808,16,57369,0,58177,16,1
657387,1871455,47,4,2455,0,2502,4,1
2405789,3744141,1010,35,93387,0,94397,35,1
4103612,1458617,932,10,5655,0,6587,10,1
2283004,3095600,143,12,2253,0,2396,12,1
3509214,4732775,263,16,14139,0,14402,16,1
4411870,2553814,948,36,60517,0,61465,36,1
2492402,4411743,336,74,1778,0,2114,74,1
2887240,833056,1143,4,118405,0,119548,4,1
4519298,4268729,577,4,14443,0,15020,4,1
1623852,1317228,85,29,495,0,580,29,1
2751572,3026155,481,53,44036,0,44517,53,1
2267633,2586923,422,32,13247,0,13669,32,1
1992276,8490,92,33,428,0,520,33,1
805360,4002890,1514,32,119306,0,120820,32,1
1100354,3543314,163,1,24439,0,24602,1,1
4338437,2869651,185,1,883,0,1068,1,1
3137585,1039183,1196,65,77354,0,78550,65,1
4272102,3039314,1608,21,104171,0,105779,21,1
1879936,4313209,281,138,6786,0,7067,138,1
1609659,252905,523,218,29763,4356,30286,4574,1
4230144,701808,216,186,4435,0,4651,186,1
3501482,2891582,522,34,28046,0,28568,34,1
3449530,4412108,717,37,73648,0,74365,37,1
1479308,3265442,83,2,480,0,563,2,1
1539837,553620,1127,89,62979,0,64106,89,1
2206273,261034,235,97,4892,0,5127,97,1
3230198,2868132,16,1,152,0,168,1,1
966488,4733778,7,265,247,99,254,364,1
4838376,3867148,606,178,26838,0,27444,178,1
3361377,2307247,4841,1,761793,0,766634,1,1
4624595,3814378,722,50,53368,0,54090,50,1
2950311,604459,807,62,85116,0,85923,62,1
2623062,4007763,247,129,2203,0,2450,129,1
60980,3263104,649,49,20708,0,21357,49,1
1086912,576913,907,103,33396,0,34303,103,1
940526,1694286,475,182,20786,0,21261,182,1
670309,361614,304,2,7567,0,7871,2,1
2064376,2492500,139,1,5873,0,6012,1,1
1966548,4627551,208,2,53149,0,53357,2,1
1966548,4482375,208,2,53149,0,53357,2,1
4295952,2411225,808,155,57369,0,58177,155,1
4013053,1617861,33,31,1781,0,1814,31,1
592541,1240219,132,2,6913,0,7045,2,1
3361377,3444967,4841,1,761793,0,766634,1,1
4747241,789762,92,33,1449,0,1541,33,1
1436216,3144138,1068,12,68770,0,69838,12,1
3683235,4705022,311,6,23110,0,23421,6,1
2263130,1128722,712,100,14043,0,14755,100,1
2409175,2342884,42,18,304,0,346,18,1
2828297,3721727,24,82,1212,0,1236,82,1
2827436,3857639,882,1,271525,0,272407,1,1
3914135,926628,2152,34,60084,0,62236,34,1
1190435,1459948,432,81,3922,0,4354,81,1
4191410,2522459,1590,87,96434,0,98024,87,1
4818002,1501265,153,54,155,1536,308,1590,1
3638272,1208372,2022,36,370904,0,372926,36,1
2981537,283652,1252,10,118718,0,119970,10,1
3361377,2731295,4841,3,761793,0,766634,3,1
1717922,3640261,432,119,6340,399,6772,518,1
1201755,4512117,68,21,129,0,197,21,1
3196195,3059169,289,7,1305,0,1594,7,1
1449540,4463716,32,2,1632,0,1664,2,1
3119726,1060295,299,341,11573,0,11872,341,1
4463545,2326401,94,114,3842,0,3936,114,1
3849054,1869791,417,1,13259,0,13676,1,1
3116124,1259003,6,2,1168,0,1174,2,1
1428477,2355493,255,2,15459,0,15714,2,1
3844858,3403819,1591,448,28974,0,30565,448,1
3638272,2682999,2022,9,370904,0,372926,9,1
755739,1732732,1117,76,58043,0,59160,76,1
755739,2506101,1117,68,58043,0,59160,68,1
459115,1939892,75,1,757,0,832,1,1
954784,254570,567,53,14450,0,15017,53,1
867231,3371346,318,1,1675,0,1993,1,1
2851109,114552,450,4,98552,0,99002,4,1
3638272,1908075,2022,3,370904,0,372926,3,1
4582129,30814,1231,18,10356,0,11587,18,1
878715,2366758,100,1,1976,0,2076,1,1
2887240,2326220,1143,1,118405,0,119548,1,1
3881566,2840469,781,162,14176,0,14957,162,1
4417253,4277059,1130,5,68389,0,69519,5,1
1351713,4104307,38,18,1748,0,1786,18,1
2772113,4402525,792,24,42907,0,43699,24,1
2687552,613299,238,25,25574,0,25812,25,1
4423184,3678577,384,16,29809,0,30193,16,1
2827436,4097748,882,1,271525,0,272407,1,1
1051108,1337643,262,79,7542,0,7804,79,1
1503116,1803773,415,12,37079,0,37494,12,1
3287083,3378572,66,33,298,0,364,33,1
1311397,788286,164,191,984,0,1148,191,1
2516076,3996324,1455,11,77782,0,79237,11,1
2343253,912281,1882,2,86401,0,88283,2,1
3280389,1677611,1101,1,411419,0,412520,1,1
1521082,3874823,766,1,6562,0,7328,1,1
2887240,2954214,1143,2,118405,0,119548,2,1
3235479,4675991,999,62,66486,0,67485,62,1
4183784,2616371,931,57,59894,0,60825,57,1
3395938,4866413,546,24,39878,0,40424,24,1
3361377,203231,4841,20,761793,0,766634,20,1
858343,4371602,1103,1174,1075,0,2178,1174,1
1236684,4295103,163,250,394,0,557,250,1
3379358,119190,44,3,3147,0,3191,3,1
3509903,1111542,1530,1,509445,0,510975,1,1
3163452,3774902,84,10,297,0,381,10,1
3361377,1824606,4841,1,761793,0,766634,1,1
4191410,2012674,1590,50,96434,0,98024,50,1
2375878,1417465,248,80,14925,0,15173,80,1
4644889,363750,144,1001,3031,10994,3175,11995,1
69534,2819220,60,1,4328,0,4388,1,1
471706,747932,794,3,65616,0,66410,3,1
1652056,3330903,326,4,66845,0,67171,4,1
2887240,868942,1143,5,118405,0,119548,5,1
1580988,1314513,2821,7,400133,0,402954,7,1
94742,3954325,264,1743,1526,16616,1790,18359,1
4278775,4694074,24,26,832,0,856,26,1
530200,2471996,2035,8,62809,0,64844,8,1
3361377,4302515,4841,5,761793,0,766634,5,1
4138472,4283654,17,551,124,206,141,757,1
2098387,2595212,182,4,1892,0,2074,4,1
2147720,3242842,1608,110,78786,0,80394,110,1
630220,696047,594,48,2886,0,3480,48,1
4585614,4610508,24,124,207,0,231,124,1
2985909,1908387,706,85,43348,0,44054,85,1
1569537,4676145,24,168,350,0,374,168,1
4290840,2456882,118,3,661,0,779,3,1
1250021,1061252,4637,19,85913,0,90550,19,1
3361377,3767947,4841,10,761793,0,766634,10,1
3638272,3134776,2022,2,370904,0,372926,2,1
1545237,3831407,381,492,14327,0,14708,492,1
2887240,4297929,1143,3,118405,0,119548,3,1
1545237,480928,381,17,14327,0,14708,17,1
3142164,1216838,51,585,1180,0,1231,585,1
3397281,1715758,743,43,15050,0,15793,43,1
3058068,836614,124,12,12734,0,12858,12,1
3638272,2124429,2022,3,370904,0,372926,3,1
3824547,3940333,1075,2,14337,0,15412,2,1
2547306,431377,171,28,1899,0,2070,28,1
3742930,4763566,410,215,22242,0,22652,215,1
3758019,1844296,189,319,2783,0,2972,319,1
4209323,1214297,1630,58,89460,0,91090,58,1
2075015,4003047,2664,137,85781,0,88445,137,1
2336530,91412,250,91,1103,193,1353,284,1
1436216,1923090,1068,61,68770,0,69838,61,1
273363,4642201,768,95,11045,0,11813,95,1
3451450,2744974,27,2,197,0,224,2,1
3361377,594437,4841,2,761793,0,766634,2,1
294412,3221680,41,34,283,0,324,34,1
3999673,3768505,6,12,60,0,66,12,1
2850994,2044088,113,226,2548,0,2661,226,1
3386313,1575784,12,22,152,0,164,22,1
3291396,4790058,195,370,11502,0,11697,370,1
4598655,2309618,155,980,1038,5354,1193,6334,1
4070413,685322,175,321,363,0,538,321,1
1580988,4452910,2821,14,400133,0,402954,14,1
71779,1845457,172,22,1404,0,1576,22,1
2441262,459879,136,197,1665,0,1801,197,1
4079090,4520863,53,3432,178,908,231,4340,1
67454,1732357,515,242,5700,0,6215,242,1
4360960,139399,1642,27,110084,0,111726,27,1
427805,4748435,483,2,156906,0,157389,2,1
4712782,4656210,171,34,4681,0,4852,34,1
3509903,1620513,1530,2,509445,0,510975,2,1
1301815,2294617,752,14,48944,0,49696,14,1
3021112,309883,472,27,6183,0,6655,27,1
3280389,4234362,1101,1,411419,0,412520,1,1
3598710,2743339,62,1,1896,0,1958,1,1
2405789,2981687,1010,28,93387,0,94397,28,1
4653941,4493165,951,32,45883,0,46834,32,1
2202415,4749097,113,2,1713,0,1826,2,1
3514277,879052,1338,40,13269,0,14607,40,1
3633019,774089,746,119,32317,0,33063,119,1
3742930,1836958,410,48,22242,0,22652,48,1
4435816,3745930,262,2,8391,0,8653,2,1
354904,1163436,3193,22,105780,0,108973,22,1
4238001,4527968,869,101,61161,0,62030,101,1
1927211,88794,1668,23,113322,0,114990,23,1
3371579,77730,204,72,1218,0,1422,72,1
2861639,4847923,481,204,10848,0,11329,204,1
4054724,2541607,20,3,435,0,455,3,1
363750,2842320,1001,47,10994,0,11995,47,1
65198,1892115,17,13,78,0,95,13,1
3361377,1193223,4841,3,761793,0,766634,3,1
1580988,2911253,2821,721,400133,1925,402954,2646,1
92352,2385543,1138,20,20575,0,21713,20,1
466194,2184137,268,6,91,0,359,6,1
256736,668364,76,551,271,76,347,627,1
4140279,4406360,337,1,49384,0,49721,1,1
3051212,132512,957,39,8349,0,9306,39,1
151693,57574,436,289,12181,4616,12617,4905,1
917806,1503702,1,276,432,0,433,276,1
4799966,357436,557,18,4819,0,5376,18,1
837553,796286,1249,51,61665,0,62914,51,1
1927211,4733583,1668,41,113322,0,114990,41,1
1103332,1248571,732,60,59415,0,60147,60,1
4479896,4784956,52,1,1132,0,1184,1,1
4817410,2040979,31,2,1422,0,1453,2,1
3569617,1914733,160,1,3695,0,3855,1,1
354904,3984653,3193,6,105780,0,108973,6,1
2950311,2811130,807,10,85116,0,85923,10,1
135188,982444,51,1,5860,0,5911,1,1
4636722,2367582,86,61,570,0,656,61,1
1015986,196817,604,522,14201,81,14805,603,1
3449530,706173,717,24,73648,0,74365,24,1
4782707,4587405,513,622,31665,0,32178,622,1
501914,2960508,217,1336,5217,0,5434,1336,1
1503116,3539630,415,80,37079,0,37494,80,1
4656799,4163258,187,40,2411,0,2598,40,1
4624595,340869,722,78,53368,0,54090,78,1
1486758,1248005,337,37,11346,0,11683,37,1
1654099,416439,1180,31,26347,0,27527,31,1
1466231,851611,408,54,3853,0,4261,54,1
3182882,1731883,54,186,765,0,819,186,1
3395938,2414474,546,66,39878,0,40424,66,1
3144238,120690,326,77,28455,0,28781,77,1
4295952,2641583,808,24,57369,0,58177,24,1
1911757,4844515,120,242,349,923,469,1165,1
4307962,4473363,18,2,425,0,443,2,1
4853234,2820949,1256,4,29554,0,30810,4,1
4798192,4656771,816,33,20426,0,21242,33,1
3881634,4392239,641,108,8471,561,9112,669,1
4013601,3421059,653,66,14886,0,15539,66,1
3765475,83871,873,5,107914,0,108787,5,1
2075015,2160987,2664,109,85781,0,88445,109,1
2872979,2549459,341,118,28510,0,28851,118,1
1580988,2933026,2821,1,400133,0,402954,1,1
55758,4860578,48,24,318,0,366,24,1
324108,2345899,113,346,618,1736,731,2082,1
4209323,744041,1630,58,89460,0,91090,58,1
3873768,3894432,449,114,35424,0,35873,114,1
3449530,1660893,717,37,73648,0,74365,37,1
1436174,3189318,105,4,9512,0,9617,4,1
3280389,678327,1101,2,411419,0,412520,2,1
2075015,570928,2664,2,85781,0,88445,2,1
1761428,72045,112,59,2469,0,2581,59,1
627727,627147,56,4,2488,0,2544,4,1
1103332,1266381,732,25,59415,0,60147,25,1
1580988,683695,2821,1,400133,0,402954,1,1
3271484,2477524,1507,16,34093,0,35600,16,1
2220873,374583,19,3,268,0,287,3,1
2261139,1302223,2014,5,42851,0,44865,5,1
3454888,1418004,162,11,7886,0,8048,11,1
1205168,3687185,662,94,7710,0,8372,94,1
2305236,1409220,248,36,424,43,672,79,1
1469880,3797392,275,55,3409,0,3684,55,1
3280389,1613885,1101,2,411419,0,412520,2,1
3346033,3533441,320,21,9541,0,9861,21,1
2735016,1505995,53,7,1112,0,1165,7,1
4547438,3667074,1291,909,25237,0,26528,909,1
3361377,4627141,4841,2,761793,0,766634,2,1
3361377,3991593,4841,1,761793,0,766634,1,1
111922,3778862,303,4,6879,0,7182,4,1
2342664,1246452,1181,4,26502,0,27683,4,1
1633053,1409600,533,18,8638,0,9171,18,1
941509,1008163,106,9,3066,0,3172,9,1
2342664,4356421,1181,516,26502,0,27683,516,1
2590487,407108,438,279,3617,0,4055,279,1
4738916,2052444,1165,120,34124,0,35289,120,1
3570299,3318417,170,74,382,0,552,74,1
4140279,1019259,337,1,49384,0,49721,1,1
298564,4476681,662,26,6261,0,6923,26,1
151693,1926125,436,51,12181,0,12617,51,1
64357,2950470,309,38,6329,0,6638,38,1
3082645,1055480,932,204,1825,232,2757,436,1
2405789,2195894,1010,133,93387,0,94397,133,1
3405059,2147720,261,1608,9604,78786,9865,80394,1
2548504,3215549,139,2,2001,0,2140,2,1
593740,4395213,1107,5,62807,0,63914,5,1
1436216,1701185,1068,1,68770,0,69838,1,1
1580988,51019,2821,3,400133,0,402954,3,1
1880135,3616789,810,34,71924,0,72734,34,1
2893334,2123555,889,61,30148,0,31037,61,1
4192206,4043016,468,681,18229,0,18697,681,1
2827436,2657984,882,57,271525,0,272407,57,1
964291,1001545,139,408,1427,0,1566,408,1
2256020,3682214,161,35,2964,0,3125,35,1
954784,884152,567,12,14450,0,15017,12,1
3765475,331820,873,5,107914,0,108787,5,1
3280389,2933273,1101,2,411419,0,412520,2,1
92352,805177,1138,33,20575,0,21713,33,1
4411870,653077,948,17,60517,0,61465,17,1
4117427,2195384,329,169,9639,0,9968,169,1
2791231,2509264,183,49,5221,0,5404,49,1
3361377,936673,4841,2,761793,0,766634,2,1
605874,1552611,145,15,3312,0,3457,15,1
3169674,2362583,73,48,715,0,788,48,1
948128,1962759,142,4,2383,0,2525,4,1
522588,4336669,496,41,20091,0,20587,41,1
2529661,1143412,493,339,27309,0,27802,339,1
1580988,3251128,2821,4,400133,0,402954,4,1
805360,44657,1514,57,119306,0,120820,57,1
4191410,2990250,1590,86,96434,0,98024,86,1
871344,155495,263,34,1863,0,2126,34,1
3509903,840004,1530,40,509445,0,510975,40,1
59609,3004250,2,852,100,339,102,1191,1
3638272,266190,2022,2,370904,0,372926,2,1
4349705,3305570,77,8,170,0,247,8,1
3873768,2986485,449,7,35424,0,35873,7,1
4807996,584631,90,19,1796,0,1886,19,1
4411870,1168244,948,12,60517,0,61465,12,1
2119827,669497,50,3,191,0,241,3,1
1580988,4257892,2821,2,400133,0,402954,2,1
1328699,1734959,83,83,1943,0,2026,83,1
1013469,2120930,2,3,89,0,91,3,1
837553,106110,1249,103,61665,0,62914,103,1
1723506,3440956,733,6,21835,0,22568,6,1
3509903,3019469,1530,2,509445,0,510975,2,1
2827436,3350694,882,3,271525,0,272407,3,1
2130979,4380716,452,74,4717,0,5169,74,1
4744679,2659073,247,122,3462,0,3709,122,1
3739473,2610722,448,78,13226,0,13674,78,1
1659017,2539729,817,29,13055,0,13872,29,1
4406088,2872034,21,11,1106,0,1127,11,1
1730094,886546,71,904,621,1080,692,1984,1
3765475,2767757,873,18,107914,0,108787,18,1
3638272,708530,2022,2,370904,0,372926,2,1
703912,4531646,119,39,5153,0,5272,39,1
1580988,80147,2821,91,400133,0,402954,91,1
4423184,2787735,384,2,29809,0,30193,2,1
4360960,3765105,1642,41,110084,0,111726,41,1
1534526,427384,51,2,1638,0,1689,2,1
1895382,1161487,227,40,121,0,348,40,1
2893334,3454055,889,2914,30148,54,31037,2968,1
755739,3077174,1117,36,58043,0,59160,36,1
1301515,82132,230,49,2378,0,2608,49,1
4238001,4710837,869,24,61161,0,62030,24,1
3766535,2946886,131,30,97,44,228,74,1
873006,3927007,375,83,33630,0,34005,83,1
3294702,4324588,991,134,68888,0,69879,134,1
2305014,2563745,10,1,606,0,616,1,1
2405789,1050771,1010,29,93387,0,94397,29,1
1580988,2316795,2821,1,400133,0,402954,1,1
3509903,787318,1530,2,509445,0,510975,2,1
3873768,3292173,449,199,35424,0,35873,199,1
3280389,2082824,1101,1,411419,0,412520,1,1
3294702,198491,991,45,68888,0,69879,45,1
1541866,4797113,542,70,16481,0,17023,70,1
948768,3232432,587,52,14768,0,15355,52,1
592541,3895039,132,27,6913,0,7045,27,1
4417253,461803,1130,52,68389,0,69519,52,1
4417102,2418403,32,1,356,0,388,1,1
932720,1142914,1411,44,111323,0,112734,44,1
3235479,1415824,999,33,66486,0,67485,33,1
3906136,3402545,387,253,41169,2083,41556,2336,1
4330391,3957832,773,31,32759,0,33532,31,1
474172,4394092,471,51,38713,0,39184,51,1
4555638,1583104,181,22,397,0,578,22,1
3742684,3278673,299,128,2003,810,2302,938,1
3361377,727417,4841,1,761793,0,766634,1,1
2646792,56490,86,457,2420,0,2506,457,1
354904,230456,3193,114,105780,0,108973,114,1
3463741,1590114,82,11,3948,0,4030,11,1
3638272,149747,2022,11,370904,0,372926,11,1
3343569,3486066,58,19,193,0,251,19,1
644902,2096270,267,970,1788,26018,2055,26988,1
515290,3429021,285,162,34080,0,34365,162,1
4191727,3632293,463,570,26315,21294,26778,21864,1
3764177,2906037,1036,4,64563,0,65599,4,1
2281149,68065,282,65,28082,0,28364,65,1
4398614,181551,6,12,28,0,34,12,1
3257465,4761322,541,9,27614,0,28155,9,1
3946789,3724401,261,15,5606,0,5867,15,1
2877907,1771658,508,93,16021,0,16529,93,1
1763959,1053177,76,293,504,3060,580,3353,1
3509903,3425679,1530,1,509445,0,510975,1,1
2428341,2390026,826,209,10151,0,10977,209,1
687713,1531467,436,11,47160,0,47596,11,1
4301252,2659280,118,2,2905,0,3023,2,1
3280389,1080324,1101,1,411419,0,412520,1,1
4101514,4142950,511,4,1676,0,2187,4,1
4360960,3910807,1642,28,110084,0,111726,28,1
4360960,3668069,1642,13,110084,0,111726,13,1
1501241,4614487,121,482,880,0,1001,482,1
2405789,2155897,1010,98,93387,0,94397,98,1
1580988,1077108,2821,1,400133,0,402954,1,1
1613202,3756187,566,16,8639,0,9205,16,1
2827436,4424518,882,99,271525,0,272407,99,1
4378981,126983,34,139,431,0,465,139,1
26760,4825729,179,106,2100,0,2279,106,1
3660280,3132939,110,1196,1083,481,1193,1677,1
4594361,2717500,103,27,3448,0,3551,27,1
250177,1611960,330,46,3969,0,4299,46,1
2405789,3730307,1010,14,93387,0,94397,14,1
2961552,4528992,562,16,16546,0,17108,16,1
1875,155377,656,8,61388,0,62044,8,1
3754637,6618,104,892,570,68849,674,69741,1
3509903,25003,1530,1,509445,0,510975,1,1
1887709,3490576,217,31,28983,0,29200,31,1
4604311,2542346,29,1,7472,0,7501,1,1
695505,1996513,98,42,2720,0,2818,42,1
1580988,4725403,2821,1,400133,0,402954,1,1
1595005,111729,209,134,481,584,690,718,1
2314038,579105,456,92,16347,0,16803,92,1
3115867,2244086,1350,7,61232,0,62582,7,1
1937293,4838376,434,606,16761,26838,17195,27444,1
1406120,199239,109,48,817,0,926,48,1
3128197,1031811,122,289,6176,0,6298,289,1
3709824,169781,165,3,450,0,615,3,1
3280389,1122966,1101,2,411419,0,412520,2,1
2949409,2214123,175,23,2185,0,2360,23,1
3569617,1771770,160,397,3695,0,3855,397,1
2075015,2829012,2664,61,85781,0,88445,61,1
2999799,364665,11,903,154,0,165,903,1
607449,3315859,380,301,19369,0,19749,301,1
1202593,4352414,93,1,5131,0,5224,1,1
4152075,2222625,232,6,355,0,587,6,1
3004174,4738265,258,61,5546,0,5804,61,1
4689808,4618102,280,19,14220,0,14500,19,1
376404,3825321,193,4,1790,21,1983,25,1
3361377,3539028,4841,2,761793,0,766634,2,1
1580508,1140872,720,4,19611,0,20331,4,1
1601507,3740009,129,14,6006,0,6135,14,1
2297625,335376,512,22,6498,0,7010,22,1
1377,4222352,92,121,788,0,880,121,1
2310265,3040576,241,6,6278,0,6519,6,1
3916976,4316797,188,15,6098,0,6286,15,1
3835618,501037,694,141,25433,0,26127,141,1
6618,3878505,892,42,68849,0,69741,42,1
603619,3994973,15,13,293,0,308,13,1
2075015,3090532,2664,40,85781,0,88445,40,1
3438576,1402674,3424,35,137753,0,141177,35,1
1250021,728746,4637,98,85913,0,90550,98,1
3010933,4026340,121,33,652,0,773,33,1
607449,1669682,380,63,19369,0,19749,63,1
1575009,2772604,429,34,37745,0,38174,34,1
1495135,1522338,70,22,250,0,320,22,1
455037,4200124,61,68,973,0,1034,68,1
748911,738808,435,7,687,0,1122,7,1
3765475,413501,873,2,107914,0,108787,2,1
4004339,1657665,153,13,6086,0,6239,13,1
4140279,3414863,337,1,49384,0,49721,1,1
1701926,2637247,42,22,162,0,204,22,1
907654,2572445,798,267,24575,0,25373,267,1
1360126,2704156,74,56,306,368,380,424,1
3872736,4535617,258,2,12660,0,12918,2,1
276502,1303835,30,2,2245,0,2275,2,1
1521082,1844864,766,139,6562,0,7328,139,1
414608,4625581,50,1,5531,0,5581,1,1
3298299,3091270,181,172,4843,0,5024,172,1
613620,1627563,141,195,2512,0,2653,195,1
3438483,1759085,155,37,284,0,439,37,1
1927211,1222696,1668,74,113322,0,114990,74,1
3361377,4059538,4841,1,761793,0,766634,1,1
1847461,4183347,1211,58,51149,0,52360,58,1
4333770,2986416,100,97,4077,0,4177,97,1
748019,878135,675,39,18480,0,19155,39,1
3765475,3874761,873,1,107914,0,108787,1,1
529022,1707567,69,25,589,0,658,25,1
6618,1746733,892,49,68849,0,69741,49,1
595757,3530123,340,266,26738,0,27078,266,1
1633022,1686460,246,1,23530,0,23776,1,1
748348,1629905,68,9,798,0,866,9,1
1839283,3061521,765,6,36658,0,37423,6,1
3992144,4092273,402,3,23683,0,24085,3,1
4680700,4237235,53,318,232,852,285,1170,1
1575009,216850,429,41,37745,0,38174,41,1
1843507,2572273,537,240,11729,1587,12266,1827,1
752551,3722921,460,193,3526,0,3986,193,1
4261,4792949,145,42,462,0,607,42,1
3112136,527452,406,2,41366,0,41772,2,1
1580988,3178628,2821,5,400133,0,402954,5,1
1063358,2526478,1350,54,63494,0,64844,54,1
2502456,2582269,719,58,50725,0,51444,58,1
1727783,4240692,110,126,306,0,416,126,1
1605802,664021,55,16,56,0,111,16,1
2879897,4459664,164,765,3212,0,3376,765,1
4022062,2176546,157,5,3780,0,3937,5,1
1397278,1769163,185,107,2295,0,2480,107,1
4479581,3438895,601,235,19545,486,20146,721,1
938472,4576728,124,66,4326,0,4450,66,1
1301815,1205004,752,20,48944,0,49696,20,1
3638272,1349271,2022,1,370904,0,372926,1,1
3913751,2277195,229,96,5248,0,5477,96,1
3361377,1156805,4841,86,761793,0,766634,86,1
755739,4327088,1117,32,58043,0,59160,32,1
1604753,56295,78,1,3240,0,3318,1,1
4209323,2567938,1630,27,89460,0,91090,27,1
276216,2451520,312,110,12600,0,12912,110,1
1575009,4623698,429,4,37745,0,38174,4,1
844892,3854509,55,4,606,0,661,4,1
4077562,4008235,433,108,2723,0,3156,108,1
4189798,3865608,140,35,1874,0,2014,35,1
1534362,1549952,1531,13,105859,0,107390,13,1
627727,4285963,56,22,2488,0,2544,22,1
2310265,1871999,241,314,6278,0,6519,314,1
2772113,665119,792,47,42907,0,43699,47,1
2887240,4187022,1143,2,118405,0,119548,2,1
1063358,2053359,1350,184,63494,0,64844,184,1
932720,1194556,1411,68,111323,0,112734,68,1
4295952,1943710,808,76,57369,0,58177,76,1
1580988,2570937,2821,2,400133,0,402954,2,1
905894,4535653,268,16,1162,0,1430,16,1
2961801,1087809,1483,10,101962,0,103445,10,1
3561502,4263659,1144,41,68800,0,69944,41,1
3689183,2070613,5,7,249,0,254,7,1
3264096,352836,331,23,697,0,1028,23,1
6618,1976559,892,46,68849,0,69741,46,1
917130,1895133,325,584,7017,0,7342,584,1
2599181,3180867,116,5,632,51,748,56,1
2827436,2781159,882,3,271525,0,272407,3,1
211698,1601403,138,35,2131,395,2269,430,1
860473,428800,751,64,20450,0,21201,64,1
1223666,309423,89,38,1587,577,1676,615,1
3072769,1851556,187,160,3430,0,3617,160,1
1580988,525082,2821,3,400133,0,402954,3,1
537240,176013,131,795,779,2,910,797,1
3280389,504259,1101,1,411419,0,412520,1,1
3509903,3694126,1530,20,509445,0,510975,20,1
1124035,2248426,84,3,3736,0,3820,3,1
2307868,937058,1131,11,38777,0,39908,11,1
3509903,2677467,1530,1,509445,0,510975,1,1
2202731,742350,72,13,493,0,565,13,1
429643,257840,767,169,19668,0,20435,169,1
3298300,86055,128,56,4498,0,4626,56,1
2498087,4672310,1630,80,32582,0,34212,80,1
4853234,2886092,1256,42,29554,437,30810,479,1
3734245,3795653,915,5,34965,0,35880,5,1
3518336,1564177,9,85,683,0,692,85,1
3383533,546488,34,1,3290,0,3324,1,1
3672238,999788,518,80,12172,0,12690,80,1
3831803,758751,39,74,173,0,212,74,1
2388735,184933,403,270,4921,0,5324,270,1
2983753,194529,20,10,214,0,234,10,1
2569009,3293494,424,291,13423,0,13847,291,1
4220190,2132646,320,14,15994,0,16314,14,1
1681927,1458142,123,14,865,0,988,14,1
3509903,227180,1530,1,509445,0,510975,1,1
3065808,71532,1235,48,82317,0,83552,48,1
2877633,4484360,152,56,5044,0,5196,56,1
2214458,4670421,41,3,604,0,645,3,1
3657628,2391963,31,265,339,0,370,265,1
3881566,549033,781,313,14176,0,14957,313,1
2702724,2456575,566,868,10448,0,11014,868,1
3361377,4197737,4841,1,761793,0,766634,1,1
932720,1972972,1411,161,111323,0,112734,161,1
441667,558272,198,25,14727,0,14925,25,1
4721617,3073507,307,34,12885,0,13192,34,1
3361377,1389151,4841,39,761793,0,766634,39,1
1580988,902092,2821,2,400133,0,402954,2,1
3127090,1526691,678,2,10017,0,10695,2,1
298564,3606273,662,74,6261,0,6923,74,1
635435,914718,199,122,1985,0,2184,122,1
2050190,215134,153,4,9156,0,9309,4,1
4624595,1982629,722,2,53368,0,54090,2,1
805360,2634632,1514,16,119306,0,120820,16,1
4192206,1135600,468,333,18229,0,18697,333,1
522588,4396765,496,1,20091,0,20587,1,1
4547438,198672,1291,61,25237,0,26528,61,1
842476,4631759,898,62,12479,0,13377,62,1
3914135,3188541,2152,27,60084,0,62236,27,1
3449530,469524,717,28,73648,0,74365,28,1
1994281,4268239,139,1117,2492,124,2631,1241,1
1792816,3850197,246,89,1522,0,1768,89,1
4247921,801154,158,43,795,0,953,43,1
4191410,4826676,1590,99,96434,0,98024,99,1
781211,1895436,976,32,51781,0,52757,32,1
3549674,3113725,602,15,38542,0,39144,15,1
765601,3768494,1485,60,101510,0,102995,60,1
1050976,4799035,67,3,924,0,991,3,1
2516076,3997457,1455,147,77782,0,79237,147,1
911192,83610,106,27,6327,0,6433,27,1
4181344,2898368,95,602,381,208,476,810,1
2042569,3719851,358,95,1959,0,2317,95,1
2981537,2966616,1252,40,118718,0,119970,40,1
4443577,1413650,509,114,11936,0,12445,114,1
4360960,3372160,1642,137,110084,0,111726,137,1
4533186,4373340,66,602,112,0,178,602,1
3112136,739587,406,49,41366,0,41772,49,1
2793437,657555,582,5,25447,0,26029,5,1
1249227,257596,621,3,7423,0,8044,3,1
4780428,3960688,94,168,2777,0,2871,168,1
3501482,1507820,522,58,28046,0,28568,58,1
3676295,4619239,374,1,70881,0,71255,1,1
3633019,176119,746,102,32317,0,33063,102,1
462298,2157289,414,11,10933,0,11347,11,1
1606469,4263016,96,545,5210,0,5306,545,1
4751453,238127,520,85,27570,0,28090,85,1
2182964,3467617,214,9,6975,0,7189,9,1
3845119,3673086,461,156,28609,0,29070,156,1
2827436,1528369,882,1,271525,0,272407,1,1
3509903,4608081,1530,1,509445,0,510975,1,1
4721617,1968687,307,5,12885,0,13192,5,1
4624595,531701,722,7,53368,0,54090,7,1
4330386,1403586,278,119,1246,312,1524,431,1
2516076,2089459,1455,72,77782,0,79237,72,1
3065808,4590180,1235,43,82317,0,83552,43,1
2638491,1785162,144,710,648,50,792,760,1
1863920,4135599,54,1648,283,329,337,1977,1
3914135,295176,2152,3,60084,0,62236,3,1
1063358,1414262,1350,5,63494,0,64844,5,1
4174344,2145985,78,33,1046,0,1124,33,1
4183784,4781097,931,29,59894,0,60825,29,1
1871399,3650069,45,217,804,4118,849,4335,1
932720,3913261,1411,27,111323,0,112734,27,1
3633019,4042735,746,72,32317,0,33063,72,1
3561502,1157723,1144,114,68800,0,69944,114,1
1560049,4733760,1121,343,12468,0,13589,343,1
1341178,404375,899,6,16829,0,17728,6,1
765601,3813598,1485,492,101510,0,102995,492,1
2207174,3835450,11,421,39,26,50,447,1
4011264,387669,1360,31,116777,0,118137,31,1
2950311,3281695,807,9,85116,0,85923,9,1
4727207,3305264,925,2,84581,0,85506,2,1
4272102,3847543,1608,40,104171,0,105779,40,1
1474822,1911670,229,17,3952,0,4181,17,1
1734954,2398790,369,55,5786,0,6155,55,1
4560210,2999512,177,6,6565,0,6742,6,1
3280389,278197,1101,1,411419,0,412520,1,1
2994391,1945949,315,20,6520,0,6835,20,1
382977,4653745,143,52,5934,0,6077,52,1
3023958,1821035,72,1794,694,60,766,1854,1
1182973,3160057,26,2358,111,187,137,2545,1
3857537,4279433,1008,24,5225,0,6233,24,1
948768,1328996,587,74,14768,0,15355,74,1
1913445,369822,564,76,47943,0,48507,76,1
3525425,2772850,81,34,2773,0,2854,34,1
1730758,1118893,82,24,1286,0,1368,24,1
2269765,3024019,22,30,295,0,317,30,1
522588,2549949,496,6,20091,0,20587,6,1
3835618,4219573,694,16,25433,0,26127,16,1
4318206,1028905,251,162,13123,0,13374,162,1
3638272,4594017,2022,1,370904,0,372926,1,1
3395938,2638533,546,157,39878,0,40424,157,1
3863474,3215556,437,99,2592,499,3029,598,1
3759853,4725635,451,16,16330,0,16781,16,1
4653941,2793204,951,1,45883,0,46834,1,1
3074145,1077412,205,77,5623,0,5828,77,1
399986,1369053,68,102,375,0,443,102,1
1250021,1021105,4637,24,85913,0,90550,24,1
6618,124385,892,54,68849,0,69741,54,1
3687221,2486502,68,8,191,0,259,8,1
4319972,711092,640,56,35279,0,35919,56,1
439557,4702015,2090,11,61744,0,63834,11,1
1339664,3791310,228,69,6682,0,6910,69,1
2961801,4354115,1483,38,101962,0,103445,38,1
2772113,3285653,792,203,42907,0,43699,203,1
743837,4186555,613,25,2344,0,2957,25,1
2981537,4441082,1252,1,118718,0,119970,1,1
1817799,2065018,402,23,15932,0,16334,23,1
1580988,1790774,2821,4,400133,0,402954,4,1
2464401,4791111,577,208,23681,0,24258,208,1
1548012,3337079,73,76,1957,0,2030,76,1
419558,946468,22,2,320,0,342,2,1
354904,1648457,3193,37,105780,302,108973,339,1
1533314,3905501,361,106,6007,0,6368,106,1
4117427,1750157,329,203,9639,0,9968,203,1
3361377,2712307,4841,1,761793,0,766634,1,1
1396884,1555621,361,16,2277,0,2638,16,1
1516853,3779559,426,1,10168,0,10594,1,1
1580988,2251169,2821,2,400133,0,402954,2,1
2516076,379108,1455,25,77782,0,79237,25,1
3290431,1118880,65,51,1379,0,1444,51,1
748019,1375294,675,10,18480,0,19155,10,1
990798,3889815,194,18,2812,0,3006,18,1
1080728,4377767,118,44,2001,0,2119,44,1
990798,330340,194,424,2812,0,3006,424,1
2755798,1486646,494,725,24862,0,25356,725,1
4208044,4235942,247,48,3919,0,4166,48,1
3397281,4239717,743,39,15050,0,15793,39,1
2827436,1858868,882,2,271525,0,272407,2,1
1580988,1978137,2821,14,400133,0,402954,14,1
4191727,3876482,463,104,26315,0,26778,104,1
659480,3104302,518,31,1649,0,2167,31,1
64567,5905,40,279,462,225,502,504,1
2827436,3667944,882,1,271525,0,272407,1,1
4653941,1480556,951,1,45883,0,46834,1,1
4801471,562546,585,59,17979,0,18564,59,1
1924872,1512580,361,154,5715,0,6076,154,1
2851109,1533546,450,703,98552,22095,99002,22798,1
3065808,2194549,1235,211,82317,0,83552,211,1
768957,945970,202,8,7986,0,8188,8,1
3075881,2428725,313,13,3346,0,3659,13,1
1580988,48832,2821,3,400133,0,402954,3,1
3402545,1841608,253,394,2083,0,2336,394,1
2827436,2995642,882,4,271525,0,272407,4,1
4117427,3144079,329,56,9639,0,9968,56,1
449287,4668423,17,2,271,0,288,2,1
3703380,420383,36,113,159,0,195,113,1
215109,4460693,134,403,956,2596,1090,2999,1
687713,3654455,436,2,47160,0,47596,2,1
1997038,4464459,2,22,151,0,153,22,1
4516604,3632293,314,570,13314,21294,13628,21864,1
250102,3232660,189,185,4350,0,4539,185,1
52770,1993229,58,118,466,87,524,205,1
3638272,1807780,2022,1,370904,0,372926,1,1
2281709,2157195,95,3,2301,0,2396,3,1
2498087,3448301,1630,365,32582,0,34212,365,1
2772113,972042,792,152,42907,0,43699,152,1
354904,447446,3193,58,105780,0,108973,58,1
4191410,1112396,1590,208,96434,0,98024,208,1
1603899,2215351,497,14,5551,0,6048,14,1
837553,3434148,1249,51,61665,0,62914,51,1
2529661,4366966,493,47,27309,0,27802,47,1
4018742,3234949,115,5,3140,0,3255,5,1
3280389,4547892,1101,1,411419,0,412520,1,1
2075015,2358218,2664,5,85781,0,88445,5,1
3361377,4539247,4841,2,761793,0,766634,2,1
4203215,946433,7,201,523,0,530,201,1
1913445,466398,564,36,47943,0,48507,36,1
497049,25593,29,1914,497,502,526,2416,1
2529661,844778,493,218,27309,0,27802,218,1
875406,2062994,69,30,691,0,760,30,1
4209323,2419529,1630,5,89460,0,91090,5,1
1563367,2270323,15,5,709,0,724,5,1
4191727,853756,463,17,26315,0,26778,17,1
3586713,2810595,51,163,564,0,615,163,1
1661134,774544,18,1,317,0,335,1,1
3280389,62225,1101,1,411419,0,412520,1,1
781211,4520120,976,33,51781,0,52757,33,1
3257465,2472030,541,36,27614,0,28155,36,1
3765475,3445790,873,2,107914,0,108787,2,1
3271898,4591772,227,33,2028,0,2255,33,1
3995686,2389645,113,1,6154,0,6267,1,1
2950311,4385737,807,31,85116,0,85923,31,1
932720,950536,1411,2,111323,0,112734,2,1
3361377,1106452,4841,2,761793,0,766634,2,1
1508024,342227,389,4,1845,0,2234,4,1
2962038,3045572,495,7,14236,0,14731,7,1
4191410,1968267,1590,99,96434,0,98024,99,1
3683235,1954167,311,26,23110,0,23421,26,1
3768498,1173962,119,16,880,0,999,16,1
474172,4044996,471,158,38713,0,39184,158,1
2405789,1992095,1010,12,93387,0,94397,12,1
1503116,4405721,415,11,37079,0,37494,11,1
1779486,4079592,211,74,1444,0,1655,74,1
1327717,25593,46,1914,516,502,562,2416,1
2985909,2791412,706,53,43348,0,44054,53,1
1937293,202745,434,1,16761,0,17195,1,1
4838376,1660037,606,62,26838,0,27444,62,1
3361377,3677610,4841,2,761793,0,766634,2,1
1580988,1155343,2821,2,400133,0,402954,2,1
1875,2508996,656,19,61388,0,62044,19,1
3638272,4327112,2022,3,370904,0,372926,3,1
2868187,2925639,61,1,379,0,440,1,1
1733957,4789381,554,45,15185,0,15739,45,1
2961801,603905,1483,22,101962,0,103445,22,1
471706,3161563,794,17,65616,0,66410,17,1
1880135,129738,810,54,71924,0,72734,54,1
3638272,3478821,2022,23,370904,0,372926,23,1
765601,3384866,1485,38,101510,0,102995,38,1
3252058,7655,26,34,1860,0,1886,34,1
3501482,4441647,522,103,28046,0,28568,103,1
2950311,647081,807,1,85116,0,85923,1,1
1029490,4206273,67,28,290,0,357,28,1
1577010,3803010,373,15,2746,0,3119,15,1
873006,372471,375,796,33630,0,34005,796,1
57574,3681185,289,156,4616,0,4905,156,1
2827436,1196312,882,3,271525,0,272407,3,1
4727207,3373161,925,3,84581,0,85506,3,1
429643,1563860,767,181,19668,0,20435,181,1
3632998,2391522,35,10,360,0,395,10,1
3907996,2527176,485,171,18964,0,19449,171,1
3361377,356806,4841,1,761793,0,766634,1,1
2092359,3137296,421,1,26936,0,27357,1,1
1628302,2389391,11,2,4819,0,4830,2,1
593740,1548150,1107,68,62807,0,63914,68,1
1534362,3910276,1531,19,105859,0,107390,19,1
2260014,887164,2466,1,98622,0,101088,1,1
920553,886206,349,545,8968,0,9317,545,1
530200,1025265,2035,1,62809,0,64844,1,1
3509214,4582733,263,3,14139,0,14402,3,1
3119726,3616275,299,54,11573,0,11872,54,1
2092359,3119989,421,6,26936,0,27357,6,1
4451122,4009104,985,49,41669,0,42654,49,1
3509903,1523061,1530,7,509445,0,510975,7,1
595757,3954398,340,26,26738,0,27078,26,1
118180,4383683,94,12,887,0,981,12,1
2961801,3338352,1483,27,101962,0,103445,27,1
4380766,3270084,114,122,1165,0,1279,122,1
1963133,4479370,62,702,361,0,423,702,1
4854634,2085278,76,3,1396,0,1472,3,1
3554097,334166,65,8,1978,0,2043,8,1
889939,1646266,154,201,1864,0,2018,201,1
681618,2644274,75,3,8789,0,8864,3,1
3280389,936354,1101,1,411419,0,412520,1,1
2790006,346617,367,170,14747,0,15114,170,1
1169100,1213507,141,107,117,115,258,222,1
2307868,1877422,1131,5,38777,0,39908,5,1
427805,4143367,483,1,156906,0,157389,1,1
1633022,242519,246,1,23530,0,23776,1,1
3361377,4675060,4841,1,761793,0,766634,1,1
2793437,3510316,582,2,25447,0,26029,2,1
2209136,1909562,620,3,33789,0,34409,3,1
4353839,4076289,144,12,3320,0,3464,12,1
499918,2452217,36,47,311,0,347,47,1
2669924,3334645,226,10,1977,0,2203,10,1
3438576,3076962,3424,94,137753,0,141177,94,1
4479403,554399,52,10,2699,0,2751,10,1
2249093,3395938,134,546,2139,39878,2273,40424,1
290157,3475225,107,11,162,0,269,11,1
2163640,1422786,129,47,5750,0,5879,47,1
2428341,3264776,826,48,10151,0,10977,48,1
957197,4186180,614,24,37109,726,37723,750,1
427805,2079071,483,1,156906,0,157389,1,1
354904,199305,3193,18,105780,0,108973,18,1
3163452,4055368,84,39,297,0,381,39,1
679540,3821306,396,26,8028,0,8424,26,1
3864556,4585357,96,40,330,0,426,40,1
1697778,152339,125,1,3760,0,3885,1,1
1503116,1099636,415,28,37079,0,37494,28,1
1234540,82682,1071,34,75251,0,76322,34,1
584906,4533909,253,170,6639,0,6892,170,1
2827436,959916,882,4,271525,0,272407,4,1
3280389,2561918,1101,2,411419,0,412520,2,1
2307868,2899547,1131,99,38777,0,39908,99,1
1207753,1000840,533,8,9348,0,9881,8,1
2757156,611351,237,8,8153,0,8390,8,1
3509903,4664553,1530,1,509445,0,510975,1,1
3823546,262071,61,1,3026,0,3087,1,1
781211,4673067,976,1,51781,0,52757,1,1
4423184,921097,384,3,29809,0,30193,3,1
1478080,2587581,593,2,7009,0,7602,2,1
3793936,572809,258,74,2342,0,2600,74,1
889939,530200,154,2035,1864,62809,2018,64844,1
2860860,833680,204,30,2609,0,2813,30,1
318090,2127314,74,790,1957,28,2031,818,1
325196,4826439,9,6,158,0,167,6,1
3577332,125364,108,62,582,0,690,62,1
3549674,1233555,602,66,38542,0,39144,66,1
4619326,3797905,539,34,22721,0,23260,34,1
4515355,1631276,21,1,8176,0,8197,1,1
2950311,4377974,807,11,85116,0,85923,11,1
3112136,593397,406,211,41366,0,41772,211,1
6618,413389,892,114,68849,0,69741,114,1
471706,2040486,794,33,65616,0,66410,33,1
4396906,3060714,7,1783,322,6,329,1789,1
2755798,3004939,494,5,24862,0,25356,5,1
2887240,438967,1143,35,118405,0,119548,35,1
4652451,956474,130,26,882,0,1012,26,1
3019092,1438192,108,1,8595,0,8703,1,1
724650,2664278,248,16,906,0,1154,16,1
4689320,1694124,40,9,334,0,374,9,1
3906136,3179621,387,31,41169,0,41556,31,1
1227855,359385,157,63,4545,0,4702,63,1
2147720,4661376,1608,71,78786,0,80394,71,1
521586,2855764,782,8,18489,0,19271,8,1
2567613,940526,186,475,2647,20786,2833,21261,1
3913751,3003750,229,101,5248,0,5477,101,1
3380067,3384389,22,15,842,0,864,15,1
2751572,1750585,481,3,44036,0,44517,3,1
2844498,346674,36,27,1483,0,1519,27,1
2790006,1932769,367,38,14747,0,15114,38,1
4624595,4856779,722,10,53368,0,54090,10,1
4272102,3736149,1608,30,104171,0,105779,30,1
3464608,1715332,129,82,2235,0,2364,82,1
544230,1673726,1532,55,60768,0,62300,55,1
4782707,657165,513,4,31665,0,32178,4,1
3916976,1850758,188,16,6098,0,6286,16,1
6618,1279038,892,19,68849,0,69741,19,1
734849,166695,27,2,991,0,1018,2,1
567161,55864,130,18,719,0,849,18,1
4191410,4745957,1590,28,96434,0,98024,28,1
1870921,3088490,182,4,8739,0,8921,4,1
1467500,574828,32,11,517,0,549,11,1
544230,565335,1532,114,60768,0,62300,114,1
3065808,2454380,1235,51,82317,0,83552,51,1
2627841,1486567,418,6,12342,0,12760,6,1
3983436,215739,376,90,3267,0,3643,90,1
2884705,4596542,649,73,10233,0,10882,73,1
1633022,504480,246,1,23530,0,23776,1,1
4154740,4320015,68,131,1352,0,1420,131,1
3280389,4678700,1101,4,411419,0,412520,4,1
3280389,2424732,1101,1,411419,0,412520,1,1
4209323,4021129,1630,115,89460,0,91090,115,1
1884174,4005055,25,62,472,0,497,62,1
3704464,2469551,64,63,827,0,891,63,1
2031305,3278082,396,110,23435,0,23831,110,1
4302043,396272,61,1,464,0,525,1,1
427805,3896588,483,5,156906,0,157389,5,1
2516076,4509598,1455,57,77782,0,79237,57,1
4755308,2054300,90,33,311,0,401,33,1
4624595,4753639,722,13,53368,0,54090,13,1
595757,3389748,340,22,26738,0,27078,22,1
3361377,3540392,4841,4,761793,0,766634,4,1
3065808,1534403,1235,75,82317,0,83552,75,1
2887240,1596576,1143,3,118405,0,119548,3,1
1534362,2030517,1531,21,105859,0,107390,21,1
1580988,4111235,2821,3,400133,0,402954,3,1
2781817,1017939,704,9,24613,0,25317,9,1
1539837,1463480,1127,13,62979,0,64106,13,1
1580988,494817,2821,1,400133,0,402954,1,1
4451122,1601163,985,20,41669,0,42654,20,1
2897926,4593166,565,73,25983,0,26548,73,1
2721412,3420389,273,47,2733,190,3006,237,1
1792987,3388535,97,176,3867,0,3964,176,1
2222147,3651179,26,1752,145,2979,171,4731,1
92352,321109,1138,22,20575,0,21713,22,1
4633132,1122422,79,11,861,140,940,151,1
1055882,740260,10,3,257,0,267,3,1
4171867,3402731,10,3654,29,18,39,3672,1
4678614,2769699,452,37,16881,0,17333,37,1
1250021,4752333,4637,8,85913,0,90550,8,1
349289,271364,91,1541,280,171,371,1712,1
1292661,4528031,57,4,889,0,946,4,1
3995855,4688598,91,14,662,0,753,14,1
3935366,1805494,377,158,3803,0,4180,158,1
4479581,2001734,601,14,19545,0,20146,14,1
1875,1112950,656,29,61388,0,62044,29,1
3280389,2524859,1101,3,411419,0,412520,3,1
4219266,337534,85,31,3252,198,3337,229,1
2311472,599952,91,26,2259,0,2350,26,1
1521855,1410814,228,43,7649,0,7877,43,1
3280389,110625,1101,1,411419,0,412520,1,1
4672319,2194903,483,3,9652,0,10135,3,1
4272102,582794,1608,56,104171,0,105779,56,1
3361377,2996708,4841,1,761793,0,766634,1,1
2075015,1435534,2664,15,85781,0,88445,15,1
805360,3187188,1514,43,119306,0,120820,43,1
860473,3551306,751,183,20450,0,21201,183,1
1086912,2031530,907,81,33396,0,34303,81,1
4782707,5072,513,3,31665,0,32178,3,1
18762,3534593,82,1,1159,0,1241,1,1
3907996,4247821,485,54,18964,0,19449,54,1
4727207,32309,925,2,84581,0,85506,2,1
148308,3745512,15,56,1948,0,1963,56,1
1591435,4750855,387,355,31245,18880,31632,19235,1
3206499,798114,1337,89,32033,0,33370,89,1
2334583,1915715,45,7,584,0,629,7,1
4272102,884138,1608,97,104171,0,105779,97,1
3206499,4544404,1337,1,32033,0,33370,1,1
2307868,4540915,1131,2,38777,0,39908,2,1
3906136,3662459,387,217,41169,0,41556,217,1
3257465,1237531,541,13,27614,0,28155,13,1
687713,854595,436,1,47160,0,47596,1,1
1406736,790517,296,162,1820,0,2116,162,1
580157,3061127,194,260,4890,0,5084,260,1
765601,1123208,1485,14,101510,0,102995,14,1
2849738,1673480,61,9,3795,0,3856,9,1
910231,1758724,155,161,2002,0,2157,161,1
3561502,239120,1144,20,68800,0,69944,20,1
92352,783615,1138,30,20575,0,21713,30,1
311243,426698,50,283,602,41,652,324,1
1497278,2490005,1869,3,35111,0,36980,3,1
3065808,3835174,1235,26,82317,0,83552,26,1
3134736,3062865,1413,33,1118,0,2531,33,1
1875,1051484,656,1,61388,0,62044,1,1
87671,1777002,51,9,199,0,250,9,1
4804614,2226444,151,5,2725,0,2876,5,1
4440160,3224248,736,278,20522,1134,21258,1412,1
2464401,4310578,577,6,23681,0,24258,6,1
3112136,4243872,406,98,41366,0,41772,98,1
1927211,3690366,1668,51,113322,0,114990,51,1
3438576,3384031,3424,15,137753,0,141177,15,1
3438576,3146422,3424,34,137753,0,141177,34,1
1591435,2350332,387,95,31245,0,31632,95,1
3509903,2688467,1530,1,509445,0,510975,1,1
4630259,1180599,69,179,527,519,596,698,1
3280389,2023951,1101,1,411419,0,412520,1,1
1927211,116570,1668,46,113322,0,114990,46,1
1534362,68953,1531,28,105859,0,107390,28,1
2962038,3450374,495,1,14236,0,14731,1,1
4360960,3582930,1642,94,110084,0,111726,94,1
417416,1539837,75,1127,1695,62979,1770,64106,1
515290,1319313,285,76,34080,0,34365,76,1
3058068,1888682,124,2,12734,0,12858,2,1
4020443,549354,81,2,1697,0,1778,2,1
3361377,1619239,4841,7,761793,0,766634,7,1
4272102,4756204,1608,25,104171,0,105779,25,1
2281149,3710479,282,54,28082,0,28364,54,1
1966548,3041096,208,8,53149,0,53357,8,1
307250,2631532,919,73,35588,0,36507,73,1
755739,2726801,1117,166,58043,0,59160,166,1
3079764,3076453,143,53,453,0,596,53,1
1580988,4207192,2821,3,400133,0,402954,3,1
1875,2065619,656,33,61388,0,62044,33,1
429643,4750781,767,4,19668,0,20435,4,1
1787075,1279852,894,129,28305,0,29199,129,1
1276253,3021413,407,1,46534,0,46941,1,1
787416,3288500,115,1,9954,0,10069,1,1
94189,1221220,251,163,2779,1935,3030,2098,1
6618,2156030,892,19,68849,0,69741,19,1
1919500,3081281,19,3,159,0,178,3,1
2147720,574035,1608,28,78786,0,80394,28,1
1580988,4851847,2821,363,400133,0,402954,363,1
3610598,4335184,380,142,17343,0,17723,142,1
4496752,354291,554,40,16258,0,16812,40,1
522588,3689137,496,20,20091,0,20587,20,1
3509903,4154237,1530,9,509445,0,510975,9,1
4179002,3250864,235,135,1340,0,1575,135,1
1847461,1943710,1211,76,51149,0,52360,76,1
3836080,3154376,1197,143,59457,0,60654,143,1
2529661,2133269,493,4,27309,0,27802,4,1
665164,3154479,396,7,12610,0,13006,7,1
1787075,3077752,894,803,28305,0,29199,803,1
2736770,3791401,55,3,1047,0,1102,3,1
4516604,943965,314,32,13314,0,13628,32,1
3638272,2296870,2022,37,370904,0,372926,37,1
1423591,364665,11,903,160,0,171,903,1
1634335,4134234,144,65,849,50,993,115,1
3350925,1734620,92,38,859,130,951,168,1
2827436,1266573,882,2,271525,0,272407,2,1
3845119,4383317,461,82,28609,0,29070,82,1
4727207,592194,925,10,84581,0,85506,10,1
2343253,2416376,1882,1,86401,0,88283,1,1
666439,3628192,35,2,127,0,162,2,1
2190221,1487899,228,45,1659,0,1887,45,1
687713,1230899,436,1,47160,0,47596,1,1
2343253,455687,1882,1,86401,0,88283,1,1
4295952,3265782,808,27,57369,0,58177,27,1
471706,2044342,794,19,65616,0,66410,19,1
752551,2222931,460,323,3526,0,3986,323,1
361675,2171765,3,22,128,0,131,22,1
268844,3879726,422,60,5070,0,5492,60,1
3294702,2888862,991,23,68888,0,69879,23,1
3739473,148586,448,1,13226,0,13674,1,1
1575009,3274878,429,5,37745,0,38174,5,1
4672596,3802114,107,47,3286,0,3393,47,1
3115867,4253184,1350,48,61232,0,62582,48,1
3235479,2630065,999,10,66486,0,67485,10,1
1063358,4267174,1350,35,63494,0,64844,35,1
3815269,4333967,213,122,7440,0,7653,122,1
2906370,2670441,271,34,4802,0,5073,34,1
792037,1151426,57,5,16445,0,16502,5,1
4192206,3937752,468,81,18229,0,18697,81,1
1580988,3917660,2821,3,400133,0,402954,3,1
3410018,1921179,38,153,157,0,195,153,1
564283,4557970,52,15,61,0,113,15,1
3280389,4347554,1101,2,411419,0,412520,2,1
312080,1383771,34,12,276,0,310,12,1
957197,3576088,614,15,37109,0,37723,15,1
3140664,231572,268,104,16099,0,16367,104,1
2117292,1044538,150,45,788,0,938,45,1
441667,2511448,198,37,14727,0,14925,37,1
2834992,2393339,69,1266,1779,0,1848,1266,1
646593,2190575,17,3,80,0,97,3,1
3065808,2865377,1235,3,82317,0,83552,3,1
2784572,4677260,69,86,3478,0,3547,86,1
2258757,1115891,142,41,412,112,554,153,1
1878924,3041299,85,736,2012,0,2097,736,1
3249379,3713556,24,16,524,0,548,16,1
3069382,2024445,113,29,5201,0,5314,29,1
2950311,2618595,807,55,85116,0,85923,55,1
639248,1705721,35,1,266,0,301,1,1
3280389,3942272,1101,3,411419,0,412520,3,1
2774493,86191,551,162,12712,0,13263,162,1
3361377,1619055,4841,12,761793,0,766634,12,1
1497278,2049832,1869,12,35111,0,36980,12,1
4505464,4695306,99,6,2637,0,2736,6,1
948768,1889033,587,122,14768,0,15355,122,1
3242275,2949221,551,103,17400,0,17951,103,1
2343253,1280440,1882,72,86401,0,88283,72,1
6618,543396,892,42,68849,0,69741,42,1
1138515,2606069,341,1,12443,0,12784,1,1
3361377,3839125,4841,12,761793,0,766634,12,1
3676295,4662316,374,1,70881,0,71255,1,1
3361377,3926289,4841,35,761793,0,766634,35,1
2702724,475799,566,19,10448,0,11014,19,1
522588,4626952,496,1,20091,0,20587,1,1
1513092,3683401,180,974,1287,0,1467,974,1
3288730,2061634,117,89,4627,0,4744,89,1
1330432,1016650,12,113,1926,0,1938,113,1
2195890,2786425,134,96,5208,0,5342,96,1
4624595,4540497,722,244,53368,0,54090,244,1
1580988,4308313,2821,1,400133,0,402954,1,1
2148937,4094598,672,26,47361,0,48033,26,1
1723506,3186510,733,2,21835,0,22568,2,1
2503097,4291057,414,77,3628,0,4042,77,1
3509903,4186281,1530,1,509445,0,510975,1,1
2961801,2633747,1483,5,101962,0,103445,5,1
932720,4151992,1411,20,111323,0,112734,20,1
679540,4585574,396,16,8028,0,8424,16,1
3157597,846827,183,268,10247,0,10430,268,1
4672319,1570646,483,61,9652,0,10135,61,1
2266491,2327344,81,219,1909,0,1990,219,1
655339,929720,93,1,1136,0,1229,1,1
4854708,2182339,76,55,440,503,516,558,1
3835618,1834577,694,84,25433,1213,26127,1297,1
2662809,990407,303,10,10704,0,11007,10,1
3301573,3224158,8,6,321,0,329,6,1
4181760,1936859,359,185,7855,0,8214,185,1
4765925,896941,105,9,1236,0,1341,9,1
3344390,2777862,309,6,4274,0,4583,6,1
3638272,2362981,2022,3,370904,0,372926,3,1
621115,184322,66,1,6250,0,6316,1,1
3464608,2364985,129,272,2235,0,2364,272,1
4653941,3150089,951,1,45883,0,46834,1,1
4417253,3120163,1130,38,68389,0,69519,38,1
462298,1179890,414,58,10933,0,11347,58,1
3509903,1410656,1530,4,509445,0,510975,4,1
2911269,3069478,740,66,20606,0,21346,66,1
2827436,1168541,882,2,271525,0,272407,2,1
3288730,763803,117,7,4627,0,4744,7,1
2498087,2959344,1630,235,32582,0,34212,235,1
4140279,811865,337,1,49384,0,49721,1,1
3853609,4495184,505,144,6896,0,7401,144,1
3849982,3568472,84,4,494,0,578,4,1
4360960,123619,1642,30,110084,0,111726,30,1
3280389,4102962,1101,5,411419,0,412520,5,1
1328761,1980290,13,1,223,0,236,1,1
1801962,2649805,49,198,297,0,346,198,1
3509903,2033871,1530,1,509445,0,510975,1,1
4853234,685385,1256,37,29554,0,30810,37,1
3541530,3750488,90,25,853,0,943,25,1
1787075,2240982,894,4,28305,0,29199,4,1
2528255,2164407,8,36,182,0,190,36,1
3602958,1754174,34,18,1096,0,1130,18,1
1413651,659131,34,221,1666,0,1700,221,1
3270646,1797410,390,10,3571,0,3961,10,1
3638272,2656049,2022,1,370904,0,372926,1,1
2001034,789830,29,1,1717,0,1746,1,1
1580988,1190151,2821,4,400133,0,402954,4,1
4727207,659428,925,1,84581,0,85506,1,1
1927211,1255783,1668,47,113322,0,114990,47,1
3758019,1853862,189,39,2783,0,2972,39,1
978797,4187288,599,230,12421,0,13020,230,1
2405789,148110,1010,39,93387,0,94397,39,1
837572,785009,70,10,1973,0,2043,10,1
1534362,4616556,1531,93,105859,0,107390,93,1
1034814,3472411,117,3,3359,0,3476,3,1
125780,4310029,16,48,295,0,311,48,1
1965276,1622566,52,1,364,0,416,1,1
3676150,3580118,125,75,7579,0,7704,75,1
4468814,4416768,48,21,722,0,770,21,1
3509903,1986262,1530,89,509445,0,510975,89,1
161346,2129293,26,3,150,0,176,3,1
499965,3876737,431,2951,281,1921,712,4872,1
4624595,4568771,722,24,53368,0,54090,24,1
1436216,2527443,1068,1,68770,0,69838,1,1
2120733,959882,819,4,20803,0,21622,4,1
4238001,2388628,869,226,61161,0,62030,226,1
2405789,2335152,1010,83,93387,0,94397,83,1
2147720,3091010,1608,178,78786,0,80394,178,1
3906136,4584236,387,33,41169,0,41556,33,1
1591435,4107457,387,6,31245,0,31632,6,1
4330391,339563,773,1999,32759,7561,33532,9560,1
849829,4527989,40,101,232,0,272,101,1
4361636,1540823,186,154,1867,0,2053,154,1
2562439,2879580,139,93,3070,0,3209,93,1
3387987,3982007,268,7,19035,0,19303,7,1
4642569,4529953,872,81,27586,0,28458,81,1
3242439,1988212,49,115,161,0,210,115,1
940526,2371473,475,1,20786,0,21261,1,1
185943,3018106,620,214,6573,196,7193,410,1
2092359,3667327,421,9,26936,0,27357,9,1
3361377,2201506,4841,6,761793,0,766634,6,1
954784,3996012,567,102,14450,0,15017,102,1
1094821,3337423,223,48,2745,0,2968,48,1
2039022,831973,417,27,342,8,759,35,1
427805,3363129,483,3,156906,0,157389,3,1
1875,3261229,656,29,61388,0,62044,29,1
2911269,275233,740,24,20606,0,21346,24,1
269982,2356361,351,179,9019,0,9370,179,1
3509903,2586328,1530,1,509445,0,510975,1,1
3051212,4264349,957,3,8349,0,9306,3,1
2509374,2968462,131,105,1014,814,1145,919,1
2569009,4414556,424,77,13423,0,13847,77,1
2207325,2627004,200,30,1848,182,2048,212,1
4592892,1353167,12,360,219,0,231,360,1
3095050,3154684,364,31,3358,0,3722,31,1
3906136,3920713,387,56,41169,0,41556,56,1
3509903,1114016,1530,145,509445,0,510975,145,1
3364515,4086676,109,437,3529,0,3638,437,1
2096270,1096208,970,8,26018,0,26988,8,1
377084,1442406,26,501,235,0,261,501,1
3001891,2370553,304,57,4550,0,4854,57,1
4408813,1523564,288,12,10077,0,10365,12,1
2482338,1999108,712,9,24222,0,24934,9,1
28346,4859240,142,100,1997,0,2139,100,1
3758692,273195,711,4,34731,0,35442,4,1
226608,265357,11,244,153,12,164,256,1
2779329,3517546,217,103,6021,0,6238,103,1
2405789,4040798,1010,84,93387,0,94397,84,1
4011264,480412,1360,33,116777,0,118137,33,1
2405789,3678783,1010,49,93387,0,94397,49,1
3509903,4182554,1530,3,509445,0,510975,3,1
1389247,1386144,7,89,466,0,473,89,1
3361377,3293681,4841,1,761793,0,766634,1,1
1234540,806565,1071,62,75251,0,76322,62,1
2398402,4173523,84,21,851,171,935,192,1
3405059,4284041,261,20,9604,0,9865,20,1
3235479,724657,999,18,66486,0,67485,18,1
3836080,390268,1197,145,59457,0,60654,145,1
4334842,1144668,85,120,4749,0,4834,120,1
4295952,3280486,808,83,57369,0,58177,83,1
4451227,4025945,27,1,450,0,477,1,1
169960,2631305,9,1,207,0,216,1,1
2981537,4347538,1252,2,118718,0,119970,2,1
3630714,1692340,257,27,7929,0,8186,27,1
3933095,3686052,304,127,2162,0,2466,127,1
3408985,4687315,205,174,6002,0,6207,174,1
544230,1794470,1532,71,60768,254,62300,325,1
3638272,3943527,2022,1,370904,0,372926,1,1
3065808,982097,1235,53,82317,0,83552,53,1
2122741,980530,190,49,6085,0,6275,49,1
4649206,4851666,566,23,31367,0,31933,23,1
842615,2978271,510,4,12316,0,12826,4,1
1968010,2562506,786,100,10371,0,11157,100,1
1497278,2435059,1869,10,35111,0,36980,10,1
1898822,3121295,114,1277,3885,0,3999,1277,1
2260014,3757765,2466,25,98622,0,101088,25,1
3003950,4729899,127,23,2904,0,3031,23,1
4542877,3809600,6,27,57,0,63,27,1
4313572,175608,930,62,16971,0,17901,62,1
3914135,1967615,2152,168,60084,0,62236,168,1
2261139,1865995,2014,7,42851,0,44865,7,1
765601,4054865,1485,5,101510,0,102995,5,1
4411145,957197,67,614,285,37109,352,37723,1
3438576,2977375,3424,41,137753,0,141177,41,1
3338434,1922397,124,187,2138,0,2262,187,1
4519069,3199731,387,367,20799,0,21186,367,1
1927211,3304188,1668,126,113322,0,114990,126,1
1807467,469653,208,111,2442,0,2650,111,1
1875,4487906,656,1,61388,0,62044,1,1
3112136,4794851,406,2,41366,0,41772,2,1
1880135,2769757,810,10,71924,0,72734,10,1
2260014,3892661,2466,6,98622,0,101088,6,1
2827436,2847161,882,1,271525,0,272407,1,1
544230,1719420,1532,3,60768,0,62300,3,1
2343253,4123163,1882,12,86401,0,88283,12,1
4192206,3442627,468,6,18229,0,18697,6,1
4417253,1998702,1130,48,68389,0,69519,48,1
3127312,2994286,110,143,1528,0,1638,143,1
3539650,1537670,194,24,2264,0,2458,24,1
3638272,701078,2022,3,370904,0,372926,3,1
4374509,4005520,770,9,9940,0,10710,9,1
3430614,1163244,95,7,2668,0,2763,7,1
3742930,1796251,410,39,22242,0,22652,39,1
3397281,141667,743,36,15050,0,15793,36,1
813554,1204108,252,5,17214,0,17466,5,1
3115867,3663804,1350,61,61232,0,62582,61,1
3361377,4273726,4841,7,761793,0,766634,7,1
1486836,608888,43,1,2752,0,2795,1,1
3509903,1844311,1530,1,509445,0,510975,1,1
2877907,1837548,508,114,16021,0,16529,114,1
1196844,102643,548,14,36289,0,36837,14,1
4224492,125727,123,150,1308,0,1431,150,1
1810977,3010,143,1,1005,0,1148,1,1
3361377,3145188,4841,22,761793,0,766634,22,1
1331940,1503984,802,9,32617,0,33419,9,1
4297315,3612244,195,3,7446,0,7641,3,1
2341040,3548100,75,24,648,153,723,177,1
1973082,3872326,1036,36,18915,0,19951,36,1
4103612,3716220,932,4,5655,0,6587,4,1
89426,1378789,184,3,2711,0,2895,3,1
4035124,2430594,77,85,1496,0,1573,85,1
3960049,2567337,140,25,2418,0,2558,25,1
4183784,1046852,931,319,59894,0,60825,319,1
1580988,3547700,2821,52,400133,0,402954,52,1
3361377,2339572,4841,2,761793,0,766634,2,1
577580,3549115,187,132,3831,0,4018,132,1
3361377,3053331,4841,1,761793,0,766634,1,1
4266665,1471685,91,1681,1894,25550,1985,27231,1
4853234,4402613,1256,1,29554,0,30810,1,1
471706,699099,794,2,65616,0,66410,2,1
1913445,100552,564,132,47943,0,48507,132,1
532681,432888,433,103,35023,0,35456,103,1
4789203,1988745,355,10,11315,0,11670,10,1
3671141,1073519,1444,16,48400,0,49844,16,1
3691520,3768366,533,334,9121,12403,9654,12737,1
92352,2167272,1138,69,20575,0,21713,69,1
4738916,1819288,1165,164,34124,0,35289,164,1
4707515,1918386,38,280,127,0,165,280,1
60980,4071611,649,19,20708,0,21357,19,1
3381542,1072462,67,1,184,0,251,1,1
2853969,1916994,1051,76,42591,0,43642,76,1
4337603,879336,333,164,9909,0,10242,164,1
2751572,4452417,481,126,44036,0,44517,126,1
6618,4367872,892,2,68849,0,69741,2,1
4860485,480484,89,86,3655,0,3744,86,1
858265,1559868,138,12,1480,0,1618,12,1
4496752,2851109,554,450,16258,98552,16812,99002,1
3323910,2275133,152,63,1250,0,1402,63,1
3509903,1851461,1530,2,509445,0,510975,2,1
4295064,4762204,68,2239,374,4518,442,6757,1
3873768,2486877,449,33,35424,0,35873,33,1
3569179,4161174,1064,72,40015,0,41079,72,1
837553,3495467,1249,96,61665,0,62914,96,1
2940588,3172799,554,40,9477,0,10031,40,1
4417253,4739810,1130,32,68389,0,69519,32,1
3437068,1550740,295,302,1597,668,1892,970,1
3449530,958149,717,10,73648,0,74365,10,1
940526,2032435,475,6,20786,0,21261,6,1
455994,3513783,95,62,2615,0,2710,62,1
4295952,908405,808,2,57369,0,58177,2,1
596012,948966,192,4,3561,0,3753,4,1
287952,3957027,7,814,141,239,148,1053,1
530200,26091,2035,18,62809,0,64844,18,1
3280389,3281577,1101,4,411419,0,412520,4,1
2962038,4064481,495,1,14236,0,14731,1,1
3280389,2016382,1101,2,411419,0,412520,2,1
427805,1144436,483,5,156906,0,157389,5,1
3683235,2448441,311,41,23110,0,23421,41,1
2828183,2839760,192,207,3138,0,3330,207,1
1968010,1785895,786,197,10371,0,11157,197,1
3235479,4069580,999,247,66486,0,67485,247,1
3438576,2586703,3424,15,137753,0,141177,15,1
6618,3665978,892,217,68849,0,69741,217,1
3280389,90382,1101,1,411419,0,412520,1,1
3936039,3261505,799,102,23884,0,24683,102,1
427805,4203114,483,3,156906,0,157389,3,1
1880135,1297216,810,37,71924,0,72734,37,1
4319972,2955775,640,96,35279,0,35919,96,1
1794799,4219272,182,128,886,0,1068,128,1
271405,982107,142,7,742,0,884,7,1
331965,2642496,34,66,193,450,227,516,1
781211,144325,976,2,51781,0,52757,2,1
3137585,635764,1196,80,77354,0,78550,80,1
2049692,4080614,38,13,618,0,656,13,1
2853969,2401569,1051,1,42591,0,43642,1,1
3509214,2669301,263,152,14139,0,14402,152,1
2147720,46593,1608,61,78786,0,80394,61,1
2989110,2007682,1042,132,19283,0,20325,132,1
765601,1688557,1485,1,101510,0,102995,1,1
3449530,3368910,717,48,73648,0,74365,48,1
1818911,2333159,425,131,2972,0,3397,131,1
4417382,362531,477,7,512,0,989,7,1
2310913,4103612,52,932,509,5655,561,6587,1
3820250,4347654,78,1278,1133,0,1211,1278,1
3567974,219873,35,19,521,0,556,19,1
1375942,4532240,2,1,34,0,36,1,1
1396391,3903975,131,26,1453,0,1584,26,1
4016481,354904,24,3193,595,105780,619,108973,1
3549674,4782173,602,29,38542,0,39144,29,1
3361377,2724694,4841,2,761793,0,766634,2,1
1250021,2594289,4637,79,85913,0,90550,79,1
4451491,2445035,817,49,8836,238,9653,287,1
4751453,2399003,520,7,27570,0,28090,7,1
2443201,4782581,75,16,669,0,744,16,1
2305948,1058648,53,26,559,0,612,26,1
3845119,3454933,461,68,28609,0,29070,68,1
4178055,2915613,260,16,8186,0,8446,16,1
1927211,4133453,1668,25,113322,0,114990,25,1
2961801,2552047,1483,165,101962,0,103445,165,1
3509903,1906242,1530,1,509445,0,510975,1,1
4360960,594792,1642,112,110084,0,111726,112,1
3361377,3381149,4841,3,761793,0,766634,3,1
2981537,2433724,1252,1,118718,0,119970,1,1
4098003,850017,21,1349,90,213,111,1562,1
1652056,3020906,326,58,66845,0,67171,58,1
1887709,3588497,217,50,28983,792,29200,842,1
2827436,1476464,882,2,271525,0,272407,2,1
1541866,851706,542,24,16481,0,17023,24,1
2961801,781243,1483,95,101962,0,103445,95,1
2976684,408422,257,204,3759,154,4016,358,1
3395938,3112674,546,30,39878,0,40424,30,1
3906136,4610309,387,4,41169,0,41556,4,1
3946789,3660889,261,357,5606,1769,5867,2126,1
4656285,3191605,1446,29,35428,0,36874,29,1
607449,4292405,380,6,19369,0,19749,6,1
439557,975885,2090,29,61744,0,63834,29,1
4850321,2603634,113,71,988,0,1101,71,1
805360,3188771,1514,28,119306,0,120820,28,1
3125762,1221220,254,163,8285,1935,8539,2098,1
1880135,2156204,810,14,71924,0,72734,14,1
1540080,3643594,255,4,3594,0,3849,4,1
4809559,682075,297,14,3171,0,3468,14,1
4099305,128651,118,130,5174,0,5292,130,1
3379358,2656737,44,1,3147,0,3191,1,1
4140279,953519,337,1,49384,0,49721,1,1
3987684,1664696,286,1,17372,0,17658,1,1
3509903,3368426,1530,1,509445,0,510975,1,1
1875,98737,656,12,61388,0,62044,12,1
2120733,3183822,819,288,20803,0,21622,288,1
3986468,2633184,111,153,3703,0,3814,153,1
1063358,4538549,1350,17,63494,0,64844,17,1
3638272,2451879,2022,1,370904,0,372926,1,1
2851109,2958495,450,1,98552,0,99002,1,1
4365938,3509739,250,67,10362,0,10612,67,1
2824719,4823659,27,62,642,0,669,62,1
3607310,2384437,318,85,3879,0,4197,85,1
1292070,24876,72,4,771,0,843,4,1
3438576,1199546,3424,3,137753,0,141177,3,1
765601,4843052,1485,6,101510,0,102995,6,1
3102873,2066072,341,2,15098,0,15439,2,1
3437784,2988013,94,3,577,0,671,3,1
1331940,4188719,802,31,32617,0,33419,31,1
4656285,867458,1446,3,35428,0,36874,3,1
2754478,2395019,86,75,1994,1352,2080,1427,1
4385783,2341748,290,95,10995,0,11285,95,1
3845119,2342363,461,2,28609,0,29070,2,1
4011264,3498527,1360,47,116777,0,118137,47,1
2849622,3847884,117,3,2673,0,2790,3,1
2457029,2531939,77,2,10427,0,10504,2,1
3361377,4192478,4841,2,761793,0,766634,2,1
3632787,1627800,112,3035,1380,3,1492,3038,1
3175944,208635,324,64,7415,0,7739,64,1
792037,2888520,57,2,16445,0,16502,2,1
1637447,2811640,555,11,8549,0,9104,11,1
1927211,843847,1668,74,113322,0,114990,74,1
1062967,4699203,260,4,15276,0,15536,4,1
2465230,1478564,88,67,663,0,751,67,1
3739473,2158744,448,15,13226,0,13674,15,1
337280,2219868,244,51,1297,0,1541,51,1
3361377,516865,4841,1,761793,0,766634,1,1
3676150,340521,125,28,7579,0,7704,28,1
3361377,2079871,4841,11,761793,0,766634,11,1
3082104,1357714,47,11,4343,0,4390,11,1
1192480,2062503,397,4,20737,0,21134,4,1
4838376,2873611,606,86,26838,0,27444,86,1
4718017,1530617,40,168,122,161,162,329,1
842615,228973,510,187,12316,0,12826,187,1
781211,1937132,976,33,51781,0,52757,33,1
2042635,2074727,101,12,283,0,384,12,1
4853234,4726665,1256,1,29554,0,30810,1,1
3509903,3642759,1530,34,509445,0,510975,34,1
3581291,2113920,83,6,535,0,618,6,1
2827436,4447373,882,55,271525,0,272407,55,1
755739,1881558,1117,42,58043,0,59160,42,1
1494665,4850068,668,376,37638,0,38306,376,1
1493489,1586961,523,36,17512,0,18035,36,1
4401835,615155,204,143,1738,0,1942,143,1
3509903,214245,1530,2,509445,0,510975,2,1
2307868,2924388,1131,80,38777,0,39908,80,1
4417253,1532450,1130,304,68389,0,69519,304,1
521586,3456211,782,15,18489,0,19271,15,1
354904,1147870,3193,20,105780,0,108973,20,1
3524073,3822374,157,19,3319,0,3476,19,1
1580988,2906702,2821,10,400133,0,402954,10,1
431086,4417074,619,5,14910,0,15529,5,1
4319972,3473004,640,103,35279,0,35919,103,1
1966548,4381412,208,1,53149,0,53357,1,1
1776708,1860612,56,18,819,0,875,18,1
1370169,320344,223,351,1452,3831,1675,4182,1
3638272,1192177,2022,2,370904,0,372926,2,1
3509903,4471417,1530,3,509445,0,510975,3,1
4547438,2449777,1291,40,25237,0,26528,40,1
1484256,1747884,7,263,163,71,170,334,1
2033773,532760,58,368,596,509,654,877,1
1478080,3823679,593,4,7009,0,7602,4,1
1092045,899518,242,172,9359,0,9601,172,1
1497278,1468070,1869,24,35111,0,36980,24,1
4194323,3164475,191,26,958,0,1149,26,1
4193551,2762372,314,818,1572,6089,1886,6907,1
1937293,3590770,434,5,16761,0,17195,5,1
2847831,3056549,80,3,307,0,387,3,1
4090769,2485529,79,358,469,1375,548,1733,1
3654276,4502842,153,201,3512,0,3665,201,1
1993295,3910816,80,58,1466,322,1546,380,1
3759853,4480308,451,590,16330,0,16781,590,1
1741497,4546817,115,19,3909,0,4024,19,1
1234540,3530693,1071,6,75251,0,76322,6,1
3718020,3823829,305,48,6132,0,6437,48,1
474172,2385101,471,52,38713,0,39184,52,1
2961801,277137,1483,36,101962,0,103445,36,1
595757,292679,340,12,26738,0,27078,12,1
3672238,595075,518,137,12172,0,12690,137,1
1887709,4680926,217,2,28983,0,29200,2,1
3676150,3586851,125,26,7579,0,7704,26,1
2209345,4488421,8,3,44,0,52,3,1
2751572,2683795,481,82,44036,0,44517,82,1
3260961,2590347,288,25,7637,0,7925,25,1
3235479,701822,999,83,66486,0,67485,83,1
3987684,697015,286,25,17372,0,17658,25,1
3857537,251605,1008,211,5225,60,6233,271,1
3910599,2360660,206,148,724,0,930,148,1
1060884,888115,65,237,1609,98,1674,335,1
1652056,1457086,326,1,66845,0,67171,1,1
3074145,3844407,205,1,5623,0,5828,1,1
3361377,3594497,4841,1,761793,0,766634,1,1
2887240,185223,1143,4,118405,0,119548,4,1
414608,4788741,50,4,5531,0,5581,4,1
1534526,388363,51,8,1638,0,1689,8,1
3836080,986451,1197,28,59457,0,60654,28,1
3361377,1282262,4841,1,761793,0,766634,1,1
3844592,4589586,15,187,596,1,611,188,1
2139873,3360712,199,3,882,0,1081,3,1
4337603,3260844,333,253,9909,0,10242,253,1
4191410,1591765,1590,109,96434,0,98024,109,1
1710318,891757,95,58,1946,0,2041,58,1
2600005,2283779,35,171,427,0,462,171,1
3134846,1947213,69,4,5634,0,5703,4,1
3986468,1168031,111,6,3703,0,3814,6,1
1580988,4140279,2821,337,400133,49384,402954,49721,1
2950311,2514823,807,24,85116,0,85923,24,1
805360,2110520,1514,40,119306,0,120820,40,1
427805,3797746,483,1,156906,0,157389,1,1
3906136,2390398,387,2,41169,0,41556,2,1
1267988,506648,71,338,794,0,865,338,1
273363,1705060,768,1,11045,0,11813,1,1
3509903,383806,1530,2,509445,0,510975,2,1
1591435,181993,387,20,31245,0,31632,20,1
3916976,4160233,188,59,6098,0,6286,59,1
3361377,4458651,4841,5,761793,0,766634,5,1
2260014,3496566,2466,5,98622,0,101088,5,1
153871,2859127,333,59,3892,0,4225,59,1
1966548,3118903,208,9,53149,0,53357,9,1
978797,4176022,599,18,12421,0,13020,18,1
607449,1111660,380,4,19369,0,19749,4,1
2854737,1425169,751,136,637,150,1388,286,1
1394232,1103473,9,41,111,0,120,41,1
1052336,2703050,93,555,1721,266,1814,821,1
3361377,4809263,4841,3,761793,0,766634,3,1
4408813,2553240,288,7,10077,0,10365,7,1
378943,58593,340,109,12563,0,12903,109,1
2981537,2591392,1252,6,118718,0,119970,6,1
3721550,3585205,188,55,14527,0,14715,55,1
2489256,3958791,11,129,118,72,129,201,1
2961801,4865657,1483,53,101962,0,103445,53,1
462298,4731963,414,33,10933,0,11347,33,1
4104022,4834275,126,20,2390,0,2516,20,1
4727207,2237422,925,1,84581,0,85506,1,1
1492163,2165585,49,3,837,0,886,3,1
813554,4330391,252,773,17214,32759,17466,33532,1
4479581,338340,601,17,19545,0,20146,17,1
1880135,763973,810,1,71924,0,72734,1,1
3361377,3627333,4841,5,761793,0,766634,5,1
791450,4530534,27,97,165,78,192,175,1
161276,731703,146,124,6548,0,6694,124,1
3989108,2034310,372,109,7033,0,7405,109,1
805360,1835938,1514,22,119306,0,120820,22,1
1717922,3933362,432,187,6340,0,6772,187,1
4497340,4135271,97,51,574,0,671,51,1
2524671,4472088,140,2,7015,0,7155,2,1
1250021,4352539,4637,8,85913,0,90550,8,1
859694,1121999,433,243,4244,0,4677,243,1
3438576,4751645,3424,71,137753,0,141177,71,1
1534362,2235353,1531,81,105859,0,107390,81,1
1580988,2792558,2821,37,400133,405,402954,442,1
4304056,837553,164,1249,12698,61665,12862,62914,1
2141187,687397,35,21,506,0,541,21,1
2821086,941859,152,318,4157,0,4309,318,1
3676295,1133958,374,1,70881,0,71255,1,1
3638272,1069356,2022,1,370904,0,372926,1,1
1906425,2271040,273,38,2940,0,3213,38,1
805360,1372079,1514,6,119306,0,120820,6,1
6618,1384528,892,51,68849,1242,69741,1293,1
1364801,180673,450,20,4704,0,5154,20,1
3689772,1837970,97,1,1170,0,1267,1,1
2981537,1359736,1252,1,118718,0,119970,1,1
3930937,4836368,225,75,8777,0,9002,75,1
1880135,4305621,810,34,71924,0,72734,34,1
2075015,2838502,2664,323,85781,0,88445,323,1
1038389,1442568,162,28,698,0,860,28,1
1591435,561321,387,2,31245,0,31632,2,1
2495609,4267589,103,198,2169,0,2272,198,1
1984092,656004,68,58,1890,0,1958,58,1
2342664,1038135,1181,15,26502,0,27683,15,1
2498087,352861,1630,25,32582,0,34212,25,1
791133,936282,485,31,3126,0,3611,31,1
4856623,3866209,125,449,1815,2902,1940,3351,1
1898822,4566171,114,3,3885,0,3999,3,1
4320535,2191821,39,165,464,63,503,228,1
3405059,2744610,261,44,9604,0,9865,44,1
356110,1945262,86,45,1880,0,1966,45,1
2348182,2882948,469,143,4747,0,5216,143,1
670587,3949937,651,70,9779,0,10430,70,1
3536369,1563829,107,5,1034,0,1141,5,1
2441073,3626443,126,18,3161,0,3287,18,1
2464401,432640,577,495,23681,0,24258,495,1
4798192,2888305,816,374,20426,0,21242,374,1
4721617,3486643,307,7,12885,0,13192,7,1
3004174,3220423,258,46,5546,0,5804,46,1
1621606,1829318,559,62,4228,0,4787,62,1
507060,2571784,191,85,6141,0,6332,85,1
1196844,2649866,548,301,36289,0,36837,301,1
1601101,2113492,578,65,1448,0,2026,65,1
3438576,386220,3424,29,137753,0,141177,29,1
1973082,4484624,1036,13,18915,0,19951,13,1
2189845,1583655,12,10,264,0,276,10,1
866357,2311939,825,172,18479,0,19304,172,1
2346646,4721270,101,1,2267,0,2368,1,1
4374509,2690906,770,44,9940,0,10710,44,1
4238001,4049514,869,262,61161,0,62030,262,1
6618,4242357,892,234,68849,0,69741,234,1
1580988,1281704,2821,1,400133,0,402954,1,1
3671141,599028,1444,38,48400,0,49844,38,1
3509903,1519304,1530,234,509445,0,510975,234,1
3071504,1104483,80,76,3797,0,3877,76,1
4863816,1298272,213,184,649,0,862,184,1
1652056,3468350,326,1,66845,0,67171,1,1
3361377,980829,4841,11,761793,0,766634,11,1
4423184,2149042,384,144,29809,0,30193,144,1
3438576,4554196,3424,4,137753,0,141177,4,1
3836080,3965018,1197,97,59457,0,60654,97,1
680662,667028,365,162,5393,0,5758,162,1
382977,511070,143,54,5934,0,6077,54,1
441667,74558,198,45,14727,0,14925,45,1
2358233,1901557,46,36,665,0,711,36,1
1580988,1572862,2821,1,400133,0,402954,1,1
4411870,2062115,948,136,60517,0,61465,136,1
4140279,2193873,337,1,49384,0,49721,1,1
4183784,1234543,931,97,59894,0,60825,97,1
4289995,1486498,525,14,4959,0,5484,14,1
4181760,4593605,359,6,7855,0,8214,6,1
1723506,1363897,733,406,21835,0,22568,406,1
3509903,2636230,1530,2,509445,0,510975,2,1
3115867,496699,1350,5,61232,0,62582,5,1
2793423,4647179,122,2,1527,0,1649,2,1
595757,3858696,340,19,26738,0,27078,19,1
1913445,528800,564,140,47943,0,48507,140,1
439557,4863202,2090,24,61744,0,63834,24,1
3361377,3125676,4841,3,761793,0,766634,3,1
2031305,1226560,396,49,23435,0,23831,49,1
2285283,4866631,279,70,6799,0,7078,70,1
1086912,4231234,907,2,33396,0,34303,2,1
2311472,4724407,91,89,2259,0,2350,89,1
2516076,2608979,1455,28,77782,0,79237,28,1
4400969,2289982,33,3,1123,0,1156,3,1
719103,2226169,26,4,93,0,119,4,1
4093043,2206104,18,2,223,0,241,2,1
1573878,3848944,99,39,489,0,588,39,1
3509903,4002246,1530,2,509445,0,510975,2,1
2537929,3363352,45,15,1110,0,1155,15,1
339563,2621002,1999,211,7561,0,9560,211,1
3988413,1993429,83,7,1410,0,1493,7,1
2092359,1636004,421,120,26936,0,27357,120,1
593740,4415568,1107,46,62807,0,63914,46,1
3500846,1163953,210,190,5085,0,5295,190,1
4653941,1815895,951,1,45883,0,46834,1,1
3836080,532311,1197,242,59457,0,60654,242,1
4198771,4328763,207,15,8543,0,8750,15,1
2827436,4060429,882,5,271525,0,272407,5,1
4286284,4183362,272,16,1571,0,1843,16,1
2477256,20551,1124,186,7025,0,8149,186,1
4295952,2710889,808,379,57369,0,58177,379,1
4372962,3609927,53,101,771,497,824,598,1
3871554,238770,947,1,16042,0,16989,1,1
2877907,2654020,508,31,16021,0,16529,31,1
2260014,3292093,2466,10,98622,0,101088,10,1
1518103,4015882,50,49,1931,0,1981,49,1
418588,2390105,65,174,569,388,634,562,1
1575009,3543768,429,77,37745,0,38174,77,1
1250021,2456560,4637,7,85913,0,90550,7,1
1112208,940337,51,6,551,0,602,6,1
3346033,36134,320,6,9541,0,9861,6,1
530200,350966,2035,11,62809,0,64844,11,1
4179343,1517558,119,9,9822,0,9941,9,1
4751453,141572,520,6,27570,0,28090,6,1
50614,592391,253,13,2444,0,2697,13,1
3343693,1927690,24,25,416,0,440,25,1
2781817,2548979,704,6,24613,0,25317,6,1
354904,2262588,3193,27,105780,0,108973,27,1
4011264,3942388,1360,20,116777,0,118137,20,1
3379358,184257,44,1,3147,0,3191,1,1
4672319,4149180,483,228,9652,0,10135,228,1
1196844,4326104,548,15,36289,0,36837,15,1
1767687,1988062,148,9,291,0,439,9,1
1436216,905312,1068,3,68770,0,69838,3,1
3361377,2187131,4841,6,761793,0,766634,6,1
4203775,4707338,84,40,404,0,488,40,1
1374852,4249074,49,99,427,0,476,99,1
3361377,124247,4841,3,761793,0,766634,3,1
755739,1835261,1117,33,58043,0,59160,33,1
3438576,1926235,3424,3,137753,0,141177,3,1
1580988,1718053,2821,1,400133,0,402954,1,1
3662626,3454055,52,2914,464,54,516,2968,1
3638272,3360751,2022,2,370904,0,372926,2,1
4451491,537789,817,670,8836,0,9653,670,1
2063726,2963581,61,41,308,0,369,41,1
364718,3271484,4,1507,36,34093,40,35600,1
3794274,166452,585,239,2539,0,3124,239,1
873006,4165325,375,43,33630,0,34005,43,1
2961552,2115654,562,13,16546,0,17108,13,1
1459082,19017,92,456,214,111,306,567,1
2985909,3039725,706,17,43348,0,44054,17,1
3794274,4311167,585,9,2539,0,3124,9,1
953240,3708577,34,31,346,0,380,31,1
1462439,2520522,777,90,5849,145,6626,235,1
862958,1733965,87,20,4203,0,4290,20,1
3755697,1866310,76,4,350,0,426,4,1
929513,3133889,145,144,4279,0,4424,144,1
1865128,3477454,76,18,2838,0,2914,18,1
3509903,825192,1530,1,509445,0,510975,1,1
1281156,2470160,21,103,196,4362,217,4465,1
2529661,2761019,493,16,27309,0,27802,16,1
2307868,1588328,1131,48,38777,0,39908,48,1
3137585,2093138,1196,25,77354,0,78550,25,1
4011264,3545241,1360,22,116777,0,118137,22,1
2308819,1252731,141,25,5491,0,5632,25,1
709709,168823,166,533,1358,152,1524,685,1
4191727,1099780,463,3,26315,0,26778,3,1
1983217,355425,67,1,874,0,941,1,1
1539209,497013,126,35,513,0,639,35,1
1497278,3612051,1869,58,35111,0,36980,58,1
1190435,1665851,432,35,3922,0,4354,35,1
743837,158589,613,204,2344,0,2957,204,1
3638272,2782670,2022,2,370904,0,372926,2,1
502082,1177988,589,77,16428,0,17017,77,1
4838376,3863991,606,62,26838,0,27444,62,1
2879897,696168,164,99,3212,0,3376,99,1
2615523,3120544,68,46,352,0,420,46,1
3361377,2467395,4841,1,761793,0,766634,1,1
1431189,3323039,167,71,3075,0,3242,71,1
1331940,3501656,802,20,32617,0,33419,20,1
964291,979316,139,867,1427,3442,1566,4309,1
1429691,355187,35,3,986,0,1021,3,1
932720,4584581,1411,34,111323,0,112734,34,1
3387987,2127990,268,266,19035,0,19303,266,1
2281149,665635,282,34,28082,0,28364,34,1
1927211,461221,1668,40,113322,0,114990,40,1
427805,1430163,483,4,156906,0,157389,4,1
4731849,3562954,455,29,10886,0,11341,29,1
2981537,1961430,1252,12,118718,0,119970,12,1
1436216,4104715,1068,60,68770,0,69838,60,1
3509903,2388840,1530,1,509445,0,510975,1,1
4191410,2236687,1590,38,96434,0,98024,38,1
2307868,2264611,1131,24,38777,0,39908,24,1
454784,2633617,5,46,129,0,134,46,1
573641,2289349,253,154,5074,0,5327,154,1
2981537,4321856,1252,2,118718,0,119970,2,1
3449530,1668603,717,6,73648,0,74365,6,1
2518731,1819991,116,16,384,0,500,16,1
429643,175950,767,132,19668,0,20435,132,1
4191410,4730539,1590,194,96434,0,98024,194,1
3943091,1354618,53,1,10283,0,10336,1,1
4030322,3402731,3,3654,54,18,57,3672,1
2696500,4008776,267,17,4128,0,4395,17,1
4272102,4446381,1608,56,104171,0,105779,56,1
974518,25824,81,29,1365,0,1446,29,1
2592149,856633,98,4,273,8,371,12,1
3361377,1435438,4841,2,761793,0,766634,2,1
1075792,3398861,181,7,4505,0,4686,7,1
1339861,3763590,200,185,1212,0,1412,185,1
765601,3827392,1485,17,101510,0,102995,17,1
1580988,1007762,2821,3,400133,0,402954,3,1
4360960,4185426,1642,26,110084,0,111726,26,1
3561502,2153694,1144,138,68800,0,69944,138,1
3835618,774669,694,11,25433,0,26127,11,1
2777702,740595,147,12,715,0,862,12,1
1788928,2766550,14,862,224,0,238,862,1
3638272,2334663,2022,2,370904,0,372926,2,1
2961203,3321339,14,1,54,0,68,1,1
1110514,3446072,68,1,3569,0,3637,1,1
2343253,3085703,1882,6,86401,0,88283,6,1
4183784,1418907,931,53,59894,0,60825,53,1
2343253,1500467,1882,6,86401,0,88283,6,1
4372648,4108412,275,3,3150,0,3425,3,1
3509903,2997335,1530,1,509445,0,510975,1,1
3395938,1145425,546,2,39878,0,40424,2,1
1989911,2952337,12,14,62,0,74,14,1
3517464,2094284,19,2,171,0,190,2,1
2502456,1698287,719,41,50725,0,51444,41,1
2015060,1509770,78,25,666,0,744,25,1
1539837,406919,1127,3,62979,0,64106,3,1
3711620,3085568,94,664,635,0,729,664,1
3407666,2692978,304,512,1290,0,1594,512,1
1580988,86213,2821,1,400133,0,402954,1,1
4295952,3141036,808,104,57369,0,58177,104,1
4191410,3125808,1590,26,96434,0,98024,26,1
4485028,4555013,445,161,14565,0,15010,161,1
1055530,90921,415,37,14969,0,15384,37,1
3605448,1634840,202,515,2022,0,2224,515,1
1880135,1241219,810,28,71924,0,72734,28,1
1207753,3489310,533,77,9348,0,9881,77,1
2516076,4605200,1455,68,77782,0,79237,68,1
3765475,2922053,873,6,107914,0,108787,6,1
2823666,1792116,31,10,1079,0,1110,10,1
427805,1898862,483,1,156906,0,157389,1,1
3069382,2249096,113,33,5201,0,5314,33,1
1221325,847657,153,18,1819,0,1972,18,1
4671746,4690413,512,7,4544,0,5056,7,1
1163180,3777988,606,2,5885,0,6491,2,1
1189037,2303150,182,39,1049,0,1231,39,1
3509903,1760399,1530,3,509445,0,510975,3,1
1580988,902951,2821,1,400133,0,402954,1,1
765601,1614674,1485,85,101510,0,102995,85,1
2895033,2505677,164,55,2870,0,3034,55,1
2962038,2174250,495,3,14236,0,14731,3,1
3361377,1000456,4841,1,761793,0,766634,1,1
4853234,3609732,1256,37,29554,0,30810,37,1
2209136,3760704,620,91,33789,0,34409,91,1
1508024,2508588,389,30,1845,0,2234,30,1
1518103,2163342,50,181,1931,0,1981,181,1
922879,1607225,143,18,1546,0,1689,18,1
4319972,3137789,640,1,35279,0,35919,1,1
4467052,4351124,18,627,193,39,211,666,1
157174,544230,99,1532,407,60768,506,62300,1
3638272,1045462,2022,1,370904,0,372926,1,1
3361377,4466955,4841,1,761793,0,766634,1,1
1913445,2309431,564,141,47943,0,48507,141,1
3501482,4303389,522,2,28046,0,28568,2,1
3140664,2990325,268,112,16099,0,16367,112,1
293665,4787837,139,1022,1817,0,1956,1022,1
2762372,1687185,818,185,6089,0,6907,185,1
1580988,2389471,2821,2,400133,0,402954,2,1
860308,2118849,19,16,147,0,166,16,1
4295952,2412916,808,27,57369,0,58177,27,1
4360960,3364170,1642,55,110084,0,111726,55,1
4360960,831498,1642,32,110084,0,111726,32,1
4560210,942150,177,2,6565,0,6742,2,1
4140279,2418193,337,9,49384,0,49721,9,1
709709,312209,166,12,1358,0,1524,12,1
1493489,993733,523,66,17512,0,18035,66,1
3361377,3711856,4841,10,761793,0,766634,10,1
932720,1821720,1411,26,111323,0,112734,26,1
2851109,4157874,450,2,98552,0,99002,2,1
1973082,3844385,1036,39,18915,0,19951,39,1
4295952,4331674,808,13,57369,0,58177,13,1
3531730,2298945,334,4,9763,0,10097,4,1
837553,3850001,1249,1,61665,0,62914,1,1
1331940,724193,802,47,32617,0,33419,47,1
4272102,4350467,1608,54,104171,0,105779,54,1
2343253,3839682,1882,2,86401,0,88283,2,1
1723506,424020,733,16,21835,0,22568,16,1
4045966,2102760,167,104,1316,0,1483,104,1
1534362,2539323,1531,367,105859,0,107390,367,1
2206250,2973535,153,11,4857,0,5010,11,1
427805,3508555,483,1,156906,0,157389,1,1
4593330,2984468,203,61,8083,0,8286,61,1
2851109,4852280,450,2,98552,0,99002,2,1
1129707,4290499,155,669,612,0,767,669,1
3123201,2685122,126,65,5539,0,5665,65,1
3023881,1934907,1035,156,996,0,2031,156,1
3289311,4353839,107,144,2041,3320,2148,3464,1
2092359,315305,421,1,26936,0,27357,1,1
4140279,3839750,337,1,49384,0,49721,1,1
1580988,1237279,2821,1,400133,0,402954,1,1
1293807,379792,1837,12,30865,0,32702,12,1
1313296,293344,152,73,540,198,692,271,1
1063358,4192131,1350,75,63494,0,64844,75,1
4642569,922266,872,447,27586,0,28458,447,1
366980,1710455,114,14,497,0,611,14,1
2150261,4512909,332,118,2204,0,2536,118,1
4004339,1605666,153,23,6086,0,6239,23,1
4337603,1909590,333,184,9909,0,10242,184,1
3941858,2587879,202,23,5760,0,5962,23,1
4357854,234804,300,655,2963,0,3263,655,1
2657429,3877636,112,393,498,2053,610,2446,1
2260014,1208766,2466,5,98622,0,101088,5,1
3638272,675023,2022,1,370904,0,372926,1,1
1163500,1481204,398,94,9540,0,9938,94,1
3481008,2148826,201,108,1452,0,1653,108,1
4279424,4284575,293,1,948,0,1241,1,1
1250021,1119829,4637,14,85913,0,90550,14,1
1206697,4434849,685,568,5595,0,6280,568,1
3066330,4784274,97,2,2081,0,2178,2,1
2106653,122620,100,41,2586,0,2686,41,1
1838158,1934053,180,52,1634,0,1814,52,1
1124035,1633223,84,10,3736,0,3820,10,1
2420083,369215,31,15,430,0,461,15,1
4319972,4571257,640,73,35279,0,35919,73,1
1611386,1749384,187,60,10932,0,11119,60,1
858265,3558518,138,276,1480,0,1618,276,1
1971223,1924204,338,395,5185,0,5523,395,1
3438576,2669216,3424,280,137753,1050,141177,1330,1
3137585,4233339,1196,62,77354,0,78550,62,1
3509903,590201,1530,2,509445,0,510975,2,1
1100354,3577477,163,6,24439,0,24602,6,1
1937293,4740744,434,1,16761,0,17195,1,1
1580988,1770871,2821,1,400133,0,402954,1,1
1609659,3277946,523,345,29763,0,30286,345,1
3824547,2336674,1075,2,14337,0,15412,2,1
2896906,553397,1193,72,7172,0,8365,72,1
1389617,1982612,482,424,2070,0,2552,424,1
4209323,415173,1630,28,89460,0,91090,28,1
3941858,1651423,202,117,5760,0,5962,117,1
1221325,339493,153,53,1819,0,1972,53,1
2261139,3360653,2014,61,42851,0,44865,61,1
3361377,2302311,4841,2,761793,0,766634,2,1
2321367,275952,97,14,932,0,1029,14,1
3509903,2143288,1530,1,509445,0,510975,1,1
1138515,1845006,341,25,12443,0,12784,25,1
3916976,603535,188,32,6098,0,6286,32,1
4653941,751394,951,65,45883,0,46834,65,1
4384375,418025,129,120,4747,0,4876,120,1
3361377,2053682,4841,1,761793,0,766634,1,1
918918,1782399,130,159,1960,0,2090,159,1
3124291,20674,237,5,712,0,949,5,1
4238001,1116897,869,66,61161,0,62030,66,1
3509903,1338975,1530,2,509445,0,510975,2,1
4678614,2951674,452,199,16881,0,17333,199,1
2260014,4062133,2466,3,98622,0,101088,3,1
401947,3711843,367,1,7890,0,8257,1,1
1927211,2630962,1668,28,113322,0,114990,28,1
1847461,1175192,1211,63,51149,0,52360,63,1
3567246,1296957,192,43,3712,0,3904,43,1
2147720,3234191,1608,46,78786,0,80394,46,1
775759,3402731,18,3654,112,18,130,3672,1
3361377,2375349,4841,1,761793,0,766634,1,1
1893962,3430959,79,180,278,0,357,180,1
1494665,3371579,668,204,37638,1218,38306,1422,1
571147,4417364,364,147,5484,0,5848,147,1
2348182,83297,469,336,4747,0,5216,336,1
3242275,993494,551,25,17400,0,17951,25,1
805360,1927869,1514,5,119306,0,120820,5,1
787416,234041,115,1,9954,0,10069,1,1
3280389,4772125,1101,1,411419,0,412520,1,1
1580474,3822647,67,7,5377,0,5444,7,1
4653941,3522484,951,62,45883,0,46834,62,1
1051108,2371614,262,79,7542,0,7804,79,1
3164098,2285259,87,2,404,0,491,2,1
4408153,686279,58,36,1129,0,1187,36,1
1436216,3247591,1068,4,68770,0,69838,4,1
466667,1982191,442,235,4239,508,4681,743,1
492385,4688650,21,36,232,509,253,545,1
4624595,1705845,722,177,53368,0,54090,177,1
3361377,4757174,4841,3,761793,0,766634,3,1
3441479,1783446,97,10,810,0,907,10,1
3705070,1616583,740,12,14938,0,15678,12,1
2291145,1776872,221,41,3037,0,3258,41,1
3494785,1761805,1253,5,539,0,1792,5,1
4035838,3577011,304,11,2624,0,2928,11,1
3487335,1388939,105,11,375,33,480,44,1
3361377,868030,4841,2,761793,0,766634,2,1
2529661,457891,493,70,27309,0,27802,70,1
2247657,2749095,306,48,7138,0,7444,48,1
2159993,2515407,39,48,670,0,709,48,1
3210349,1660460,46,30,3372,0,3418,30,1
709509,150782,359,5,2719,0,3078,5,1
4801471,1105129,585,19,17979,0,18564,19,1
1913445,2932040,564,20,47943,0,48507,20,1
2949069,4266516,37,1,399,0,436,1,1
3280389,2179360,1101,1,411419,0,412520,1,1
1580988,1973027,2821,3,400133,0,402954,3,1
3361377,1437234,4841,1,761793,0,766634,1,1
3361377,1990030,4841,1,761793,0,766634,1,1
2052485,568126,59,4,2664,0,2723,4,1
4838376,1949592,606,19,26838,0,27444,19,1
4451227,1247288,27,35,450,0,477,35,1
4789203,808644,355,1050,11315,0,11670,1050,1
2242848,4693564,24,28,383,0,407,28,1
4721617,2234003,307,2,12885,0,13192,2,1
2341838,1086363,75,14,3932,0,4007,14,1
2751125,957700,48,1,676,0,724,1,1
4417253,88775,1130,16,68389,0,69519,16,1
4061273,948027,143,18,2219,0,2362,18,1
3277539,3827311,147,9,986,0,1133,9,1
3554339,3173224,342,137,559,0,901,137,1
3387987,1985185,268,266,19035,0,19303,266,1
1875,4162355,656,7,61388,0,62044,7,1
1436216,1387975,1068,4,68770,0,69838,4,1
4701417,59160,305,25,3855,0,4160,25,1
1164238,4182062,179,119,2363,0,2542,119,1
457452,3996799,60,17,1010,0,1070,17,1
1986790,3692193,4,7,80,0,84,7,1
1531446,1924197,142,61,864,0,1006,61,1
3509903,723575,1530,3,509445,0,510975,3,1
323258,723574,50,1515,577,0,627,1515,1
3765475,813347,873,3,107914,0,108787,3,1
855111,101625,31,9,420,0,451,9,1
3271484,3052240,1507,3,34093,0,35600,3,1
3361377,332678,4841,1,761793,0,766634,1,1
1652056,3790844,326,1,66845,0,67171,1,1
1533546,2529947,703,11,22095,0,22798,11,1
2981984,371654,71,25,317,16,388,41,1
978797,101661,599,17,12421,0,13020,17,1
3280389,3422643,1101,1,411419,0,412520,1,1
2348093,4082882,335,26,12064,0,12399,26,1
3361377,4241299,4841,4,761793,0,766634,4,1
493062,1591361,34,56,2722,0,2756,56,1
2851109,4754268,450,3,98552,0,99002,3,1
439557,1676768,2090,187,61744,0,63834,187,1
1311307,1167656,358,53,10864,0,11222,53,1
3280389,1313954,1101,1,411419,0,412520,1,1
3638272,1103789,2022,1,370904,0,372926,1,1
892512,3669469,1505,69,11757,0,13262,69,1
370461,2682795,103,13,1991,0,2094,13,1
4011264,3814244,1360,76,116777,0,118137,76,1
4258870,2876791,336,287,4963,0,5299,287,1
1880135,3662360,810,8,71924,0,72734,8,1
1331570,3930611,103,333,2386,0,2489,333,1
2946468,354904,43,3193,200,105780,243,108973,1
427805,2966856,483,2,156906,0,157389,2,1
3742930,3926787,410,96,22242,0,22652,96,1
3387987,838052,268,141,19035,0,19303,141,1
3633019,1353584,746,56,32317,0,33063,56,1
3316620,1965066,214,8,5083,0,5297,8,1
3139564,192696,76,1,224,0,300,1,1
2781817,4176547,704,6,24613,0,25317,6,1
2781817,44908,704,34,24613,0,25317,34,1
2027108,4454996,1172,16,5587,0,6759,16,1
3567246,3696916,192,265,3712,0,3904,265,1
3632293,3977972,570,132,21294,0,21864,132,1
4011264,3246888,1360,4,116777,0,118137,4,1
1272751,1812323,153,96,1127,0,1280,96,1
3638272,1584182,2022,5,370904,0,372926,5,1
3419989,4049514,350,262,16316,0,16666,262,1
4767550,410350,65,9,1636,0,1701,9,1
2052930,1259561,407,16,8479,0,8886,16,1
3065808,2499570,1235,53,82317,0,83552,53,1
290670,2347024,252,185,3851,0,4103,185,1
1436216,2414163,1068,2,68770,0,69838,2,1
2522799,268395,253,7,3062,0,3315,7,1
2295788,3248482,289,479,2710,0,2999,479,1
2207944,1773650,165,62,4573,0,4738,62,1
765601,4820776,1485,33,101510,0,102995,33,1
1984622,497262,145,80,20659,1897,20804,1977,1
2685897,3314091,38,2,4789,0,4827,2,1
255306,2226271,21,5,107,0,128,5,1
1086912,821599,907,9,33396,0,34303,9,1
3612833,1331265,38,59,34,397,72,456,1
3361377,2427152,4841,2,761793,0,766634,2,1
1511324,1429176,415,709,791,28,1206,737,1
3959546,565730,233,365,2002,151,2235,516,1
3102873,395462,341,421,15098,0,15439,421,1
92352,4279668,1138,43,20575,0,21713,43,1
1968010,4242553,786,141,10371,0,11157,141,1
2075015,849757,2664,13,85781,0,88445,13,1
2209136,2561,620,5,33789,0,34409,5,1
2659363,381876,100,56,826,0,926,56,1
3509903,1545454,1530,1,509445,0,510975,1,1
2343253,313621,1882,7,86401,0,88283,7,1
3396719,861773,660,2,8141,0,8801,2,1
2339149,943222,97,54,4258,0,4355,54,1
1583787,2196471,5,1,55,0,60,1,1
3992144,4815051,402,14,23683,0,24085,14,1
1903752,4452492,506,10,10494,0,11000,10,1
3691520,1551925,533,56,9121,0,9654,56,1
3151252,3997113,90,40,880,1233,970,1273,1
4519069,4271066,387,1,20799,0,21186,1,1
3873768,1471050,449,1,35424,0,35873,1,1
3949507,2636641,121,2,1877,0,1998,2,1
1504506,2787677,551,136,1317,0,1868,136,1
2827436,3585831,882,1,271525,0,272407,1,1
4853234,4350264,1256,3,29554,0,30810,3,1
4191410,517339,1590,45,96434,0,98024,45,1
3631686,4696172,165,20,319,0,484,20,1
1875,3824899,656,43,61388,0,62044,43,1
1580988,944456,2821,77,400133,0,402954,77,1
289767,1721989,43,5,323,0,366,5,1
3280389,4182839,1101,4,411419,0,412520,4,1
2827436,2683779,882,1,271525,0,272407,1,1
3280389,65282,1101,1,411419,0,412520,1,1
401947,3477304,367,317,7890,0,8257,317,1
1923198,2695298,531,379,3973,0,4504,379,1
2878621,4390770,194,243,2011,0,2205,243,1
2827436,3049228,882,1,271525,0,272407,1,1
2985909,1700532,706,69,43348,0,44054,69,1
805360,4450504,1514,46,119306,0,120820,46,1
4011264,2393810,1360,17,116777,0,118137,17,1
4577918,3488604,54,9,993,0,1047,9,1
2172854,4747268,239,50,2000,125,2239,175,1
154154,3002604,37,25,687,0,724,25,1
2981537,3277317,1252,2,118718,0,119970,2,1
435003,4814764,92,3,1730,0,1822,3,1
2748275,1559148,93,24,286,0,379,24,1
4782707,3432028,513,134,31665,0,32178,134,1
2989110,4837729,1042,116,19283,0,20325,116,1
1580988,4147650,2821,1,400133,0,402954,1,1
2454128,2095913,130,7,802,0,932,7,1
4349341,3768271,24,14,1570,0,1594,14,1
1927974,4201375,107,182,9317,0,9424,182,1
593740,2666393,1107,93,62807,0,63914,93,1
532681,3170524,433,8,35023,0,35456,8,1
605874,2617940,145,168,3312,0,3457,168,1
2851109,477934,450,1,98552,0,99002,1,1
1367688,3487259,101,1227,557,1456,658,2683,1
3361377,2797178,4841,33,761793,0,766634,33,1
892512,2681744,1505,15,11757,0,13262,15,1
2198488,2359118,37,104,2593,822,2630,926,1
2961552,1022212,562,3,16546,0,17108,3,1
1370197,889330,665,148,3306,1591,3971,1739,1
3361377,1215635,4841,1,761793,0,766634,1,1
392779,1749819,148,5,2136,0,2284,5,1
3361377,3274783,4841,5,761793,0,766634,5,1
2772892,1340071,120,29,836,0,956,29,1
4068258,2861443,110,136,97,0,207,136,1
755739,2236437,1117,48,58043,0,59160,48,1
831951,2810292,68,17,781,0,849,17,1
2627267,298036,44,201,413,0,457,201,1
611927,4379288,305,393,8695,0,9000,393,1
4479896,469550,52,23,1132,0,1184,23,1
427805,1652244,483,2,156906,0,157389,2,1
466667,2497208,442,37,4239,0,4681,37,1
4209961,1992163,48,11,458,0,506,11,1
4777016,3639908,69,109,813,0,882,109,1
4360960,91569,1642,68,110084,0,111726,68,1
3280389,2068793,1101,1,411419,0,412520,1,1
3906136,4585731,387,67,41169,0,41556,67,1
502327,3877207,57,11,313,0,370,11,1
4295952,4576734,808,2,57369,0,58177,2,1
1704222,692355,69,2,179,0,248,2,1
3816962,52608,160,2,1665,0,1825,2,1
3361377,2030578,4841,1,761793,0,766634,1,1
4750855,552390,355,59,18880,0,19235,59,1
3764177,4442238,1036,447,64563,0,65599,447,1
1613202,615890,566,239,8639,2229,9205,2468,1
779657,544230,121,1532,895,60768,1016,62300,1
1635215,687836,209,49,8253,0,8462,49,1
489387,1014833,42,5,693,0,735,5,1
2150686,4371792,69,91,983,852,1052,943,1
3569179,3461417,1064,1,40015,0,41079,1,1
2187320,2858533,208,3,3143,0,3351,3,1
1611386,2856506,187,80,10932,0,11119,80,1
4731849,4018335,455,20,10886,0,11341,20,1
1196844,1626061,548,113,36289,0,36837,113,1
1734816,4458208,159,73,2395,0,2554,73,1
2267633,1319276,422,26,13247,0,13669,26,1
2934549,776786,255,107,2836,0,3091,107,1
1285213,4187061,21,86,300,111,321,197,1
2161375,1232211,52,1,2492,0,2544,1,1
1521082,2118477,766,81,6562,0,7328,81,1
3638272,1493346,2022,1,370904,0,372926,1,1
135188,3787212,51,30,5860,0,5911,30,1
3906136,4226213,387,1,41169,0,41556,1,1
1710318,847228,95,75,1946,0,2041,75,1
3509903,2721491,1530,1,509445,0,510975,1,1
3361377,401591,4841,6,761793,0,766634,6,1
665164,2683510,396,177,12610,0,13006,177,1
932720,2213290,1411,51,111323,0,112734,51,1
3765475,1833597,873,1,107914,0,108787,1,1
4295952,30655,808,4,57369,0,58177,4,1
2138219,2137663,110,11,600,0,710,11,1
4727207,1937825,925,2,84581,0,85506,2,1
2147720,247814,1608,15,78786,0,80394,15,1
3115867,4240532,1350,32,61232,0,62582,32,1
3395938,356951,546,93,39878,0,40424,93,1
2772113,1075022,792,480,42907,0,43699,480,1
3910135,2552845,298,24,14348,0,14646,24,1
4220190,4053607,320,181,15994,2197,16314,2378,1
805360,2778466,1514,33,119306,0,120820,33,1
2893334,4302921,889,509,30148,13289,31037,13798,1
3296550,67304,11,3,99,0,110,3,1
4823828,3056344,124,284,208,62,332,346,1
4011264,3030604,1360,53,116777,0,118137,53,1
3361377,1898945,4841,1,761793,0,766634,1,1
3361377,3736848,4841,1,761793,0,766634,1,1
3943091,2413661,53,13,10283,0,10336,13,1
2851916,274589,167,15,728,0,895,15,1
2466110,3828907,107,5,348,0,455,5,1
767034,999102,107,77,1474,0,1581,77,1
354904,66440,3193,15,105780,0,108973,15,1
1635717,1674603,174,15,1173,0,1347,15,1
4731722,3434131,151,30,1196,0,1347,30,1
1652056,3047527,326,1,66845,0,67171,1,1
4342519,4296261,138,2,11317,0,11455,2,1
1580988,4417279,2821,1,400133,0,402954,1,1
3288730,1046694,117,15,4627,0,4744,15,1
3361377,3674285,4841,1,761793,0,766634,1,1
1520236,2323475,97,150,213,134,310,284,1
1055530,2345592,415,36,14969,0,15384,36,1
366948,2902512,13,11,339,0,352,11,1
2553405,2440110,568,2,12913,0,13481,2,1
2375878,1233116,248,24,14925,0,15173,24,1
4330391,702107,773,25,32759,0,33532,25,1
4594361,3996996,103,31,3448,0,3551,31,1
765601,3429756,1485,99,101510,0,102995,99,1
3346033,4635568,320,1,9541,0,9861,1,1
2856517,959876,1,98,136,0,137,98,1
2961552,2859958,562,65,16546,0,17108,65,1
3509903,2423658,1530,5,509445,0,510975,5,1
4479581,3508051,601,4,19545,0,20146,4,1
3127090,4188751,678,1,10017,0,10695,1,1
1436216,1417862,1068,1,68770,0,69838,1,1
1580988,4293614,2821,26,400133,0,402954,26,1
1312530,862336,40,30,156,0,196,30,1
2772113,2137453,792,24,42907,0,43699,24,1
1880135,2376109,810,64,71924,0,72734,64,1
3361377,1786790,4841,1,761793,0,766634,1,1
4220190,61674,320,21,15994,0,16314,21,1
3509214,360036,263,15,14139,0,14402,15,1
572390,288810,91,1,3173,0,3264,1,1
3941858,3447136,202,6,5760,0,5962,6,1
3280389,2314036,1101,1,411419,0,412520,1,1
1609659,1652091,523,94,29763,0,30286,94,1
3361377,3839553,4841,1,761793,0,766634,1,1
489584,174234,421,2,12098,0,12519,2,1
1927211,4661022,1668,6,113322,0,114990,6,1
3509903,4381402,1530,1,509445,0,510975,1,1
3316576,1020878,669,11,7971,0,8640,11,1
4404761,82918,247,88,1238,3786,1485,3874,1
530200,3986617,2035,96,62809,0,64844,96,1
3898535,1352331,59,92,9303,0,9362,92,1
57574,4837909,289,12,4616,0,4905,12,1
2446968,4149345,452,158,20110,0,20562,158,1
21944,1619989,317,40,9419,0,9736,40,1
2542968,3469699,444,26,4728,0,5172,26,1
4435816,1344333,262,1,8391,0,8653,1,1
1196844,892334,548,7,36289,0,36837,7,1
3335189,3779487,29,148,186,0,215,148,1
1609659,2314281,523,172,29763,0,30286,172,1
768957,3445171,202,23,7986,0,8188,23,1
4600097,2044050,25,67,261,225,286,292,1
4313572,2539968,930,58,16971,0,17901,58,1
3361377,215623,4841,2,761793,0,766634,2,1
792037,434151,57,2,16445,0,16502,2,1
3645402,899938,153,27,7400,0,7553,27,1
3734728,430233,85,8,789,0,874,8,1
1471685,457544,1681,28,25550,0,27231,28,1
1103332,2227727,732,95,59415,0,60147,95,1
3641600,1802189,751,21,9269,0,10020,21,1
1544547,1732048,47,103,1177,0,1224,103,1
4642569,239992,872,36,27586,0,28458,36,1
4678614,1434311,452,271,16881,0,17333,271,1
1723506,2712521,733,119,21835,0,22568,119,1
3140992,4805819,28,513,321,9,349,522,1
3871554,3942571,947,7,16042,0,16989,7,1
2148937,2323233,672,1,47361,0,48033,1,1
3549674,1747296,602,147,38542,0,39144,147,1
1063857,3047650,248,3,15849,0,16097,3,1
4423184,4725959,384,99,29809,0,30193,99,1
2772113,4472701,792,16,42907,0,43699,16,1
1234540,2527667,1071,79,75251,0,76322,79,1
3509903,3479548,1530,1,509445,0,510975,1,1
3119726,2730873,299,161,11573,0,11872,161,1
3795219,3929599,82,11,22,0,104,11,1
3280389,1573004,1101,2,411419,0,412520,2,1
3150561,3447685,157,2,2631,0,2788,2,1
302204,2069793,366,96,3449,0,3815,96,1
1092203,40823,174,178,1996,0,2170,178,1
4011264,331631,1360,19,116777,0,118137,19,1
3280389,1899017,1101,2,411419,0,412520,2,1
3630714,1540458,257,77,7929,0,8186,77,1
978797,2565087,599,1,12421,0,13020,1,1
495782,1562653,18,418,262,0,280,418,1
2827436,2107242,882,1,271525,0,272407,1,1
2218570,3402731,158,3654,142,18,300,3672,1
3883660,3198983,305,2,1465,0,1770,2,1
2075015,1546732,2664,165,85781,0,88445,165,1
3280389,1249145,1101,3,411419,0,412520,3,1
1063857,1744919,248,3,15849,0,16097,3,1
2849535,4360799,273,910,1462,10476,1735,11386,1
3692657,1161762,33,1,2350,0,2383,1,1
3361377,3943599,4841,2,761793,0,766634,2,1
940526,2678197,475,8,20786,0,21261,8,1
226540,3086151,463,13,10650,0,11113,13,1
595757,3963041,340,63,26738,0,27078,63,1
3509903,1845903,1530,3,509445,0,510975,3,1
284877,1478059,107,119,3215,0,3322,119,1
3361377,2968364,4841,1,761793,0,766634,1,1
2887240,2048699,1143,2,118405,0,119548,2,1
2950311,3185369,807,25,85116,0,85923,25,1
161276,657353,146,39,6548,0,6694,39,1
2490914,4580539,570,38,22965,0,23535,38,1
1927211,2433501,1668,4,113322,0,114990,4,1
276216,2621116,312,248,12600,0,12912,248,1
2777702,4376489,147,6,715,0,862,6,1
2388735,785917,403,2,4921,0,5324,2,1
530200,1813962,2035,32,62809,0,64844,32,1
2361966,4065453,149,171,1585,0,1734,171,1
1580988,4591636,2821,4,400133,0,402954,4,1
2096270,3960185,970,116,26018,0,26988,116,1
3759853,4673803,451,21,16330,0,16781,21,1
2281149,1382059,282,81,28082,0,28364,81,1
3395938,1720170,546,7,39878,0,40424,7,1
3705965,3094682,190,239,1950,0,2140,239,1
1654099,2511752,1180,72,26347,0,27527,72,1
2615366,3395717,5,32,203,0,208,32,1
1103332,4610532,732,2,59415,0,60147,2,1
2465843,3236387,160,41,1215,0,1375,41,1
974650,1412261,114,19,1990,0,2104,19,1
4560210,780870,177,10,6565,0,6742,10,1
1815739,3139287,248,91,6590,0,6838,91,1
3551797,781347,162,72,1393,269,1555,341,1
3638272,3671269,2022,1,370904,0,372926,1,1
781211,4859051,976,17,51781,0,52757,17,1
4011264,1435217,1360,131,116777,0,118137,131,1
1516853,1433745,426,11,10168,0,10594,11,1
544230,1659323,1532,49,60768,0,62300,49,1
4731849,2051858,455,18,10886,0,11341,18,1
1903752,3959720,506,164,10494,0,11000,164,1
2148937,570761,672,53,47361,0,48033,53,1
504676,3617193,921,225,2940,623,3861,848,1
2887240,1496509,1143,1,118405,0,119548,1,1
3914135,1804199,2152,86,60084,0,62236,86,1
2474070,2714010,102,34,2421,0,2523,34,1
4460816,3564556,87,10,1298,0,1385,10,1
3989108,3866187,372,1,7033,0,7405,1,1
2148937,879480,672,8,47361,0,48033,8,1
4423559,2460447,77,310,1412,0,1489,310,1
1355516,4636028,315,27,2436,0,2751,27,1
681618,2511118,75,2,8789,0,8864,2,1
196521,3918457,1176,33,11269,0,12445,33,1
3616842,2057288,317,138,3201,0,3518,138,1
4214558,3807503,41,50,171,311,212,361,1
245479,4143607,473,29,4348,0,4821,29,1
2490914,2989214,570,423,22965,0,23535,423,1
2981537,3567473,1252,1,118718,0,119970,1,1
2851109,4032663,450,9,98552,0,99002,9,1
2343253,2445542,1882,9,86401,0,88283,9,1
635909,4318891,179,7,6949,0,7128,7,1
2772256,2522313,82,17,4404,0,4486,17,1
3157597,2141320,183,1,10247,0,10430,1,1
1654099,4541993,1180,347,26347,3610,27527,3957,1
3638272,1694054,2022,1,370904,0,372926,1,1
979316,2744204,867,191,3442,0,4309,191,1
3987684,1987766,286,5,17372,0,17658,5,1
4319972,1726815,640,9,35279,0,35919,9,1
3449530,2953215,717,32,73648,0,74365,32,1
3214323,1573227,147,41,12543,0,12690,41,1
2774493,243763,551,9,12712,0,13263,9,1
1580988,1658980,2821,2,400133,0,402954,2,1
4594361,25593,103,1914,3448,502,3551,2416,1
1639434,1997042,587,56,8053,0,8640,56,1
1580988,4361662,2821,2,400133,0,402954,2,1
2307868,1433207,1131,19,38777,0,39908,19,1
2345261,3258584,92,2,1694,0,1786,2,1
3765475,2095294,873,4,107914,0,108787,4,1
3835618,973916,694,348,25433,0,26127,348,1
158492,1510942,85,9,1069,0,1154,9,1
4519026,2086394,58,5,1929,0,1987,5,1
957197,214631,614,319,37109,2590,37723,2909,1
2516076,2574456,1455,25,77782,0,79237,25,1
2381857,676766,79,420,669,0,748,420,1
4099305,761562,118,58,5174,0,5292,58,1
26287,1196738,43,111,264,181,307,292,1
1633100,1388105,163,686,8737,0,8900,686,1
1606469,4585752,96,9,5210,0,5306,9,1
4295952,2918994,808,90,57369,0,58177,90,1
3845119,3794318,461,36,28609,0,29070,36,1
3693359,2317842,25,13,133,0,158,13,1
3280389,555820,1101,4,411419,0,412520,4,1
593740,4769432,1107,77,62807,0,63914,77,1
1591435,1154186,387,6,31245,0,31632,6,1
4360960,899453,1642,31,110084,0,111726,31,1
2405789,2028563,1010,59,93387,0,94397,59,1
3965805,296476,65,112,1186,297,1251,409,1
3638272,2451583,2022,1,370904,0,372926,1,1
3873768,3621753,449,38,35424,0,35873,38,1
1234540,1190957,1071,44,75251,0,76322,44,1
1195811,3370925,89,68,1995,0,2084,68,1
4416945,2721615,417,45,33228,0,33645,45,1
4209323,3148708,1630,83,89460,0,91090,83,1
2787187,2725902,49,16,119,0,168,16,1
4519069,192016,387,1,20799,0,21186,1,1
3524438,3775729,51,3,2423,0,2474,3,1
573641,550619,253,93,5074,0,5327,93,1
4853234,890375,1256,1,29554,0,30810,1,1
2120140,3500471,453,42,6305,0,6758,42,1
2516076,783825,1455,13,77782,0,79237,13,1
2247463,106919,388,263,2747,0,3135,263,1
4313572,387952,930,47,16971,0,17901,47,1
4513872,350798,37,689,1295,0,1332,689,1
2276175,871812,262,149,4860,0,5122,149,1
2551530,1274620,145,147,2250,0,2395,147,1
1880135,3328270,810,68,71924,0,72734,68,1
4295952,3797058,808,31,57369,0,58177,31,1
1483094,2381825,146,102,3104,0,3250,102,1
892512,4020454,1505,58,11757,0,13262,58,1
889939,2438528,154,121,1864,0,2018,121,1
860473,4646269,751,2,20450,0,21201,2,1
1638032,798213,91,243,3942,0,4033,243,1
1363220,2993817,37,5,1001,0,1038,5,1
1534362,4724120,1531,10,105859,0,107390,10,1
805360,374277,1514,26,119306,0,120820,26,1
2913481,252694,58,42,1012,0,1070,42,1
670296,4816096,632,65,10586,0,11218,65,1
4040467,4674356,206,17,2565,0,2771,17,1
3836080,2085335,1197,42,59457,0,60654,42,1
372359,407236,48,5,1323,0,1371,5,1
18228,4231881,122,97,3947,0,4069,97,1
1615261,4222270,955,206,12715,0,13670,206,1
3676295,4511986,374,1,70881,0,71255,1,1
1601101,4627371,578,142,1448,59,2026,201,1
474172,2074335,471,43,38713,0,39184,43,1
474172,1969993,471,37,38713,0,39184,37,1
3632293,4086535,570,1,21294,0,21864,1,1
1356925,2177744,248,10,6996,0,7244,10,1
1973082,4085787,1036,23,18915,0,19951,23,1
1276253,4458810,407,30,46534,0,46941,30,1
3235479,700881,999,35,66486,0,67485,35,1
2040749,1218720,596,109,3834,0,4430,109,1
3280389,646175,1101,1,411419,0,412520,1,1
126622,973624,378,131,2615,3161,2993,3292,1
1370169,4671746,223,512,1452,4544,1675,5056,1
1196844,756817,548,109,36289,0,36837,109,1
3517820,1182808,50,58,1345,0,1395,58,1
2985909,2320467,706,175,43348,0,44054,175,1
3636190,2937878,119,15,4195,0,4314,15,1
2772113,3241456,792,102,42907,0,43699,102,1
1600857,64411,324,1,10576,0,10900,1,1
4629176,4289995,2058,525,9211,4959,11269,5484,1
4010118,40858,54,33,318,0,372,33,1
3881634,2784235,641,174,8471,0,9112,174,1
2763282,2562509,321,54,10936,465,11257,519,1
3438576,3210863,3424,6,137753,0,141177,6,1
1250021,2167822,4637,111,85913,0,90550,111,1
2513691,1600639,244,17,17485,0,17729,17,1
3633377,1304012,319,7,4662,0,4981,7,1
4210728,1428477,60,255,1952,15459,2012,15714,1
3668051,2192032,89,1,3044,0,3133,1,1
478985,2959987,21,32,250,0,271,32,1
843445,2565828,302,22,1763,0,2065,22,1
1618616,701808,931,186,5417,0,6348,186,1
3509903,4237686,1530,3,509445,0,510975,3,1
1539837,3293449,1127,33,62979,0,64106,33,1
1436174,2442726,105,2,9512,0,9617,2,1
6618,218783,892,49,68849,0,69741,49,1
276263,2876925,112,3,1473,0,1585,3,1
3638272,2949975,2022,2,370904,0,372926,2,1
1234540,4058530,1071,77,75251,0,76322,77,1
4705270,8869,30,184,168,0,198,184,1
1591435,710659,387,56,31245,0,31632,56,1
4301309,1218095,323,11,4103,0,4426,11,1
1428477,4039269,255,93,15459,0,15714,93,1
4135733,3514359,169,8,1941,0,2110,8,1
1723506,3460172,733,177,21835,0,22568,177,1
439557,1465199,2090,45,61744,0,63834,45,1
2147720,4054137,1608,156,78786,0,80394,156,1
1816385,2588607,272,102,2945,0,3217,102,1
462477,2699148,240,65,2418,0,2658,65,1
1769943,2418637,553,523,7901,0,8454,523,1
3361377,1833758,4841,19,761793,0,766634,19,1
940526,943819,475,4,20786,0,21261,4,1
3569179,930921,1064,5,40015,0,41079,5,1
670587,1258652,651,9,9779,0,10430,9,1
4011264,4411282,1360,6,116777,0,118137,6,1
4012459,2393226,21,6,41,0,62,6,1
1163500,871285,398,3,9540,0,9938,3,1
6618,1250021,892,4637,68849,85913,69741,90550,1
1201711,1132938,357,206,15948,1979,16305,2185,1
3361377,2765271,4841,1,761793,0,766634,1,1
408965,1566551,903,30,38623,0,39526,30,1
382977,4258149,143,34,5934,0,6077,34,1
347640,2342664,330,1181,1106,26502,1436,27683,1
3443229,1727464,152,267,1959,1073,2111,1340,1
2772113,1792195,792,65,42907,0,43699,65,1
3187565,1970848,97,98,4164,0,4261,98,1
4654860,4567102,317,110,1516,0,1833,110,1
4295952,411954,808,112,57369,0,58177,112,1
4793435,2590833,15,9,412,0,427,9,1
3361377,526398,4841,2,761793,0,766634,2,1
429643,2415676,767,163,19668,0,20435,163,1
3374092,2704991,145,12,705,0,850,12,1
573641,4763710,253,13,5074,0,5327,13,1
2405789,1362732,1010,57,93387,0,94397,57,1
2307868,1524358,1131,35,38777,0,39908,35,1
703912,438105,119,350,5153,0,5272,350,1
1250021,2231179,4637,6,85913,0,90550,6,1
2405789,3223092,1010,42,93387,0,94397,42,1
3910135,2911150,298,11,14348,0,14646,11,1
2001034,1840988,29,1,1717,0,1746,1,1
860473,4741042,751,58,20450,0,21201,58,1
2380464,48871,208,316,642,0,850,316,1
3509903,3171352,1530,3,509445,0,510975,3,1
4011264,1621606,1360,559,116777,4228,118137,4787,1
4238001,3365471,869,1,61161,0,62030,1,1
1623359,2742881,95,2,1002,0,1097,2,1
3271484,2702080,1507,3,34093,0,35600,3,1
1459082,3113814,92,17,214,0,306,17,1
1654099,3872324,1180,29,26347,0,27527,29,1
4624595,3202736,722,55,53368,0,54090,55,1
145506,2926386,10,1,1271,0,1281,1,1
3361377,537683,4841,27,761793,0,766634,27,1
3509903,2519831,1530,2,509445,0,510975,2,1
1839283,4316582,765,125,36658,0,37423,125,1
3549674,4703756,602,75,38542,0,39144,75,1
4319972,4599598,640,141,35279,0,35919,141,1
1913445,1664225,564,40,47943,0,48507,40,1
2405789,4525922,1010,28,93387,0,94397,28,1
2985909,4345033,706,17,43348,0,44054,17,1
3563938,3703295,186,130,655,0,841,130,1
765601,2928355,1485,466,101510,0,102995,466,1
4624595,162604,722,28,53368,0,54090,28,1
1243539,4557101,104,18,741,0,845,18,1
1989563,4578398,18,3,106,0,124,3,1
4067716,1016679,622,7,4349,0,4971,7,1
3438576,386718,3424,14,137753,0,141177,14,1
3194560,1015901,282,60,2856,0,3138,60,1
2148937,1206639,672,41,47361,0,48033,41,1
3590948,3222730,492,34,2943,0,3435,34,1
3824547,4071553,1075,2,14337,0,15412,2,1
4319972,4112891,640,426,35279,3572,35919,3998,1
4842916,367071,134,25,1045,0,1179,25,1
3509903,2355870,1530,1,509445,0,510975,1,1
3395938,3675352,546,185,39878,0,40424,185,1
1966548,3331519,208,1,53149,0,53357,1,1
595757,145666,340,348,26738,0,27078,348,1
474172,1635863,471,91,38713,0,39184,91,1
414608,564228,50,3,5531,0,5581,3,1
1138515,3141539,341,244,12443,0,12784,244,1
2441425,4842359,803,187,18561,0,19364,187,1
4681143,3139355,44,4,179,0,223,4,1
2498895,561233,401,2,1909,0,2310,2,1
713575,3265608,30,111,219,0,249,111,1
3638272,4083527,2022,1,370904,0,372926,1,1
439557,4553989,2090,4,61744,0,63834,4,1
3361377,735899,4841,2,761793,0,766634,2,1
1580988,2513509,2821,4,400133,0,402954,4,1
2075015,177594,2664,32,85781,0,88445,32,1
3877636,357101,393,57,2053,0,2446,57,1
3509903,1963242,1530,3,509445,0,510975,3,1
3522049,2717432,301,46,12347,0,12648,46,1
1879936,554792,281,47,6786,0,7067,47,1
4455047,4675318,83,1,1453,0,1536,1,1
1580988,283282,2821,2,400133,0,402954,2,1
3361377,1865315,4841,1,761793,0,766634,1,1
1250021,2142828,4637,55,85913,0,90550,55,1
1580988,2991832,2821,1,400133,0,402954,1,1
3127090,3622562,678,3,10017,0,10695,3,1
3361377,2196227,4841,1,761793,0,766634,1,1
3941858,1305929,202,16,5760,0,5962,16,1
3561502,2149305,1144,49,68800,0,69944,49,1
2966605,2638820,16,6,130,0,146,6,1
4701417,1856139,305,1,3855,0,4160,1,1
866357,40109,825,10,18479,0,19304,10,1
3280389,1900101,1101,5,411419,0,412520,5,1
354904,2933468,3193,72,105780,0,108973,72,1
3567246,195024,192,146,3712,0,3904,146,1
765601,425886,1485,178,101510,0,102995,178,1
4191410,2695677,1590,47,96434,0,98024,47,1
1591435,4529450,387,215,31245,0,31632,215,1
1341178,4625859,899,93,16829,0,17728,93,1
1621849,4388073,201,85,1877,0,2078,85,1
4360960,1028966,1642,44,110084,0,111726,44,1
3280389,2313956,1101,2,411419,0,412520,2,1
153871,1471685,333,1681,3892,25550,4225,27231,1
6618,412226,892,1,68849,0,69741,1,1
4267961,2905848,288,29,1440,262,1728,291,1
767491,1307649,59,92,659,0,718,92,1
4846817,4803899,76,4,5055,0,5131,4,1
2436781,135475,689,26,9972,0,10661,26,1
4642569,1762082,872,57,27586,0,28458,57,1
2405789,2304943,1010,34,93387,0,94397,34,1
2303294,336249,185,98,1515,0,1700,98,1
940526,2214919,475,1,20786,0,21261,1,1
1927211,322455,1668,83,113322,0,114990,83,1
4183784,3627447,931,80,59894,0,60825,80,1
2827436,543501,882,9,271525,0,272407,9,1
1201711,4316582,357,125,15948,0,16305,125,1
3916976,4526252,188,70,6098,0,6286,70,1
25593,1455463,1914,258,502,0,2416,258,1
2635438,3153992,92,22,184,0,276,22,1
2544987,1343428,50,32,255,0,305,32,1
1023621,3726183,103,74,1104,0,1207,74,1
3638272,4344638,2022,4,370904,0,372926,4,1
4272102,463582,1608,32,104171,0,105779,32,1
3509903,4709913,1530,1,509445,0,510975,1,1
6618,4774382,892,86,68849,0,69741,86,1
3361377,4150922,4841,2,761793,0,766634,2,1
946854,1199242,22,1,2951,0,2973,1,1
896542,1238726,45,34,874,0,919,34,1
4360442,3383234,66,44,1235,0,1301,44,1
1875,2750342,656,171,61388,0,62044,171,1
1843507,3320537,537,60,11729,0,12266,60,1
1411954,2017143,7,1,114,0,121,1,1
875909,4062197,118,6,3602,0,3720,6,1
3509903,1681939,1530,1,509445,0,510975,1,1
1539837,1742652,1127,78,62979,0,64106,78,1
1748831,4511224,352,8,1777,0,2129,8,1
2075015,3861824,2664,250,85781,0,88445,250,1
2952826,1136221,92,265,1299,0,1391,265,1
1301815,543628,752,10,48944,0,49696,10,1
3509903,3517535,1530,10,509445,0,510975,10,1
1814709,2521822,316,119,5746,0,6062,119,1
2827436,2098798,882,3,271525,0,272407,3,1
592541,3122892,132,1,6913,0,7045,1,1
2827436,4700222,882,1,271525,0,272407,1,1
787416,316764,115,2,9954,0,10069,2,1
2884705,3693741,649,57,10233,0,10882,57,1
873241,1309423,616,69,22633,0,23249,69,1
4660753,3430078,178,169,2207,0,2385,169,1
354904,4645952,3193,137,105780,0,108973,137,1
3705070,3403884,740,50,14938,0,15678,50,1
4671746,709059,512,12,4544,0,5056,12,1
2961801,3491574,1483,4,101962,0,103445,4,1
422275,4324009,101,109,4142,0,4243,109,1
3758692,1636374,711,130,34731,0,35442,130,1
111922,4465289,303,1,6879,0,7182,1,1
78836,2885661,86,46,3525,0,3611,46,1
1927211,4228546,1668,38,113322,0,114990,38,1
3119726,2405789,299,1010,11573,93387,11872,94397,1
3906136,1246149,387,80,41169,0,41556,80,1
135188,1710065,51,27,5860,0,5911,27,1
1950866,3002685,23,59,238,0,261,59,1
893544,143243,53,4,862,0,915,4,1
519175,365320,173,1,7221,0,7394,1,1
1301515,514003,230,124,2378,0,2608,124,1
3137900,1489930,357,16,6655,0,7012,16,1
1847461,2966536,1211,65,51149,0,52360,65,1
1075792,1603231,181,13,4505,0,4686,13,1
2985909,3021512,706,109,43348,0,44054,109,1
354904,4463109,3193,31,105780,0,108973,31,1
3590948,1137955,492,41,2943,0,3435,41,1
2627841,2225714,418,6,12342,0,12760,6,1
4808135,865933,21,76,329,51,350,127,1
4701737,4141758,98,3,4855,0,4953,3,1
1887669,1509457,733,70,23145,0,23878,70,1
3638272,3710810,2022,1,370904,0,372926,1,1
2290451,4858535,84,4,493,0,577,4,1
4183784,1299627,931,52,59894,0,60825,52,1
3612446,1978518,32,1,1944,0,1976,1,1
3115867,100840,1350,76,61232,0,62582,76,1
3280389,1211312,1101,1,411419,0,412520,1,1
4208653,2121048,1820,95,21104,0,22924,95,1
4751453,4727352,520,109,27570,0,28090,109,1
4165452,1657508,27,137,280,0,307,137,1
2786853,3531892,91,5,922,0,1013,5,1
1984092,4220603,68,177,1890,0,1958,177,1
4582129,1994475,1231,2,10356,0,11587,2,1
3228493,3638162,19,1,2744,0,2763,1,1
2345261,3770358,92,1,1694,0,1786,1,1
1875,3021229,656,24,61388,0,62044,24,1
4304056,1616492,164,310,12698,5893,12862,6203,1
2994391,4710137,315,21,6520,0,6835,21,1
3638272,1054134,2022,4,370904,0,372926,4,1
1494665,1210298,668,38,37638,0,38306,38,1
3561502,2257859,1144,143,68800,0,69944,143,1
2375878,95216,248,7,14925,0,15173,7,1
3361377,510107,4841,2,761793,0,766634,2,1
3150595,3623300,78,19,2207,0,2285,19,1
866357,2536806,825,55,18479,0,19304,55,1
4751453,237614,520,246,27570,0,28090,246,1
4624595,4865925,722,14,53368,0,54090,14,1
2260014,2289094,2466,57,98622,0,101088,57,1
842615,2813938,510,53,12316,0,12826,53,1
1603899,1629249,497,2,5551,0,6048,2,1
3396499,2699684,125,14,372,8,497,22,1
3361377,2387689,4841,2,761793,0,766634,2,1
1225988,2437129,157,29,8881,0,9038,29,1
595757,457614,340,254,26738,0,27078,254,1
2498087,898297,1630,3,32582,0,34212,3,1
3116723,206788,194,46,4798,0,4992,46,1
2064376,3380412,139,1,5873,0,6012,1,1
1234540,4526883,1071,2,75251,0,76322,2,1
427805,4618126,483,27,156906,0,157389,27,1
3863177,1350411,30,9,615,0,645,9,1
502082,3946047,589,31,16428,0,17017,31,1
431086,3002637,619,4,14910,0,15529,4,1
3320234,4731915,285,23,901,0,1186,23,1
2000788,317579,29,13,250,0,279,13,1
429643,2356536,767,46,19668,0,20435,46,1
3559552,3458868,145,51,2863,0,3008,51,1
3906136,3606506,387,1,41169,0,41556,1,1
3144238,3981769,326,50,28455,0,28781,50,1
3638272,4733708,2022,1,370904,0,372926,1,1
2829725,2265383,25,1,201,0,226,1,1
848275,1275854,76,19,1423,0,1499,19,1
858791,1862419,110,39,2663,0,2773,39,1
932720,606211,1411,22,111323,0,112734,22,1
2120963,2881833,136,8,1318,0,1454,8,1
4272102,2126530,1608,72,104171,0,105779,72,1
1580988,4182113,2821,7,400133,0,402954,7,1
3578463,4358478,240,42,4104,0,4344,42,1
1580988,2822817,2821,2,400133,0,402954,2,1
1062967,3637257,260,3,15276,0,15536,3,1
3768366,1041625,334,184,12403,0,12737,184,1
3115867,1831370,1350,27,61232,0,62582,27,1
3198896,3574042,157,14,1397,0,1554,14,1
1839283,3581742,765,25,36658,0,37423,25,1
2985909,2568139,706,34,43348,0,44054,34,1
4637792,1308199,430,1003,517,49,947,1052,1
4727207,27079,925,21,84581,0,85506,21,1
3361377,3245977,4841,1,761793,0,766634,1,1
1138515,623422,341,313,12443,0,12784,313,1
4360960,1770182,1642,16,110084,0,111726,16,1
408965,4855857,903,13,38623,0,39526,13,1
2981537,3411304,1252,1,118718,0,119970,1,1
1503116,4360960,415,1642,37079,110084,37494,111726,1
1494665,2733050,668,64,37638,0,38306,64,1
3764177,1330684,1036,7,64563,0,65599,7,1
3505066,4265170,131,10,3630,0,3761,10,1
1580988,1229579,2821,1,400133,0,402954,1,1
4689808,1623178,280,180,14220,0,14500,180,1
1057351,2940416,44,3,2235,0,2279,3,1
765601,4441085,1485,27,101510,0,102995,27,1
3338906,4111817,140,85,6745,0,6885,85,1
1966548,1128606,208,27,53149,0,53357,27,1
1250021,2057179,4637,50,85913,0,90550,50,1
2886626,1151850,192,48,6077,0,6269,48,1
2893334,2347011,889,26,30148,0,31037,26,1
3438576,952234,3424,46,137753,0,141177,46,1
2885394,4049138,174,8,3481,0,3655,8,1
3590948,1794702,492,251,2943,0,3435,251,1
680015,109977,485,82,9502,0,9987,82,1
3509903,348914,1530,2,509445,0,510975,2,1
3074145,4063018,205,21,5623,0,5828,21,1
439557,1551925,2090,56,61744,0,63834,56,1
938472,1072552,124,91,4326,0,4450,91,1
3918618,4696176,299,521,3785,201,4084,722,1
3694946,2067031,167,25,907,0,1074,25,1
4140279,1585066,337,1,49384,0,49721,1,1
4406088,3309807,21,10,1106,0,1127,10,1
3707352,4356256,144,39,5112,0,5256,39,1
2490914,4723036,570,216,22965,0,23535,216,1
2189017,591398,159,9,870,0,1029,9,1
1875,3594580,656,18,61388,0,62044,18,1
474172,4476589,471,21,38713,0,39184,21,1
3361377,2321049,4841,1,761793,0,766634,1,1
2827436,890875,882,34,271525,0,272407,34,1
3638272,2786863,2022,1,370904,0,372926,1,1
4440160,2335850,736,39,20522,0,21258,39,1
1792987,4651422,97,78,3867,0,3964,78,1
2687552,2679815,238,12,25574,0,25812,12,1
2464401,237951,577,38,23681,0,24258,38,1
4853234,3270007,1256,4,29554,0,30810,4,1
3304867,1521447,217,4,1983,0,2200,4,1
837553,1896674,1249,24,61665,0,62914,24,1
1015986,3625884,604,31,14201,0,14805,31,1
2147720,302894,1608,156,78786,0,80394,156,1
2096270,4390928,970,38,26018,0,26988,38,1
4417253,4736857,1130,11,68389,0,69519,11,1
3509903,3845828,1530,2,509445,0,510975,2,1
1415800,727191,67,287,301,0,368,287,1
1331570,4371496,103,105,2386,960,2489,1065,1
3488762,4601259,145,39,4916,0,5061,39,1
3896145,3742198,85,1,1108,0,1193,1,1
2884705,560724,649,158,10233,0,10882,158,1
708290,2564578,317,312,5975,0,6292,312,1
1686099,219493,53,264,281,0,334,264,1
3509903,3793948,1530,1,509445,0,510975,1,1
296476,3814694,112,9,297,0,409,9,1
2381712,4130956,82,348,1479,0,1561,348,1
842476,1043631,898,1,12479,0,13377,1,1
1644171,4548216,1071,14,3690,0,4761,14,1
2343253,33991,1882,1,86401,0,88283,1,1
4528103,4363390,268,267,14258,0,14526,267,1
4479581,1998130,601,7,19545,0,20146,7,1
3981914,3122490,93,87,360,65,453,152,1
1497278,1267076,1869,10,35111,0,36980,10,1
2985909,1939607,706,16,43348,0,44054,16,1
3863016,4209490,67,103,2808,0,2875,103,1
1250021,965880,4637,4,85913,0,90550,4,1
4565869,3855448,49,74,424,0,473,74,1
1234540,1511227,1071,60,75251,0,76322,60,1
431709,1201256,205,786,5602,0,5807,786,1
3082645,2894708,932,38,1825,0,2757,38,1
2981537,2434768,1252,2,118718,0,119970,2,1
2499805,1130005,33,287,88,103,121,390,1
4520526,3207929,33,20,1224,0,1257,20,1
4738916,4115588,1165,1,34124,0,35289,1,1
4727207,385619,925,25,84581,0,85506,25,1
4191727,2698056,463,185,26315,0,26778,185,1
1497278,3357391,1869,13,35111,0,36980,13,1
2887240,1013058,1143,1,118405,0,119548,1,1
3438576,4296197,3424,41,137753,0,141177,41,1
1652056,4683259,326,1,66845,0,67171,1,1
1927211,1616840,1668,48,113322,0,114990,48,1
1455058,4358376,129,2,3856,0,3985,2,1
2096270,3268364,970,45,26018,0,26988,45,1
3638272,2845987,2022,1,370904,0,372926,1,1
253352,2357943,237,480,10413,0,10650,480,1
2881894,1024917,211,131,7468,0,7679,131,1
1580988,2413640,2821,12,400133,0,402954,12,1
2893334,3822209,889,99,30148,0,31037,99,1
3930937,3502630,225,263,8777,0,9002,263,1
4467395,455216,2084,160,14574,0,16658,160,1
1834690,4386869,17,7,184,0,201,7,1
4485028,1955980,445,106,14565,0,15010,106,1
3280389,2100142,1101,1,411419,0,412520,1,1
1727464,1242964,267,767,1073,1168,1340,1935,1
2388735,2454978,403,57,4921,175,5324,232,1
3509903,3384950,1530,1,509445,0,510975,1,1
2446968,4062175,452,248,20110,8522,20562,8770,1
259575,3267644,260,218,13949,0,14209,218,1
2785529,506424,57,83,728,0,785,83,1
4171214,507838,358,4,4601,0,4959,4,1
1913445,2537610,564,54,47943,0,48507,54,1
1634335,4286907,144,369,849,0,993,369,1
2827436,1485578,882,1,271525,0,272407,1,1
3361377,4215572,4841,3,761793,0,766634,3,1
2793437,808668,582,35,25447,0,26029,35,1
1534362,462811,1531,13,105859,0,107390,13,1
3280389,4247968,1101,1,411419,0,412520,1,1
1462439,2017177,777,17,5849,0,6626,17,1
1534362,2958013,1531,36,105859,0,107390,36,1
2985909,3039537,706,76,43348,0,44054,76,1
1234540,3746690,1071,165,75251,0,76322,165,1
3092943,2998317,352,279,2435,456,2787,735,1
3201381,2627474,250,6,661,0,911,6,1
2075015,4196387,2664,82,85781,0,88445,82,1
1103332,2787817,732,176,59415,0,60147,176,1
379565,697947,46,18,2516,0,2562,18,1
378943,3446820,340,146,12563,0,12903,146,1
3866209,633574,449,265,2902,0,3351,265,1
2881425,1815099,102,73,5272,0,5374,73,1
471706,1639769,794,7,65616,0,66410,7,1
1866521,3510647,13,10,167,0,180,10,1
1606469,1107839,96,2,5210,0,5306,2,1
2023009,1031761,15,735,96,866,111,1601,1
3361377,1699937,4841,7,761793,0,766634,7,1
1919631,3220141,185,259,2750,3705,2935,3964,1
2787998,1250021,160,4637,85,85913,245,90550,1
3063001,1481592,40,22,1110,0,1150,22,1
4751453,3474722,520,53,27570,0,28090,53,1
3509903,2951879,1530,3,509445,0,510975,3,1
2827436,4587225,882,2,271525,0,272407,2,1
2758517,1739607,48,177,1829,0,1877,177,1
2339149,4686125,97,45,4258,0,4355,45,1
2035351,2914649,32,1,795,0,827,1,1
1478080,3174437,593,4,7009,0,7602,4,1
1234540,1877065,1071,77,75251,0,76322,77,1
2263130,2944368,712,131,14043,0,14755,131,1
3638272,4094336,2022,2,370904,0,372926,2,1
2887240,1130447,1143,3,118405,0,119548,3,1
1140134,2764870,311,7,11111,0,11422,7,1
3395938,327716,546,162,39878,0,40424,162,1
4798192,515143,816,108,20426,0,21242,108,1
3033166,3235641,312,2,4444,0,4756,2,1
1580988,1087564,2821,3,400133,0,402954,3,1
201249,2929883,323,65,621,0,944,65,1
4192206,1573370,468,125,18229,0,18697,125,1
2981537,2274948,1252,1,118718,0,119970,1,1
669455,2322481,52,61,1362,0,1414,61,1
3795221,1999372,332,66,5749,0,6081,66,1
813554,1701914,252,6,17214,0,17466,6,1
1819836,581535,269,1283,1652,8414,1921,9697,1
1471685,3881981,1681,375,25550,0,27231,375,1
3280389,624273,1101,5,411419,0,412520,5,1
276216,2351660,312,256,12600,0,12912,256,1
2693173,1398178,18,29,251,0,269,29,1
2553405,4582663,568,6,12913,0,13481,6,1
2793437,1039444,582,77,25447,0,26029,77,1
3836080,1660755,1197,51,59457,0,60654,51,1
4249273,1329780,225,783,3063,0,3288,783,1
2033773,445667,58,20,596,0,654,20,1
1471685,3452283,1681,77,25550,0,27231,77,1
3638272,3207202,2022,5,370904,0,372926,5,1
2517463,3881093,54,11,1105,0,1159,11,1
3842148,3434502,719,15,11430,0,12149,15,1
2158773,809475,158,77,431,0,589,77,1
4013601,2421885,653,1,14886,0,15539,1,1
1653268,498320,183,12,5919,0,6102,12,1
1913445,1055530,564,415,47943,14969,48507,15384,1
1580988,2670672,2821,2,400133,0,402954,2,1
4035124,67307,77,2,1496,0,1573,2,1
4411870,3213304,948,24,60517,0,61465,24,1
3271484,4561584,1507,85,34093,0,35600,85,1
2016133,3548594,14,63,328,0,342,63,1
4209323,3779328,1630,46,89460,730,91090,776,1
2704156,286378,56,26,368,312,424,338,1
765601,2767757,1485,18,101510,0,102995,18,1
3561502,2896389,1144,42,68800,0,69944,42,1
3361377,2089941,4841,1,761793,0,766634,1,1
354904,2530177,3193,4,105780,0,108973,4,1
2377014,439557,229,2090,1174,61744,1403,63834,1
2260014,1121547,2466,13,98622,0,101088,13,1
530200,568062,2035,194,62809,0,64844,194,1
1283690,2865400,102,62,1462,0,1564,62,1
2107861,716481,535,7,25743,0,26278,7,1
3683235,753242,311,27,23110,0,23421,27,1
2823179,2689043,505,37,6744,0,7249,37,1
4207089,4373149,53,13,1312,0,1365,13,1
196521,3410268,1176,39,11269,0,12445,39,1
4011264,624937,1360,47,116777,0,118137,47,1
2691855,4140036,32,1,295,0,327,1,1
3196588,2385744,212,224,669,268,881,492,1
3361377,1375021,4841,25,761793,0,766634,25,1
3361377,4397740,4841,1,761793,0,766634,1,1
1591435,238772,387,354,31245,0,31632,354,1
1534362,3882529,1531,23,105859,0,107390,23,1
307250,3395334,919,34,35588,0,36507,34,1
4727207,3819922,925,4,84581,0,85506,4,1
515290,3875755,285,29,34080,0,34365,29,1
401947,3790344,367,56,7890,0,8257,56,1
3509903,3555401,1530,2,509445,0,510975,2,1
4629176,3708370,2058,7,9211,0,11269,7,1
3739473,4548845,448,108,13226,0,13674,108,1
4070413,4863816,175,213,363,649,538,862,1
1225988,1979755,157,42,8881,0,9038,42,1
3361377,1496395,4841,7,761793,0,766634,7,1
3361377,4597089,4841,5,761793,0,766634,5,1
1333354,637380,226,4,1059,0,1285,4,1
3509903,1309138,1530,1,509445,0,510975,1,1
4423184,3221425,384,60,29809,0,30193,60,1
2827436,3810269,882,1,271525,0,272407,1,1
687713,238064,436,20,47160,0,47596,20,1
553041,460979,455,35,5962,0,6417,35,1
3675474,4198061,46,46,1953,0,1999,46,1
483251,713711,154,4,5257,0,5411,4,1
4541993,3420607,347,2,3610,0,3957,2,1
3361377,792892,4841,1,761793,0,766634,1,1
1575009,1902996,429,38,37745,0,38174,38,1
4727207,2179540,925,21,84581,0,85506,21,1
1966548,983718,208,3,53149,0,53357,3,1
991610,4042460,281,18,1539,0,1820,18,1
3361377,3332802,4841,1,761793,0,766634,1,1
2985909,2277009,706,38,43348,0,44054,38,1
4255453,2682115,327,362,3125,0,3452,362,1
3137585,2924709,1196,91,77354,0,78550,91,1
3676295,2533320,374,1,70881,0,71255,1,1
4371411,241195,189,73,648,0,837,73,1
2102496,3398526,64,66,1022,0,1086,66,1
3028424,2338543,83,5,330,0,413,5,1
2887240,2724100,1143,2,118405,0,119548,2,1
3509903,4581009,1530,1,509445,0,510975,1,1
1580988,4217665,2821,1,400133,0,402954,1,1
621115,4515018,66,47,6250,0,6316,47,1
2822651,1217528,25,3,3794,0,3819,3,1
4479581,3261539,601,109,19545,0,20146,109,1
1178793,259089,146,59,1343,0,1489,59,1
2985909,2669342,706,60,43348,0,44054,60,1
1486758,2108539,337,34,11346,0,11683,34,1
1927211,79302,1668,107,113322,0,114990,107,1
3509903,1085173,1530,2,509445,0,510975,2,1
765601,219120,1485,1,101510,0,102995,1,1
2553405,3180495,568,7,12913,0,13481,7,1
3718020,4758188,305,7,6132,0,6437,7,1
2887240,2328675,1143,1,118405,0,119548,1,1
4238001,2627465,869,1,61161,0,62030,1,1
2897926,4016783,565,10,25983,0,26548,10,1
605874,757037,145,7,3312,0,3457,7,1
3509214,4789932,263,1,14139,0,14402,1,1
3758692,1384503,711,143,34731,0,35442,143,1
4864079,2951816,78,211,218,287,296,498,1
2343253,2055395,1882,1,86401,0,88283,1,1
1068490,2941880,201,599,1742,264,1943,863,1
1474822,3484858,229,57,3952,0,4181,57,1
605874,4202634,145,12,3312,737,3457,749,1
1031334,3538688,459,55,16840,0,17299,55,1
3836080,1897010,1197,78,59457,0,60654,78,1
1913445,4532884,564,28,47943,0,48507,28,1
1828733,4206786,135,3,947,0,1082,3,1
1886780,2803072,183,14,2578,0,2761,14,1
4751453,1580774,520,407,27570,0,28090,407,1
4745146,775935,69,9,1826,0,1895,9,1
2557982,3770707,145,3,1760,0,1905,3,1
219155,1366835,149,33,3947,0,4096,33,1
3692657,2045977,33,7,2350,0,2383,7,1
2102496,1481839,64,32,1022,0,1086,32,1
4191410,306272,1590,98,96434,0,98024,98,1
2897926,3948255,565,41,25983,0,26548,41,1
2075015,2067728,2664,88,85781,0,88445,88,1
3449530,160433,717,16,73648,0,74365,16,1
4733353,4168432,244,52,1693,934,1937,986,1
3914135,3652803,2152,3,60084,0,62236,3,1
868049,2572232,35,3,2387,0,2422,3,1
4519298,4455484,577,6,14443,0,15020,6,1
917130,2308465,325,1,7017,0,7342,1,1
1533546,3542457,703,105,22095,252,22798,357,1
1615261,273363,955,768,12715,11045,13670,11813,1
2293122,3348334,57,1,623,0,680,1,1
2667980,2672764,80,116,1609,12,1689,128,1
3954325,3626258,1743,1,16616,0,18359,1,1
3361377,3842002,4841,2,761793,0,766634,2,1
3449530,3450913,717,3,73648,0,74365,3,1
2627841,4772237,418,27,12342,0,12760,27,1
3238429,4221773,21,7,223,0,244,7,1
1436216,1707116,1068,4,68770,0,69838,4,1
3206499,3289390,1337,4,32033,0,33370,4,1
1961226,2885536,33,4,2215,0,2248,4,1
1119016,1265706,252,179,1457,38,1709,217,1
532681,1109702,433,52,35023,0,35456,52,1
3509903,2880010,1530,1,509445,0,510975,1,1
2853969,3128709,1051,3,42591,0,43642,3,1
1616492,4452472,310,49,5893,0,6203,49,1
3509903,898748,1530,1,509445,0,510975,1,1
3638272,1362351,2022,1,370904,0,372926,1,1
2021745,2299452,72,105,2948,0,3020,105,1
1580988,2144638,2821,1,400133,0,402954,1,1
2295788,3357641,289,213,2710,0,2999,213,1
4004339,3575558,153,265,6086,0,6239,265,1
2446968,965601,452,34,20110,0,20562,34,1
3676295,3815921,374,1,70881,0,71255,1,1
4247921,4591023,158,42,795,0,953,42,1
282129,699226,146,35,2112,0,2258,35,1
2961801,3690329,1483,29,101962,0,103445,29,1
3237295,4238451,57,1643,119,54,176,1697,1
582276,4150846,298,155,10990,0,11288,155,1
1301815,2884652,752,51,48944,0,49696,51,1
2827436,2933862,882,1,271525,0,272407,1,1
4611279,2002261,40,119,294,135,334,254,1
1655138,613338,120,1805,354,0,474,1805,1
3294702,3259114,991,121,68888,0,69879,121,1
1234540,701587,1071,15,75251,0,76322,15,1
1831198,2657284,450,2605,5884,690,6334,3295,1
842615,4026241,510,83,12316,0,12826,83,1
818302,3446672,54,81,490,0,544,81,1
3873768,4761670,449,232,35424,0,35873,232,1
3065808,1051634,1235,49,82317,0,83552,49,1
2613814,2179948,242,398,1818,0,2060,398,1
2358307,3575803,46,121,1392,0,1438,121,1
1062967,1493387,260,23,15276,0,15536,23,1
1927211,2008306,1668,14,113322,0,114990,14,1
2150686,2846957,69,68,983,0,1052,68,1
1467764,3687762,93,627,381,3168,474,3795,1
4746749,3777807,283,137,3968,0,4251,137,1
805360,2823712,1514,113,119306,0,120820,113,1
4191410,3345878,1590,18,96434,0,98024,18,1
1466231,4140436,408,57,3853,0,4261,57,1
3280389,928592,1101,1,411419,0,412520,1,1
2120733,2384889,819,71,20803,0,21622,71,1
3967814,2616950,31,6,2091,0,2122,6,1
1550824,3874407,165,503,3841,62,4006,565,1
1889641,3581701,33,3,1381,0,1414,3,1
2539975,2979886,40,15,224,0,264,15,1
2374539,988613,92,52,3805,0,3897,52,1
1293807,135277,1837,27,30865,0,32702,27,1
3638272,4514850,2022,1,370904,0,372926,1,1
1652056,959921,326,1,66845,0,67171,1,1
4069688,4215177,197,5,2726,0,2923,5,1
4624595,1234914,722,102,53368,0,54090,102,1
3914135,4201862,2152,1,60084,0,62236,1,1
2033650,93300,177,37,533,0,710,37,1
4838376,4813613,606,51,26838,0,27444,51,1
748019,1768604,675,60,18480,0,19155,60,1
4140279,2846901,337,2,49384,0,49721,2,1
860473,4691822,751,68,20450,0,21201,68,1
2981537,1011572,1252,5,118718,0,119970,5,1
4423184,110882,384,68,29809,0,30193,68,1
3873768,4307879,449,28,35424,0,35873,28,1
2851109,3305756,450,3,98552,0,99002,3,1
878715,946775,100,110,1976,1072,2076,1182,1
245479,2939073,473,4,4348,0,4821,4,1
1923830,1894250,181,62,2733,0,2914,62,1
4534401,2452634,103,129,4125,0,4228,129,1
4638702,3796735,37,36,1225,0,1262,36,1
1580988,2347913,2821,1,400133,0,402954,1,1
2405789,1082270,1010,44,93387,0,94397,44,1
3645759,1241907,17,176,144,1602,161,1778,1
1985223,607729,92,26,201,0,293,26,1
607449,51619,380,18,19369,0,19749,18,1
907654,2303435,798,79,24575,0,25373,79,1
427805,4866562,483,4,156906,0,157389,4,1
3280389,1886143,1101,6,411419,0,412520,6,1
708290,2354079,317,28,5975,0,6292,28,1
4062175,4380415,248,81,8522,0,8770,81,1
4710107,2148937,65,672,748,47361,813,48033,1
1446824,4591933,569,115,4958,0,5527,115,1
3361377,1714016,4841,1,761793,0,766634,1,1
245479,1482337,473,1,4348,0,4821,1,1
808127,10949,273,100,4215,0,4488,100,1
2197837,2432129,97,116,1984,129,2081,245,1
1777808,3478126,211,4,3413,0,3624,4,1
1878000,2464580,6,29,201,0,207,29,1
3721550,3617146,188,11,14527,0,14715,11,1
4187061,500188,86,92,111,343,197,435,1
3873768,350674,449,52,35424,0,35873,52,1
3802719,4016791,91,223,3170,0,3261,223,1
3914135,4219126,2152,60,60084,1362,62236,1422,1
3509903,2276816,1530,1,509445,0,510975,1,1
4866251,2621958,19,16,815,0,834,16,1
3275484,857744,77,116,1462,0,1539,116,1
3280389,1229739,1101,1,411419,0,412520,1,1
3630714,946018,257,6,7929,0,8186,6,1
3438576,1481161,3424,1,137753,0,141177,1,1
2516076,2351859,1455,42,77782,0,79237,42,1
1022123,3037355,126,59,8212,0,8338,59,1
1654099,947436,1180,76,26347,0,27527,76,1
2405789,2022244,1010,86,93387,0,94397,86,1
4362385,3706457,17,14,364,0,381,14,1
671026,3403968,421,80,8079,82,8500,162,1
2887240,147967,1143,4,118405,0,119548,4,1
1847461,3293128,1211,1,51149,0,52360,1,1
2851109,1456202,450,4,98552,0,99002,4,1
550387,3438434,185,9,2453,0,2638,9,1
3667893,913152,471,169,2170,450,2641,619,1
1887709,859383,217,9,28983,0,29200,9,1
1803007,323035,90,21,1999,0,2089,21,1
55855,1146781,245,5,5888,0,6133,5,1
3509903,3572114,1530,2,509445,0,510975,2,1
1580988,763585,2821,1,400133,0,402954,1,1
3638272,1993850,2022,2,370904,0,372926,2,1
1165223,2196316,42,58,94,87,136,145,1
3907996,258498,485,66,18964,0,19449,66,1
2745294,2654853,64,222,799,0,863,222,1
3569179,2739990,1064,41,40015,0,41079,41,1
4272102,2151872,1608,28,104171,0,105779,28,1
4472471,2066742,11,17,99,375,110,392,1
3509903,4282407,1530,1,509445,0,510975,1,1
3914135,666227,2152,20,60084,0,62236,20,1
4314111,697429,110,82,1951,0,2061,82,1
1243368,621675,319,148,5045,0,5364,148,1
1580988,4635172,2821,71,400133,0,402954,71,1
3509903,315110,1530,109,509445,0,510975,109,1
4210728,1988629,60,72,1952,0,2012,72,1
4011264,635572,1360,43,116777,0,118137,43,1
307250,1788270,919,9,35588,0,36507,9,1
1436216,2530711,1068,234,68770,0,69838,234,1
2827436,201526,882,2,271525,0,272407,2,1
2260014,2440642,2466,13,98622,0,101088,13,1
2380608,4024938,360,22,3399,0,3759,22,1
2961801,2943265,1483,36,101962,0,103445,36,1
4653941,2652980,951,41,45883,0,46834,41,1
4191727,4318649,463,102,26315,0,26778,102,1
1503116,1480741,415,201,37079,0,37494,201,1
1652056,1159329,326,14,66845,0,67171,14,1
4624595,4049215,722,43,53368,0,54090,43,1
4011264,994091,1360,377,116777,0,118137,377,1
4350742,1983399,36,510,338,2027,374,2537,1
3569179,2638768,1064,329,40015,0,41079,329,1
2148937,250277,672,4,47361,0,48033,4,1
3438576,2132029,3424,35,137753,0,141177,35,1
340160,3613968,41,17,2700,0,2741,17,1
525299,676939,337,51,4714,0,5051,51,1
4738916,299157,1165,39,34124,0,35289,39,1
57574,2370707,289,62,4616,0,4905,62,1
3361377,1787644,4841,3,761793,0,766634,3,1
3773737,3213641,108,124,2435,0,2543,124,1
1250021,3163995,4637,29,85913,0,90550,29,1
1629701,4096302,58,351,157,547,215,898,1
3316576,3763307,669,6,7971,0,8640,6,1
3405059,202377,261,31,9604,0,9865,31,1
1321472,3351793,68,17,1770,0,1838,17,1
1068490,3127013,201,6,1742,0,1943,6,1
3906136,3864177,387,1,41169,0,41556,1,1
3651179,2574190,1752,16,2979,0,4731,16,1
2446968,1825732,452,34,20110,0,20562,34,1
837553,1556400,1249,16,61665,0,62914,16,1
2960322,656166,193,175,2647,0,2840,175,1
4301252,3860469,118,25,2905,0,3023,25,1
4209323,3840735,1630,39,89460,0,91090,39,1
3720283,2793440,50,1,257,0,307,1,1
3167388,4716411,203,70,9760,0,9963,70,1
2147720,4848455,1608,53,78786,0,80394,53,1
3235479,4329728,999,49,66486,0,67485,49,1
905894,4115592,268,119,1162,0,1430,119,1
1293807,4265109,1837,19,30865,0,32702,19,1
2514761,1487277,198,168,2369,0,2567,168,1
1580988,4447527,2821,3,400133,0,402954,3,1
4236325,3922225,372,17,6103,0,6475,17,1
2516076,3802850,1455,108,77782,0,79237,108,1
3449530,4717982,717,13,73648,0,74365,13,1
1927211,2787817,1668,176,113322,0,114990,176,1
3638272,3483211,2022,1,370904,0,372926,1,1
940526,1633167,475,78,20786,0,21261,78,1
1431076,2182964,167,214,1978,6975,2145,7189,1
1234540,466692,1071,23,75251,0,76322,23,1
595757,1730280,340,111,26738,0,27078,111,1
408965,2953250,903,37,38623,0,39526,37,1
1234540,2014644,1071,82,75251,0,76322,82,1
4217831,2497198,40,151,1212,0,1252,151,1
474172,4166892,471,36,38713,0,39184,36,1
3112136,432874,406,276,41366,0,41772,276,1
3019092,1378607,108,1,8595,0,8703,1,1
3021112,1933764,472,246,6183,0,6655,246,1
2441425,510180,803,37,18561,0,19364,37,1
733639,2284932,259,88,3744,0,4003,88,1
3361377,219940,4841,2,761793,0,766634,2,1
4460507,2254847,70,87,772,0,842,87,1
1620797,4546788,14,6,801,0,815,6,1
4018742,1013330,115,1,3140,0,3255,1,1
2405789,4753645,1010,176,93387,0,94397,176,1
1611386,652860,187,78,10932,0,11119,78,1
1195007,2576341,17,359,158,690,175,1049,1
3139176,4314252,42,47,143,138,185,185,1
3509903,1875597,1530,3,509445,0,510975,3,1
2961552,550908,562,297,16546,0,17108,297,1
2851109,1614934,450,4,98552,0,99002,4,1
720204,4303193,240,8,322,0,562,8,1
652714,3612767,64,4,1815,0,1879,4,1
2516076,1404904,1455,43,77782,0,79237,43,1
2147720,2307654,1608,64,78786,0,80394,64,1
4751453,3637952,520,234,27570,0,28090,234,1
868049,222893,35,17,2387,0,2422,17,1
3280389,2118662,1101,1,411419,0,412520,1,1
4503106,204288,19,31,509,0,528,31,1
3361377,1230664,4841,11,761793,0,766634,11,1
2897926,3557408,565,30,25983,0,26548,30,1
4417253,10900,1130,38,68389,0,69519,38,1
1580988,1143066,2821,4,400133,0,402954,4,1
4304056,4110791,164,88,12698,0,12862,88,1
2075015,2716692,2664,3,85781,0,88445,3,1
3863016,1333103,67,12,2808,0,2875,12,1
2576364,4292879,108,687,1654,0,1762,687,1
2536472,3607783,344,2,9725,0,10069,2,1
3914135,3853689,2152,28,60084,0,62236,28,1
4238001,945538,869,243,61161,0,62030,243,1
4539039,3917118,35,1,5584,0,5619,1,1
97028,69338,619,25,8923,0,9542,25,1
1591435,2606445,387,48,31245,0,31632,48,1
1807330,1995344,62,161,1136,0,1198,161,1
2772113,3021521,792,44,42907,0,43699,44,1
3396719,537857,660,399,8141,0,8801,399,1
2637259,410846,151,17,3592,0,3743,17,1
3361377,4331519,4841,1,761793,0,766634,1,1
2851109,2558256,450,4,98552,0,99002,4,1
1092203,3347039,174,196,1996,0,2170,196,1
4838376,4678225,606,29,26838,0,27444,29,1
3280389,2694462,1101,2,411419,0,412520,2,1
2498087,2579149,1630,87,32582,610,34212,697,1
51185,730545,350,44,1600,0,1950,44,1
1446824,2527518,569,38,4958,0,5527,38,1
4853234,2687639,1256,97,29554,0,30810,97,1
4411870,281882,948,66,60517,0,61465,66,1
3137900,2460779,357,284,6655,0,7012,284,1
2260014,2588189,2466,5,98622,0,101088,5,1
3509903,704617,1530,2,509445,0,510975,2,1
2887240,3247135,1143,2,118405,0,119548,2,1
2261139,3456663,2014,13,42851,0,44865,13,1
2853969,3669551,1051,1,42591,0,43642,1,1
4035838,2125883,304,1,2624,0,2928,1,1
1539837,2805825,1127,69,62979,0,64106,69,1
3412172,4741870,227,29,2700,0,2927,29,1
3316576,3786947,669,1,7971,0,8640,1,1
3561502,2231960,1144,40,68800,0,69944,40,1
2261139,4685246,2014,64,42851,0,44865,64,1
2790006,3080775,367,60,14747,0,15114,60,1
182123,4849508,17,256,218,0,235,256,1
3102873,4659056,341,1,15098,0,15439,1,1
1185954,408965,125,903,1646,38623,1771,39526,1
4327932,4680670,128,13,1082,0,1210,13,1
2564052,3771469,102,27,1292,0,1394,27,1
3361377,2136554,4841,1,761793,0,766634,1,1
3549674,1440550,602,82,38542,0,39144,82,1
2565218,177113,285,158,1750,0,2035,158,1
528463,36074,40,66,784,2609,824,2675,1
4330391,1678808,773,85,32759,0,33532,85,1
4115120,4401915,33,633,828,0,861,633,1
1539837,4257648,1127,68,62979,0,64106,68,1
2502456,3865285,719,2,50725,0,51444,2,1
4548429,2404411,2,1841,12,15,14,1856,1
2111855,3766535,40,131,290,97,330,228,1
2307868,2812873,1131,90,38777,0,39908,90,1
3509903,4714297,1530,1,509445,0,510975,1,1
2147720,1958581,1608,8,78786,0,80394,8,1
3876737,2729684,2951,63,1921,0,4872,63,1
3361377,4094734,4841,72,761793,0,766634,72,1
1460308,3694018,35,2,1951,0,1986,2,1
917130,2280452,325,59,7017,0,7342,59,1
4411870,3936433,948,82,60517,0,61465,82,1
4547438,2775377,1291,360,25237,0,26528,360,1
4202576,1899892,600,284,10697,0,11297,284,1
1580988,3184458,2821,31,400133,0,402954,31,1
3013547,3279270,29,72,133,326,162,398,1
3013547,4097734,29,389,133,92,162,481,1
462298,2613695,414,43,10933,0,11347,43,1
4249983,2005821,679,115,16076,0,16755,115,1
2115198,325060,82,173,326,922,408,1095,1
4798192,157609,816,370,20426,0,21242,370,1
2188394,3253683,166,5,2340,0,2506,5,1
2182964,504523,214,1,6975,0,7189,1,1
1489175,3898645,238,24,883,0,1121,24,1
3509903,4349268,1530,2,509445,0,510975,2,1
2343253,204666,1882,1,86401,0,88283,1,1
4203093,3561806,100,79,1954,0,2054,79,1
3115867,1950392,1350,38,61232,0,62582,38,1
2388735,4524162,403,11,4921,0,5324,11,1
1611386,737230,187,110,10932,0,11119,110,1
502082,2530677,589,231,16428,0,17017,231,1
996752,2633830,173,8,3538,0,3711,8,1
3561502,156049,1144,47,68800,0,69944,47,1
3509903,1976317,1530,1,509445,0,510975,1,1
2343253,4454231,1882,20,86401,0,88283,20,1
593740,3936387,1107,70,62807,0,63914,70,1
3419989,2114768,350,23,16316,0,16666,23,1
4304056,2735112,164,165,12698,0,12862,165,1
3361377,3225067,4841,3,761793,0,766634,3,1
2980119,3401604,154,77,2068,0,2222,77,1
550387,1994335,185,235,2453,0,2638,235,1
1580988,4638450,2821,2,400133,0,402954,2,1
3154825,1499157,44,39,694,0,738,39,1
4183784,4492363,931,12,59894,0,60825,12,1
1321472,2137971,68,6,1770,0,1838,6,1
3280389,3974599,1101,1,411419,0,412520,1,1
2375269,1517282,384,89,2509,0,2893,89,1
1787075,1274523,894,24,28305,0,29199,24,1
2911269,426964,740,58,20606,0,21346,58,1
198589,3093066,37,566,184,68,221,634,1
2052930,91401,407,6,8479,0,8886,6,1
3214323,2776773,147,22,12543,0,12690,22,1
3836080,1625681,1197,1,59457,0,60654,1,1
3569179,4256128,1064,2,40015,0,41079,2,1
2950311,3577266,807,33,85116,0,85923,33,1
2911253,3073164,721,30,1925,0,2646,30,1
805360,4552735,1514,346,119306,0,120820,346,1
6618,2199555,892,15,68849,0,69741,15,1
1822719,3308819,285,16,22351,0,22636,16,1
4230144,3139611,216,20,4435,0,4651,20,1
3375887,2084978,119,27,2874,0,2993,27,1
3438576,1431078,3424,4,137753,0,141177,4,1
1591435,2160078,387,239,31245,0,31632,239,1
250177,351959,330,8,3969,0,4299,8,1
743837,4211375,613,54,2344,0,2957,54,1
4272102,3443740,1608,5,104171,0,105779,5,1
3987684,4393064,286,1200,17372,0,17658,1200,1
3361377,4506105,4841,2,761793,0,766634,2,1
2854737,2965723,751,64,637,641,1388,705,1
1216656,897409,244,7,798,0,1042,7,1
3361377,3986442,4841,1,761793,0,766634,1,1
3425860,493727,14,30,60,0,74,30,1
2462210,119885,96,23,1606,0,1702,23,1
3827240,5300,356,128,7496,0,7852,128,1
4417253,2275912,1130,31,68389,0,69519,31,1
408965,36979,903,28,38623,0,39526,28,1
2343253,479920,1882,49,86401,0,88283,49,1
1817799,2975872,402,87,15932,0,16334,87,1
3179391,2197170,3,3,167,0,170,3,1
2827436,1975036,882,2,271525,0,272407,2,1
141067,2506316,432,43,2002,0,2434,43,1
3509903,1063297,1530,2,509445,0,510975,2,1
1550672,2241338,18,5,2328,0,2346,5,1
2307868,685540,1131,2,38777,0,39908,2,1
3676295,1845014,374,1,70881,0,71255,1,1
3361377,3149511,4841,1,761793,0,766634,1,1
4621952,3297148,922,24,5245,200,6167,224,1
3509214,2894480,263,1,14139,0,14402,1,1
611927,1631242,305,428,8695,0,9000,428,1
757158,3650967,85,3,929,0,1014,3,1
3936039,4468122,799,73,23884,0,24683,73,1
4417253,2245884,1130,18,68389,0,69519,18,1
2745133,661838,85,59,2347,0,2432,59,1
2827436,2613575,882,1,271525,0,272407,1,1
3671141,1235830,1444,2,48400,0,49844,2,1
1847461,3315912,1211,66,51149,0,52360,66,1
1609659,4843435,523,65,29763,0,30286,65,1
3137585,3497138,1196,10,77354,0,78550,10,1
1875,78537,656,118,61388,0,62044,118,1
3638272,341021,2022,28,370904,0,372926,28,1
2404691,4088731,46,1418,494,1242,540,2660,1
4220190,4258621,320,1,15994,0,16314,1,1
1344759,1532243,276,62,2679,0,2955,62,1
1822719,2923162,285,4,22351,0,22636,4,1
64321,4064620,263,11,959,0,1222,11,1
3661174,839796,42,69,499,0,541,69,1
3280389,2799526,1101,1,411419,0,412520,1,1
860409,1511937,38,52,2413,0,2451,52,1
3630714,4414176,257,9,7929,0,8186,9,1
1202593,902181,93,31,5131,0,5224,31,1
1293807,1051426,1837,15,30865,0,32702,15,1
2981537,1931883,1252,14,118718,0,119970,14,1
1477543,4626039,84,111,1627,0,1711,111,1
4050480,4694819,422,101,4311,0,4733,101,1
3642631,2148649,47,139,427,0,474,139,1
195955,1580988,52,2821,374,400133,426,402954,1
748911,4137854,435,148,687,412,1122,560,1
448517,589428,625,151,12450,0,13075,151,1
1579383,4453050,3,3,24,0,27,3,1
1827983,3859910,172,65,429,0,601,65,1
1436174,3839949,105,1,9512,0,9617,1,1
3060508,249599,171,4,509,0,680,4,1
1503116,3906136,415,387,37079,41169,37494,41556,1
4385783,3214778,290,6,10995,0,11285,6,1
4249983,4319460,679,39,16076,0,16755,39,1
1914712,2942817,60,50,115,0,175,50,1
4796329,3145378,43,9,538,0,581,9,1
932720,3643672,1411,4,111323,0,112734,4,1
1790294,4044839,54,20,1246,0,1300,20,1
1202593,395329,93,1,5131,0,5224,1,1
1879936,3721177,281,8,6786,0,7067,8,1
2827436,3085306,882,4,271525,0,272407,4,1
2120733,204574,819,178,20803,0,21622,178,1
3157597,4410290,183,21,10247,0,10430,21,1
2887240,1525958,1143,4,118405,0,119548,4,1
2083920,3025582,65,11,678,0,743,11,1
2075015,4197883,2664,3,85781,0,88445,3,1
1580988,9909,2821,4,400133,0,402954,4,1
439557,2545899,2090,9,61744,0,63834,9,1
2887240,726707,1143,2,118405,0,119548,2,1
4360960,178889,1642,4,110084,0,111726,4,1
2827436,1283062,882,2,271525,0,272407,2,1
3271484,4061236,1507,1,34093,0,35600,1,1
269982,2672589,351,189,9019,0,9370,189,1
1580988,4816789,2821,1,400133,0,402954,1,1
4125838,1038301,344,54,1602,426,1946,480,1
4838376,3432588,606,11,26838,0,27444,11,1
2996107,50479,99,129,141,162,240,291,1
429643,4341997,767,62,19668,0,20435,62,1
3569179,2564955,1064,108,40015,1325,41079,1433,1
4179343,3750484,119,34,9822,0,9941,34,1
1535773,991610,86,281,135,1539,221,1820,1
3361377,2802720,4841,2,761793,0,766634,2,1
3802719,616238,91,118,3170,0,3261,118,1
493062,2294331,34,78,2722,0,2756,78,1
3361377,3494465,4841,2,761793,0,766634,2,1
366262,118171,85,238,268,0,353,238,1
2405789,2147075,1010,18,93387,0,94397,18,1
3742930,2337048,410,44,22242,0,22652,44,1
3683235,3265721,311,15,23110,0,23421,15,1
2516076,3755492,1455,20,77782,0,79237,20,1
4727207,2391213,925,1,84581,0,85506,1,1
4555638,4491490,181,2,397,0,578,2,1
1633022,2818424,246,1,23530,0,23776,1,1
4011264,4270898,1360,82,116777,0,118137,82,1
3361377,2173755,4841,1,761793,0,766634,1,1
860473,1592521,751,4,20450,0,21201,4,1
4653941,3370267,951,2,45883,0,46834,2,1
1234540,4555973,1071,43,75251,0,76322,43,1
2281580,1883375,309,29,1051,0,1360,29,1
1436216,510289,1068,15,68770,0,69838,15,1
1580988,4138847,2821,23,400133,0,402954,23,1
1654099,2885683,1180,97,26347,0,27527,97,1
904266,3059214,70,36,581,0,651,36,1
1889048,848052,21,76,301,0,322,76,1
3721550,529911,188,43,14527,0,14715,43,1
3509903,464710,1530,1,509445,0,510975,1,1
1185620,4467181,60,70,660,0,720,70,1
2883731,2350549,213,54,5217,0,5430,54,1
2343253,4161275,1882,7,86401,0,88283,7,1
2206250,1412987,153,30,4857,0,5010,30,1
1497278,3230297,1869,47,35111,0,36980,47,1
932720,104239,1411,25,111323,0,112734,25,1
3372109,1124406,108,63,182,146,290,209,1
932720,1953072,1411,3,111323,0,112734,3,1
281939,4561972,80,237,2031,0,2111,237,1
3280389,1822346,1101,1,411419,0,412520,1,1
3335643,819515,191,587,1944,0,2135,587,1
2721412,4014826,273,244,2733,288,3006,532,1
3881566,2681811,781,284,14176,6285,14957,6569,1
3449530,4842329,717,17,73648,0,74365,17,1
4272102,3442767,1608,5,104171,0,105779,5,1
4653941,3909051,951,22,45883,0,46834,22,1
3361377,4225623,4841,7,761793,0,766634,7,1
2119841,4864564,272,2,1846,0,2118,2,1
681618,425585,75,1,8789,0,8864,1,1
2281149,4464878,282,177,28082,0,28364,177,1
1927211,969303,1668,8,113322,0,114990,8,1
4467395,1927752,2084,245,14574,0,16658,245,1
1364801,2038640,450,51,4704,0,5154,51,1
3128197,500252,122,60,6176,0,6298,60,1
4238001,1248129,869,187,61161,0,62030,187,1
593740,4577883,1107,73,62807,0,63914,73,1
3992144,1728559,402,4,23683,0,24085,4,1
1178312,877654,1213,1838,2028,1348,3241,3186,1
2260014,3045145,2466,136,98622,0,101088,136,1
41224,1659971,106,538,1786,0,1892,538,1
1534362,2754956,1531,61,105859,0,107390,61,1
1733957,4289447,554,190,15185,0,15739,190,1
2206106,2911523,21,85,369,0,390,85,1
4321286,3659437,32,7,208,0,240,7,1
593740,3863987,1107,46,62807,0,63914,46,1
878715,3702535,100,1,1976,0,2076,1,1
1887113,998493,8,3,343,0,351,3,1
567662,562383,172,100,1626,0,1798,100,1
2498087,675509,1630,33,32582,0,34212,33,1
3638272,3464544,2022,1,370904,0,372926,1,1
2870711,3936961,87,9,2239,0,2326,9,1
3836080,1201051,1197,56,59457,0,60654,56,1
1875,1279257,656,45,61388,0,62044,45,1
1303956,4011264,292,1360,2659,116777,2951,118137,1
1887669,4383999,733,47,23145,0,23878,47,1
3280389,1395880,1101,2,411419,0,412520,2,1
958615,1235049,56,1,2225,0,2281,1,1
592541,2579417,132,1,6913,0,7045,1,1
3592993,3306413,85,16,452,0,537,16,1
502082,2492680,589,187,16428,0,17017,187,1
671026,2815249,421,106,8079,0,8500,106,1
3157597,3246015,183,73,10247,0,10430,73,1
3671141,3931085,1444,174,48400,0,49844,174,1
2107861,1848154,535,1,25743,0,26278,1,1
4314280,2380479,568,15,9552,0,10120,15,1
1659274,3339556,132,638,1310,0,1442,638,1
2851109,2702469,450,2,98552,0,99002,2,1
1785615,1441628,153,146,2575,0,2728,146,1
1580988,3902892,2821,2,400133,0,402954,2,1
2147720,3969289,1608,57,78786,0,80394,57,1
3264929,1343613,15,17,246,0,261,17,1
3214492,3392570,32,4,150,0,182,4,1
3603010,381906,24,12,607,0,631,12,1
3907996,3575260,485,242,18964,5576,19449,5818,1
2851109,973527,450,1,98552,0,99002,1,1
855821,3242433,770,334,5493,0,6263,334,1
1618616,791840,931,9,5417,0,6348,9,1
1828358,3019636,106,23,927,0,1033,23,1
3734245,1422878,915,85,34965,0,35880,85,1
873006,772101,375,8,33630,0,34005,8,1
3897644,4018588,389,14,917,0,1306,14,1
1875,975016,656,14,61388,0,62044,14,1
3138039,4018719,5,9,84,0,89,9,1
941958,3994789,14,22,102,0,116,22,1
4416945,25430,417,35,33228,0,33645,35,1
4140279,3585578,337,28,49384,0,49721,28,1
3864556,3305012,96,184,330,273,426,457,1
4801471,3480685,585,66,17979,0,18564,66,1
3037644,4475136,71,3,2219,0,2290,3,1
2851109,123836,450,3,98552,0,99002,3,1
2851109,1928106,450,6,98552,0,99002,6,1
3280389,4215362,1101,1,411419,0,412520,1,1
3768366,2381593,334,78,12403,0,12737,78,1
3936039,2185534,799,1,23884,0,24683,1,1
1234540,665188,1071,14,75251,0,76322,14,1
1506065,4132521,136,247,3968,0,4104,247,1
4642569,2635083,872,68,27586,0,28458,68,1
4272102,3344572,1608,11,104171,0,105779,11,1
3929270,4533333,257,73,2972,0,3229,73,1
3509903,1505427,1530,8,509445,0,510975,8,1
2772256,263332,82,32,4404,0,4486,32,1
2346390,3421707,52,3,1982,0,2034,3,1
120760,1687566,76,6,364,0,440,6,1
1880135,1463541,810,57,71924,0,72734,57,1
765601,3093797,1485,29,101510,0,102995,29,1
2962038,326346,495,2,14236,0,14731,2,1
2751572,4776584,481,58,44036,0,44517,58,1
2848857,1046514,82,27,229,107,311,134,1
1580988,1618165,2821,160,400133,0,402954,160,1
4129802,1215316,48,18,326,0,374,18,1
868693,1508024,469,389,832,1845,1301,2234,1
471706,2451314,794,9,65616,0,66410,9,1
2096270,1244597,970,12,26018,0,26988,12,1
3879570,2823666,152,31,1376,1079,1528,1110,1
1234540,2099297,1071,26,75251,0,76322,26,1
3361377,2724786,4841,3,761793,0,766634,3,1
3918618,2573171,299,72,3785,0,4084,72,1
3235479,314106,999,171,66486,0,67485,171,1
277804,4255252,202,176,170,991,372,1167,1
3755697,183132,76,370,350,2556,426,2926,1
1242199,4023801,207,77,6182,0,6389,77,1
68756,2924941,230,62,355,0,585,62,1
4448424,4783846,6,20,345,0,351,20,1
3257465,4094000,541,64,27614,0,28155,64,1
2994391,1312078,315,61,6520,0,6835,61,1
2677334,1007191,377,1,6774,0,7151,1,1
4519069,799865,387,26,20799,0,21186,26,1
3569179,1302056,1064,7,40015,0,41079,7,1
3577145,680600,43,188,520,0,563,188,1
610143,906905,26,5,2000,0,2026,5,1
3513900,4067716,280,622,1809,4349,2089,4971,1
3260961,4029510,288,1,7637,0,7925,1,1
2653925,4679535,102,43,1214,0,1316,43,1
3438576,2970243,3424,16,137753,0,141177,16,1
2751572,3497176,481,250,44036,0,44517,250,1
752618,1485440,169,15,5929,0,6098,15,1
2662654,587327,224,24,1542,0,1766,24,1
1807497,4635295,180,193,371,0,551,193,1
4727207,1855530,925,4,84581,0,85506,4,1
3280389,4358552,1101,1,411419,0,412520,1,1
1735116,1584479,503,5,16146,0,16649,5,1
1913445,1880589,564,11,47943,0,48507,11,1
1545237,3080483,381,91,14327,0,14708,91,1
3361377,1483580,4841,12,761793,0,766634,12,1
4656285,1729590,1446,6,35428,0,36874,6,1
2981537,3883761,1252,2,118718,0,119970,2,1
2090342,4617680,155,5,2211,0,2366,5,1
519175,1300168,173,226,7221,0,7394,226,1
4624595,1901677,722,172,53368,0,54090,172,1
1907524,2860986,39,9,651,0,690,9,1
3835618,1859747,694,11,25433,0,26127,11,1
2120733,947721,819,56,20803,0,21622,56,1
3764177,3312073,1036,53,64563,0,65599,53,1
2860851,3614982,39,232,199,0,238,232,1
2529661,3180421,493,24,27309,0,27802,24,1
3851674,3971661,22,148,287,529,309,677,1
1927211,4679033,1668,31,113322,0,114990,31,1
2161635,3027177,124,11,1394,0,1518,11,1
3412500,4381750,41,798,733,153,774,951,1
1195333,332041,64,78,431,0,495,78,1
1250021,2744009,4637,10,85913,0,90550,10,1
3936039,1649405,799,82,23884,0,24683,82,1
2307868,2496706,1131,7,38777,0,39908,7,1
2075015,3209990,2664,139,85781,0,88445,139,1
4781147,4711492,161,147,2894,0,3055,147,1
1533546,106301,703,129,22095,0,22798,129,1
1276253,4847436,407,51,46534,0,46941,51,1
2497238,2342664,251,1181,2806,26502,3057,27683,1
4451122,2909376,985,74,41669,0,42654,74,1
1591435,1513589,387,312,31245,0,31632,312,1
765601,1588441,1485,23,101510,0,102995,23,1
3549674,443228,602,140,38542,0,39144,140,1
4782707,3595540,513,59,31665,0,32178,59,1
917130,2264286,325,84,7017,0,7342,84,1
1913445,4186047,564,61,47943,0,48507,61,1
2359044,3619188,14,34,45,0,59,34,1
2778168,4011868,65,74,1464,0,1529,74,1
2883055,864983,286,54,13198,0,13484,54,1
3914135,2023378,2152,51,60084,0,62236,51,1
2650412,4623678,931,4,29038,0,29969,4,1
1469880,1685494,275,93,3409,0,3684,93,1
2788949,3790299,134,4,1950,0,2084,4,1
3845119,449540,461,11,28609,0,29070,11,1
352669,1585656,51,80,1151,0,1202,80,1
2647342,2309328,68,185,1550,0,1618,185,1
2751572,984854,481,67,44036,0,44517,67,1
1671411,1085350,21,8,64,70,85,78,1
1331940,491736,802,64,32617,0,33419,64,1
3549674,1370097,602,27,38542,0,39144,27,1
1800445,2481786,132,63,2387,0,2519,63,1
4708541,994046,981,12,15678,0,16659,12,1
2989372,2616648,88,55,684,0,772,55,1
4411870,1581985,948,10,60517,0,61465,10,1
3157597,3235455,183,82,10247,0,10430,82,1
3385289,1123438,648,112,7232,0,7880,112,1
3844745,1394973,67,6,756,0,823,6,1
4411870,3368950,948,116,60517,0,61465,116,1
2847192,2036687,105,165,3937,0,4042,165,1
4827056,4509384,226,3,12578,0,12804,3,1
2981537,4485933,1252,7,118718,0,119970,7,1
3491692,3295251,76,1,1361,0,1437,1,1
417999,4520863,173,3432,2109,908,2282,4340,1
4011264,252650,1360,80,116777,0,118137,80,1
80085,1675775,75,1,2925,0,3000,1,1
1471685,4679184,1681,140,25550,0,27231,140,1
2853969,2373596,1051,25,42591,0,43642,25,1
2343253,1893492,1882,20,86401,0,88283,20,1
4174344,1658374,78,5,1046,0,1124,5,1
3387987,2891518,268,17,19035,0,19303,17,1
2446968,4599223,452,57,20110,0,20562,57,1
2169693,763005,194,12,7674,0,7868,12,1
401947,2125777,367,80,7890,0,8257,80,1
532681,524600,433,56,35023,0,35456,56,1
2120733,350910,819,48,20803,0,21622,48,1
3739473,2142759,448,157,13226,1936,13674,2093,1
3509903,2274131,1530,1,509445,0,510975,1,1
4011264,4351598,1360,22,116777,0,118137,22,1
3361377,2964721,4841,1,761793,0,766634,1,1
680015,1886142,485,192,9502,0,9987,192,1
549160,2736702,13,144,129,412,142,556,1
3853609,4660413,505,389,6896,0,7401,389,1
2971546,2734530,4,3,49,0,53,3,1
954784,972312,567,10,14450,0,15017,10,1
3768366,426799,334,39,12403,0,12737,39,1
1057323,2347376,291,13,1153,0,1444,13,1
4473394,627849,19,3,961,0,980,3,1
3509903,1397063,1530,1,509445,0,510975,1,1
2310300,4447516,229,141,1157,616,1386,757,1
2472397,1875468,116,18,1031,0,1147,18,1
307250,434201,919,6,35588,0,36507,6,1
3288730,2113133,117,88,4627,0,4744,88,1
2659272,1962264,28,2,183,0,211,2,1
2827436,2619294,882,1,271525,0,272407,1,1
1984826,3855132,2,1,479,0,481,1,1
2326007,1769714,94,30,3295,0,3389,30,1
3509903,1168530,1530,1,509445,0,510975,1,1
3672238,476498,518,375,12172,0,12690,375,1
1913445,559695,564,206,47943,0,48507,206,1
2869151,3583081,395,143,1304,0,1699,143,1
1887669,4331526,733,105,23145,0,23878,105,1
929513,3327064,145,113,4279,0,4424,113,1
595757,788566,340,3,26738,0,27078,3,1
805360,1254685,1514,28,119306,0,120820,28,1
155547,614791,34,21,350,0,384,21,1
4411870,361676,948,26,60517,0,61465,26,1
3866441,1714746,261,336,3655,0,3916,336,1
2088912,3578948,64,137,1178,0,1242,137,1
1588330,4385507,694,115,10280,0,10974,115,1
3137585,84889,1196,50,77354,0,78550,50,1
3936039,401489,799,24,23884,0,24683,24,1
916921,3539521,44,252,181,0,225,252,1
508787,3521384,29,568,88,357,117,925,1
3109249,3359949,27,135,71,38,98,173,1
401947,362946,367,25,7890,0,8257,25,1
1301815,1592467,752,70,48944,0,49696,70,1
3154825,2036100,44,14,694,0,738,14,1
253406,1154412,185,58,2002,793,2187,851,1
3672238,3787150,518,8,12172,0,12690,8,1
1503116,2637412,415,30,37079,0,37494,30,1
1301815,102975,752,3,48944,0,49696,3,1
1580988,475989,2821,2,400133,0,402954,2,1
2827436,2681563,882,4,271525,0,272407,4,1
1123367,441757,387,3,3721,0,4108,3,1
3280389,3748643,1101,52,411419,0,412520,52,1
3235479,1595615,999,139,66486,0,67485,139,1
3765475,2951271,873,290,107914,0,108787,290,1
3638272,2708942,2022,13,370904,0,372926,13,1
6618,3544315,892,151,68849,0,69741,151,1
3361377,3957212,4841,8,761793,0,766634,8,1
3253453,3715629,194,148,893,0,1087,148,1
2405451,2285360,124,8,2161,0,2285,8,1
630220,1175510,594,5,2886,0,3480,5,1
2516076,4843804,1455,57,77782,0,79237,57,1
64357,4586551,309,114,6329,0,6638,114,1
146390,749405,80,1,2046,0,2126,1,1
4593330,4600094,203,74,8083,0,8286,74,1
3509903,2400959,1530,2,509445,0,510975,2,1
1792932,1245658,153,12,901,0,1054,12,1
3509903,641468,1530,2,509445,0,510975,2,1
4496449,3159026,174,28,4260,0,4434,28,1
1839283,3728306,765,1,36658,0,37423,1,1
1751669,4008290,860,50,9825,0,10685,50,1
146390,421488,80,36,2046,0,2126,36,1
4295271,2911253,35,721,258,1925,293,2646,1
354904,4183607,3193,33,105780,0,108973,33,1
2969575,962233,28,24,442,0,470,24,1
3671141,1160724,1444,48,48400,0,49844,48,1
4272102,1929420,1608,57,104171,0,105779,57,1
3501482,1452943,522,115,28046,0,28568,115,1
3836080,158523,1197,384,59457,0,60654,384,1
1995204,1150105,119,8,1174,0,1293,8,1
3438576,2289327,3424,10,137753,0,141177,10,1
1580988,2009019,2821,1,400133,0,402954,1,1
3569179,1560056,1064,8,40015,0,41079,8,1
1471685,1562451,1681,13,25550,0,27231,13,1
1196844,2955564,548,124,36289,0,36837,124,1
2269301,1801126,82,47,784,0,866,47,1
3361377,526319,4841,2,761793,0,766634,2,1
4801471,956307,585,994,17979,0,18564,994,1
3837347,3975632,169,85,2761,0,2930,85,1
2823179,2927830,505,25,6744,0,7249,25,1
3522015,2905702,88,28,919,0,1007,28,1
2961801,3726413,1483,95,101962,0,103445,95,1
3438576,4300682,3424,1,137753,0,141177,1,1
345047,3230318,111,25,2534,0,2645,25,1
3458417,1314016,33,132,416,0,449,132,1
4238217,3567674,81,181,893,0,974,181,1
3081555,4671804,44,84,143,463,187,547,1
3449530,4233446,717,78,73648,0,74365,78,1
4064346,1877196,195,139,1521,0,1716,139,1
831272,512140,76,79,2383,0,2459,79,1
4360960,1927752,1642,245,110084,0,111726,245,1
471706,3323561,794,26,65616,0,66410,26,1
2502456,2135033,719,2,50725,0,51444,2,1
4727207,1805391,925,1,84581,0,85506,1,1
1196844,740109,548,75,36289,0,36837,75,1
1633100,961844,163,2,8737,0,8900,2,1
4360960,4528080,1642,51,110084,0,111726,51,1
2827436,2055649,882,1,271525,0,272407,1,1
1031334,1720129,459,137,16840,0,17299,137,1
907654,4854126,798,351,24575,0,25373,351,1
3280389,3825050,1101,2,411419,0,412520,2,1
1103332,544850,732,69,59415,0,60147,69,1
2874231,3137126,15,61,226,0,241,61,1
1580988,3882159,2821,3,400133,0,402954,3,1
3189108,4212752,421,473,6767,0,7188,473,1
3280389,177865,1101,1,411419,0,412520,1,1
1486758,290161,337,56,11346,0,11683,56,1
3734245,735052,915,131,34965,0,35880,131,1
354904,2848579,3193,28,105780,0,108973,28,1
4744878,4011264,68,1360,1896,116777,1964,118137,1
4238001,2788513,869,130,61161,0,62030,130,1
3633019,1557269,746,49,32317,0,33063,49,1
1910777,164090,477,3,1910,0,2387,3,1
3509903,2102010,1530,6,509445,0,510975,6,1
1794526,3370770,169,5,1730,0,1899,5,1
837553,3596378,1249,126,61665,0,62914,126,1
3167388,1573388,203,57,9760,0,9963,57,1
431086,2174133,619,51,14910,0,15529,51,1
1966548,4628003,208,1,53149,0,53357,1,1
2827436,732114,882,10,271525,0,272407,10,1
2560406,781042,18,228,38,181,56,409,1
3873768,1962880,449,38,35424,0,35873,38,1
2101710,4126018,152,108,6934,0,7086,108,1
3019092,3212501,108,1,8595,0,8703,1,1
3449530,2419680,717,2,73648,0,74365,2,1
1652056,3714837,326,1,66845,0,67171,1,1
582276,2456054,298,37,10990,0,11288,37,1
3765475,3167726,873,78,107914,0,108787,78,1
1505328,1250399,76,8,795,0,871,8,1
3361377,2278379,4841,15,761793,0,766634,15,1
525299,3323037,337,96,4714,0,5051,96,1
3072769,2997654,187,11,3430,0,3617,11,1
3569617,4029838,160,3,3695,0,3855,3,1
4440160,2460962,736,38,20522,0,21258,38,1
2348093,165399,335,7,12064,0,12399,7,1
471706,2874711,794,79,65616,0,66410,79,1
3280389,3605796,1101,11,411419,0,412520,11,1
3071504,1613428,80,141,3797,0,3877,141,1
2613814,3242899,242,121,1818,0,2060,121,1
4178055,1122270,260,173,8186,0,8446,173,1
3398118,4723734,49,10,1466,0,1515,10,1
4840211,1549677,145,139,2001,139,2146,278,1
3522049,3432959,301,289,12347,0,12648,289,1
2529661,3366602,493,42,27309,0,27802,42,1
408965,1287511,903,1,38623,0,39526,1,1
1504506,2533528,551,60,1317,0,1868,60,1
427805,1133038,483,1,156906,0,157389,1,1
1494665,3380779,668,20,37638,0,38306,20,1
4077562,1041019,433,502,2723,0,3156,502,1
1913445,1538046,564,41,47943,0,48507,41,1
2138728,2436822,38,26,63,0,101,26,1
867231,968399,318,78,1675,0,1993,78,1
1580988,3837319,2821,2,400133,0,402954,2,1
3759853,2707014,451,200,16330,0,16781,200,1
3906136,3330579,387,99,41169,0,41556,99,1
4210860,2504390,86,126,251,636,337,762,1
1635215,53386,209,73,8253,0,8462,73,1
4013053,55190,33,43,1781,0,1814,43,1
2961801,173228,1483,36,101962,0,103445,36,1
3873768,4467395,449,2084,35424,14574,35873,16658,1
1225988,3058722,157,294,8881,0,9038,294,1
808127,3874407,273,503,4215,62,4488,565,1
1580988,2836918,2821,1,400133,0,402954,1,1
2405789,827535,1010,7,93387,0,94397,7,1
2850494,50546,29,141,202,0,231,141,1
1580988,3773587,2821,1,400133,0,402954,1,1
3638272,585204,2022,2,370904,0,372926,2,1
2827436,4297127,882,1,271525,0,272407,1,1
4416945,3448534,417,21,33228,0,33645,21,1
3633019,3685690,746,8,32317,0,33063,8,1
3435085,2737849,221,24,663,0,884,24,1
1814709,2227258,316,1046,5746,0,6062,1046,1
2702724,4356733,566,200,10448,0,11014,200,1
2064376,2096131,139,82,5873,0,6012,82,1
4103612,3846305,932,45,5655,0,6587,45,1
700722,22919,121,28,490,1075,611,1103,1
1436216,4861982,1068,1,68770,0,69838,1,1
1160303,4016647,54,4,164,0,218,4,1
1875,3861280,656,4,61388,0,62044,4,1
3361377,370670,4841,63,761793,0,766634,63,1
1063358,779901,1350,11,63494,0,64844,11,1
284877,2333268,107,273,3215,0,3322,273,1
2098655,78676,3,46,55,43,58,89,1
3278135,4334170,358,28,7252,0,7610,28,1
439557,2134595,2090,73,61744,0,63834,73,1
2950311,981761,807,78,85116,0,85923,78,1
4411870,2893430,948,8,60517,0,61465,8,1
687713,3349193,436,1,47160,0,47596,1,1
1582015,1149497,62,166,69,333,131,499,1
4701737,3650693,98,59,4855,0,4953,59,1
3615027,4114412,81,105,442,0,523,105,1
3667893,1436562,471,694,2170,124,2641,818,1
3509903,3203863,1530,317,509445,0,510975,317,1
4311068,654367,65,26,514,0,579,26,1
3248738,3157782,102,42,4433,0,4535,42,1
4727207,1395862,925,4,84581,0,85506,4,1
1460308,1417387,35,93,1951,0,1986,93,1
1494665,949873,668,3,37638,0,38306,3,1
4140279,2532997,337,1,49384,0,49721,1,1
3067549,1148474,684,214,1696,2785,2380,2999,1
3361377,276365,4841,1,761793,0,766634,1,1
2827436,4492852,882,2,271525,0,272407,2,1
227235,2067429,60,12,1787,0,1847,12,1
1539837,1918083,1127,251,62979,0,64106,251,1
151034,1075497,54,30,494,0,548,30,1
2772256,3076880,82,14,4404,0,4486,14,1
1063358,1459458,1350,162,63494,0,64844,162,1
2092359,1621590,421,4,26936,0,27357,4,1
3672238,2405845,518,97,12172,0,12690,97,1
4238001,1578435,869,53,61161,0,62030,53,1
3914135,3861335,2152,83,60084,0,62236,83,1
427805,1789530,483,2,156906,0,157389,2,1
4727207,2061514,925,6,84581,0,85506,6,1
3509903,1496167,1530,1,509445,0,510975,1,1
4798192,2777466,816,11,20426,0,21242,11,1
1353265,335054,128,15,6709,0,6837,15,1
805360,3071878,1514,29,119306,0,120820,29,1
3128197,3190163,122,2,6176,0,6298,2,1
670296,3453829,632,26,10586,0,11218,26,1
860473,550916,751,102,20450,0,21201,102,1
2759996,3572241,37,1,362,0,399,1,1
3676295,1408277,374,1,70881,0,71255,1,1
3043117,485437,130,3,2809,0,2939,3,1
3438576,2656878,3424,2,137753,0,141177,2,1
4334842,3680870,85,19,4749,0,4834,19,1
1319584,2165801,62,5,1989,0,2051,5,1
4467395,117122,2084,9,14574,0,16658,9,1
1913445,2323217,564,867,47943,0,48507,867,1
3857537,4312524,1008,116,5225,0,6233,116,1
2150686,3361377,69,4841,983,761793,1052,766634,1
1100354,2481617,163,3,24439,0,24602,3,1
4209323,4221991,1630,139,89460,0,91090,139,1
3829011,3564871,143,97,2807,0,2950,97,1
4727207,483640,925,8,84581,0,85506,8,1
4671746,4816697,512,137,4544,0,5056,137,1
4308612,877654,22,1838,183,1348,205,3186,1
3509903,496984,1530,2,509445,0,510975,2,1
4220190,2989110,320,1042,15994,19283,16314,20325,1
4052496,480868,107,79,4222,0,4329,79,1
3898535,4810532,59,12,9303,0,9362,12,1
2108131,3275082,25,21,629,0,654,21,1
2453598,3972065,100,5,1097,0,1197,5,1
961349,4451122,154,985,5849,41669,6003,42654,1
2762372,4073763,818,23,6089,0,6907,23,1
3673348,759354,26,13,562,0,588,13,1
4754275,2005602,75,8,2058,0,2133,8,1
2911269,2936511,740,21,20606,0,21346,21,1
4088288,4227328,57,17,366,0,423,17,1
1927211,2769673,1668,44,113322,0,114990,44,1
4360960,1096511,1642,5,110084,0,111726,5,1
2882832,4171022,146,35,887,0,1033,35,1
3294702,3220030,991,182,68888,0,69879,182,1
2961801,3232596,1483,68,101962,0,103445,68,1
3361377,3796605,4841,1,761793,0,766634,1,1
427805,2717606,483,1,156906,0,157389,1,1
354904,1238785,3193,95,105780,0,108973,95,1
4636168,379918,215,76,1967,0,2182,76,1
1971076,2666911,74,53,350,0,424,53,1
1927780,4700546,420,122,6230,0,6650,122,1
2498087,3605946,1630,17,32582,0,34212,17,1
4395006,4540782,239,10,1862,0,2101,10,1
3040163,1773896,16,669,217,109,233,778,1
4303282,4865875,60,89,99,107,159,196,1
4360960,4153286,1642,128,110084,0,111726,128,1
501914,3791101,217,902,5217,0,5434,902,1
2429949,514401,27,32,293,0,320,32,1
3872736,3535665,258,575,12660,0,12918,575,1
2261139,2020671,2014,19,42851,0,44865,19,1
3438576,3721337,3424,63,137753,0,141177,63,1
2092359,763913,421,17,26936,0,27357,17,1
4238001,1108614,869,36,61161,0,62030,36,1
2307868,4119466,1131,6,38777,0,39908,6,1
659480,1868970,518,24,1649,0,2167,24,1
1396952,1874401,37,3,628,0,665,3,1
4751453,492804,520,286,27570,0,28090,286,1
2260014,4163496,2466,30,98622,0,101088,30,1
4141746,4570635,61,53,917,0,978,53,1
892512,1680255,1505,38,11757,67,13262,105,1
2649949,1012350,79,55,866,0,945,55,1
3638272,124988,2022,5,370904,0,372926,5,1
573101,1075439,781,121,12750,0,13531,121,1
2628417,2252074,11,5,689,0,700,5,1
3765475,1715359,873,3,107914,0,108787,3,1
3018264,81378,77,36,689,0,766,36,1
2760655,1432650,403,966,2250,215,2653,1181,1
1250021,3629508,4637,64,85913,0,90550,64,1
4660753,1600900,178,282,2207,211,2385,493,1
1051108,1927323,262,57,7542,0,7804,57,1
1516853,3373294,426,4,10168,0,10594,4,1
1321779,574877,320,15,2517,0,2837,15,1
2897926,1411330,565,1,25983,0,26548,1,1
2706492,3893049,14,4,417,0,431,4,1
72159,3938702,161,27,2037,0,2198,27,1
515290,144970,285,107,34080,0,34365,107,1
4569293,4163561,191,179,5084,0,5275,179,1
4209323,2717975,1630,24,89460,0,91090,24,1
2260014,1325697,2466,14,98622,0,101088,14,1
60980,3178665,649,4,20708,0,21357,4,1
3582961,533526,12,2,275,0,287,2,1
1977657,1063630,141,120,1990,0,2131,120,1
2343253,4443948,1882,4,86401,0,88283,4,1
3361377,398280,4841,3,761793,0,766634,3,1
2872979,1631137,341,118,28510,0,28851,118,1
2179326,4861830,71,11,780,0,851,11,1
3734245,4205932,915,11,34965,0,35880,11,1
2041371,2672918,211,406,2804,0,3015,406,1
3954325,1520633,1743,32,16616,0,18359,32,1
1503116,3332863,415,90,37079,0,37494,90,1
2981537,2595638,1252,2,118718,0,119970,2,1
577850,3749931,21,72,126,0,147,72,1
2209136,1386110,620,51,33789,0,34409,51,1
1609659,2354652,523,48,29763,0,30286,48,1
2827436,3545135,882,3,271525,0,272407,3,1
3361377,693211,4841,12,761793,0,766634,12,1
2702724,595757,566,340,10448,26738,11014,27078,1
755739,1718465,1117,20,58043,0,59160,20,1
4653941,3967612,951,2,45883,0,46834,2,1
2405789,3906079,1010,149,93387,0,94397,149,1
2631746,4713662,80,23,420,0,500,23,1
3115867,810266,1350,146,61232,0,62582,146,1
268333,2311449,77,60,550,0,627,60,1
3750255,3408405,18,15,176,0,194,15,1
2307868,2878862,1131,38,38777,0,39908,38,1
1580508,4761719,720,511,19611,0,20331,511,1
3607310,64357,318,309,3879,6329,4197,6638,1
1293807,231833,1837,2,30865,0,32702,2,1
2565218,1013942,285,27,1750,0,2035,27,1
4701737,4051434,98,2,4855,0,4953,2,1
3638272,2620907,2022,12,370904,0,372926,12,1
2950311,4440290,807,5,85116,0,85923,5,1
630220,1147089,594,114,2886,0,3480,114,1
3501677,2748317,33,37,127,0,160,37,1
2985909,4114411,706,90,43348,0,44054,90,1
940526,4660479,475,13,20786,0,21261,13,1
755739,124288,1117,48,58043,0,59160,48,1
2516076,2035826,1455,30,77782,0,79237,30,1
3742930,3545241,410,22,22242,0,22652,22,1
1580988,1226432,2821,1,400133,0,402954,1,1
3866441,2641486,261,2,3655,0,3916,2,1
151693,3862109,436,161,12181,0,12617,161,1
1275916,671876,583,95,1663,0,2246,95,1
2961552,3360703,562,20,16546,0,17108,20,1
4519298,1680085,577,70,14443,0,15020,70,1
1875,2634338,656,13,61388,0,62044,13,1
635435,1544729,199,3,1985,0,2184,3,1
2209891,1478940,204,8,4060,0,4264,8,1
877,1186677,258,122,2455,0,2713,122,1
3914135,4364943,2152,5,60084,0,62236,5,1
4272102,4662137,1608,18,104171,0,105779,18,1
3280389,845210,1101,1,411419,0,412520,1,1
3280389,2787636,1101,2,411419,0,412520,2,1
1241907,2466469,176,13,1602,0,1778,13,1
2516076,602143,1455,14,77782,0,79237,14,1
3561502,2471299,1144,143,68800,0,69944,143,1
883775,268143,202,28,2409,0,2611,28,1
3723631,1924872,173,361,578,5715,751,6076,1
4272102,3760942,1608,1,104171,0,105779,1,1
3361377,2043781,4841,1,761793,0,766634,1,1
2662809,4176284,303,192,10704,342,11007,534,1
427805,566239,483,2,156906,0,157389,2,1
427805,33412,483,1,156906,0,157389,1,1
439557,1128460,2090,3,61744,0,63834,3,1
1192480,1204314,397,4,20737,0,21134,4,1
3384159,4021473,415,105,6659,0,7074,105,1
2674718,4552836,136,468,5233,0,5369,468,1
3509903,1985247,1530,2,509445,0,510975,2,1
544230,3425694,1532,69,60768,0,62300,69,1
1100354,3196742,163,1,24439,0,24602,1,1
352669,1331317,51,46,1151,0,1202,46,1
3875080,46697,285,363,5153,3359,5438,3722,1
2897926,984442,565,15,25983,0,26548,15,1
1623852,1495218,85,13,495,0,580,13,1
4319287,3280484,271,424,1522,2345,1793,2769,1
1588330,2114744,694,35,10280,0,10974,35,1
2961552,2258501,562,11,16546,0,17108,11,1
3505066,4331696,131,45,3630,0,3761,45,1
2482338,4453049,712,7,24222,0,24934,7,1
1325245,3441431,144,26,5103,0,5247,26,1
4707650,117232,257,21,6619,0,6876,21,1
773149,265634,202,1,926,0,1128,1,1
4319972,474633,640,2,35279,0,35919,2,1
3509903,3786315,1530,1,509445,0,510975,1,1
2784572,4011737,69,30,3478,0,3547,30,1
3765475,3679834,873,1,107914,0,108787,1,1
3191004,2074879,62,268,1343,231,1405,499,1
3271484,3245610,1507,45,34093,0,35600,45,1
441734,1967594,271,1,3594,0,3865,1,1
2188394,231454,166,56,2340,0,2506,56,1
1375041,4128888,62,242,495,0,557,242,1
1927211,391722,1668,44,113322,0,114990,44,1
3094189,2649990,7,1,1033,0,1040,1,1
1580988,1101353,2821,1,400133,0,402954,1,1
842615,2188909,510,130,12316,0,12826,130,1
3361377,4234512,4841,2,761793,0,766634,2,1
3361377,2052568,4841,103,761793,0,766634,103,1
2021745,348616,72,57,2948,0,3020,57,1
755739,4660115,1117,33,58043,0,59160,33,1
1600857,4437794,324,7,10576,0,10900,7,1
3125762,2286680,254,2,8285,0,8539,2,1
582276,2746955,298,33,10990,0,11288,33,1
2090342,4191923,155,7,2211,0,2366,7,1
3509903,3790092,1530,1,509445,0,510975,1,1
3370656,1882921,74,3,820,0,894,3,1
3280389,822012,1101,1,411419,0,412520,1,1
2343253,58557,1882,249,86401,0,88283,249,1
2827436,3571973,882,52,271525,0,272407,52,1
4817410,1866450,31,1,1422,0,1453,1,1
837553,3039600,1249,90,61665,0,62914,90,1
3594818,2639555,81,1,1945,0,2026,1,1
3115867,3921246,1350,120,61232,0,62582,120,1
2793995,3718853,230,3,427,0,657,3,1
3638272,2145486,2022,6,370904,0,372926,6,1
837553,245689,1249,155,61665,0,62914,155,1
3871554,4074712,947,153,16042,0,16989,153,1
4117427,1821456,329,104,9639,0,9968,104,1
4057848,292868,556,2,3400,0,3956,2,1
2482338,3931085,712,174,24222,0,24934,174,1
1973082,1246144,1036,31,18915,0,19951,31,1
4011264,322917,1360,54,116777,0,118137,54,1
1494665,1233290,668,22,37638,0,38306,22,1
4440160,1539670,736,37,20522,0,21258,37,1
2961801,3884270,1483,25,101962,0,103445,25,1
2893334,1738446,889,49,30148,0,31037,49,1
2887240,1147105,1143,11,118405,0,119548,11,1
2948092,3690740,412,8,18486,0,18898,8,1
3916976,2147453,188,15,6098,0,6286,15,1
1490274,3050692,25,1,276,0,301,1,1
1580988,4022478,2821,1,400133,0,402954,1,1
2206273,2518475,235,76,4892,0,5127,76,1
1817799,3841523,402,119,15932,175,16334,294,1
1777298,1796867,468,38,6381,0,6849,38,1
3361377,2002917,4841,1,761793,0,766634,1,1
3764316,1579957,53,8,1015,0,1068,8,1
2687552,2448126,238,51,25574,0,25812,51,1
4087774,4833716,578,26,10107,0,10685,26,1
1575009,1323787,429,38,37745,0,38174,38,1
4751453,4068234,520,13,27570,0,28090,13,1
3509214,2408035,263,11,14139,0,14402,11,1
3361377,2317640,4841,1,761793,0,766634,1,1
3361377,2312005,4841,3,761793,0,766634,3,1
907654,4799235,798,34,24575,0,25373,34,1
4437944,1783218,262,354,3324,0,3586,354,1
3764177,505190,1036,50,64563,0,65599,50,1
681618,4612548,75,21,8789,0,8864,21,1
3361377,2036471,4841,1,761793,0,766634,1,1
3361377,2862405,4841,1,761793,0,766634,1,1
1927211,4792166,1668,23,113322,0,114990,23,1
1580988,2841828,2821,106,400133,2223,402954,2329,1
1406736,3294484,296,61,1820,0,2116,61,1
4624595,4711600,722,19,53368,0,54090,19,1
711442,3023130,300,778,999,6402,1299,7180,1
307250,2215182,919,1,35588,0,36507,1,1
2470160,2129096,103,2,4362,0,4465,2,1
3070589,1648045,280,305,4483,0,4763,305,1
3065808,4441273,1235,2,82317,0,83552,2,1
3645402,854450,153,99,7400,0,7553,99,1
3280389,2670268,1101,2,411419,0,412520,2,1
687713,345253,436,2,47160,0,47596,2,1
1880135,3150765,810,33,71924,0,72734,33,1
2405789,1422513,1010,29,93387,0,94397,29,1
2687552,2312756,238,196,25574,0,25812,196,1
4120171,508150,33,9,407,0,440,9,1
1310800,2491268,200,755,6100,0,6300,755,1
3294702,2904442,991,8,68888,0,69879,8,1
4272102,1760369,1608,41,104171,0,105779,41,1
2093169,4742295,10,65,81,0,91,65,1
2961801,1715209,1483,52,101962,0,103445,52,1
746117,3523179,45,6,760,0,805,6,1
4479581,2416146,601,126,19545,0,20146,126,1
2567613,2165822,186,228,2647,0,2833,228,1
1250021,2346339,4637,20,85913,0,90550,20,1
2766066,1639309,74,2,663,0,737,2,1
1541866,3504320,542,11,16481,0,17023,11,1
471706,3074718,794,115,65616,0,66410,115,1
3509903,651241,1530,4,509445,0,510975,4,1
1580988,3449097,2821,177,400133,0,402954,177,1
2407452,741713,249,63,3937,0,4186,63,1
2861639,3254457,481,46,10848,0,11329,46,1
3361377,2531735,4841,6,761793,0,766634,6,1
2260014,4415014,2466,12,98622,0,101088,12,1
4496752,3520040,554,41,16258,0,16812,41,1
4738916,4838376,1165,606,34124,26838,35289,27444,1
1300847,30472,51,166,343,0,394,166,1
2075015,2010868,2664,6,85781,0,88445,6,1
832576,2382445,127,46,356,0,483,46,1
932720,1748003,1411,140,111323,0,112734,140,1
3845119,4778982,461,163,28609,0,29070,163,1
2751572,4528906,481,24,44036,0,44517,24,1
4853234,3483312,1256,13,29554,0,30810,13,1
775837,1375653,196,1,1396,0,1592,1,1
1973082,3145595,1036,21,18915,0,19951,21,1
2827436,3395399,882,1,271525,0,272407,1,1
3954325,2123086,1743,43,16616,0,18359,43,1
3638272,1997751,2022,1,370904,0,372926,1,1
524924,3127391,45,59,910,0,955,59,1
3127312,4426694,110,93,1528,0,1638,93,1
3361377,1118465,4841,6,761793,0,766634,6,1
2090342,271623,155,57,2211,0,2366,57,1
3006008,4803355,51,5,431,0,482,5,1
3505068,1903259,167,17,2673,0,2840,17,1
2781817,520059,704,20,24613,0,25317,20,1
3257465,2389728,541,53,27614,0,28155,53,1
852898,2389288,122,283,1097,0,1219,283,1
1973082,1971009,1036,18,18915,0,19951,18,1
3137585,4561350,1196,28,77354,0,78550,28,1
956350,2335377,35,15,107,0,142,15,1
4183784,3431276,931,2,59894,0,60825,2,1
3509903,412824,1530,3,509445,0,510975,3,1
2827436,205007,882,35,271525,0,272407,35,1
3569179,3089606,1064,1,40015,0,41079,1,1
2851109,97362,450,2,98552,0,99002,2,1
4191410,3925428,1590,18,96434,0,98024,18,1
4186494,2942299,57,87,599,0,656,87,1
2642496,1589618,66,1,450,0,516,1,1
2962038,3288974,495,20,14236,0,14731,20,1
408965,884358,903,40,38623,0,39526,40,1
2851109,2264991,450,2,98552,0,99002,2,1
907654,266891,798,57,24575,0,25373,57,1
4126505,3781739,114,88,1915,0,2029,88,1
2881894,1841608,211,394,7468,0,7679,394,1
471706,4518143,794,35,65616,0,66410,35,1
3329658,2504983,95,192,1945,0,2040,192,1
3361377,3279523,4841,2,761793,0,766634,2,1
1264672,1387669,193,240,1577,0,1770,240,1
1635717,4383965,174,25,1173,0,1347,25,1
1516853,397555,426,26,10168,0,10594,26,1
3575260,2364077,242,255,5576,0,5818,255,1
1063358,2295381,1350,29,63494,0,64844,29,1
1817799,1888723,402,571,15932,0,16334,571,1
4727207,4199062,925,4,84581,0,85506,4,1
1370197,2888891,665,64,3306,0,3971,64,1
3764177,1388724,1036,35,64563,0,65599,35,1
3632293,1563414,570,2,21294,0,21864,2,1
3551464,3361377,11,4841,40,761793,51,766634,1
276502,4643002,30,1,2245,0,2275,1,1
474172,426277,471,146,38713,0,39184,146,1
2047860,2021098,131,159,143,212,274,371,1
3105613,1026213,15,17,139,0,154,17,1
2502456,3385530,719,101,50725,0,51444,101,1
807776,2002385,3,36,94,0,97,36,1
4384375,4411879,129,122,4747,0,4876,122,1
3284020,4479370,111,702,2181,0,2292,702,1
502082,2664382,589,41,16428,0,17017,41,1
2050190,837159,153,6,9156,0,9309,6,1
3278135,3516597,358,101,7252,0,7610,101,1
354904,581466,3193,33,105780,0,108973,33,1
3509903,547692,1530,3,509445,0,510975,3,1
386424,745359,131,285,7871,0,8002,285,1
1276253,396294,407,1,46534,0,46941,1,1
6618,3619921,892,9,68849,0,69741,9,1
4064346,4058687,195,418,1521,3486,1716,3904,1
4803701,2811908,333,354,6414,0,6747,354,1
1998083,4247426,123,36,953,0,1076,36,1
333887,1788972,15,1,3610,0,3625,1,1
2893327,1635192,100,148,2238,0,2338,148,1
915390,3929192,1345,8,5262,0,6607,8,1
284877,2123966,107,14,3215,0,3322,14,1
2041134,3894112,477,10,4284,0,4761,10,1
805360,731226,1514,11,119306,0,120820,11,1
2222568,2980140,44,30,679,0,723,30,1
544230,1676115,1532,20,60768,0,62300,20,1
3099326,4440723,176,29,1952,0,2128,29,1
2791231,3530930,183,22,5221,0,5404,22,1
3630714,3635897,257,3,7929,0,8186,3,1
2428341,4461786,826,32,10151,0,10977,32,1
2258757,1867287,142,13,412,0,554,13,1
1344759,4001378,276,2,2679,0,2955,2,1
1580474,2675594,67,23,5377,0,5444,23,1
1164238,2959838,179,18,2363,0,2542,18,1
573641,3044241,253,129,5074,0,5327,129,1
4236325,473628,372,477,6103,0,6475,477,1
354904,4769266,3193,17,105780,0,108973,17,1
1880135,3751222,810,306,71924,0,72734,306,1
1807467,2512738,208,312,2442,0,2650,312,1
1839283,3876832,765,5,36658,0,37423,5,1
3112136,1383325,406,1,41366,0,41772,1,1
3361377,975996,4841,2,761793,0,766634,2,1
3742930,681549,410,299,22242,0,22652,299,1
3361377,88477,4841,59,761793,0,766634,59,1
919120,1466898,205,36,2831,0,3036,36,1
386424,1388633,131,357,7871,0,8002,357,1
3112136,683809,406,23,41366,0,41772,23,1
4236325,1022080,372,8,6103,0,6475,8,1
4649206,2830115,566,38,31367,0,31933,38,1
4672319,3459758,483,150,9652,0,10135,150,1
3318434,800197,55,54,1995,0,2050,54,1
680015,1410472,485,41,9502,0,9987,41,1
3509903,3584167,1530,17,509445,0,510975,17,1
1831198,1027486,450,782,5884,383,6334,1165,1
1416419,234595,401,47,2098,0,2499,47,1
3280389,3695201,1101,1,411419,0,412520,1,1
4084121,2320517,113,371,2582,0,2695,371,1
3361377,1042458,4841,12,761793,0,766634,12,1
4628096,441984,219,44,5074,0,5293,44,1
4727207,3660535,925,1,84581,0,85506,1,1
4089528,264488,76,415,359,0,435,415,1
3509903,1954700,1530,1,509445,0,510975,1,1
2950311,3093296,807,19,85116,0,85923,19,1
360874,3011705,124,100,4585,0,4709,100,1
3509903,1055918,1530,1,509445,0,510975,1,1
2551530,3619703,145,115,2250,0,2395,115,1
3280389,4432935,1101,3,411419,0,412520,3,1
1580988,3047057,2821,24,400133,0,402954,24,1
3361377,2185934,4841,117,761793,0,766634,117,1
3361377,95875,4841,1,761793,0,766634,1,1
768957,2387994,202,39,7986,0,8188,39,1
1086912,441651,907,34,33396,0,34303,34,1
3280389,2561445,1101,1,411419,0,412520,1,1
288324,4402767,90,53,1983,0,2073,53,1
4731849,3786621,455,202,10886,0,11341,202,1
3509903,3414665,1530,1,509445,0,510975,1,1
2052485,371595,59,42,2664,0,2723,42,1
6618,2935931,892,58,68849,0,69741,58,1
2107861,652579,535,2,25743,0,26278,2,1
2961801,3794644,1483,6,101962,0,103445,6,1
621115,1182502,66,2,6250,0,6316,2,1
1545237,3341068,381,192,14327,0,14708,192,1
2362241,4076822,324,21,7732,0,8056,21,1
3049925,563191,18,4,98,0,116,4,1
2137402,2418607,94,22,569,0,663,22,1
2405789,139440,1010,156,93387,0,94397,156,1
4744679,3749417,247,21,3462,0,3709,21,1
3059686,789595,460,7,4530,0,4990,7,1
3569179,2666157,1064,7,40015,0,41079,7,1
2587505,91530,25,20,238,0,263,20,1
4161939,4173456,104,80,1917,0,2021,80,1
1497278,852159,1869,50,35111,0,36980,50,1
354904,4375654,3193,12,105780,0,108973,12,1
4360960,395243,1642,90,110084,0,111726,90,1
427805,1021338,483,1,156906,0,157389,1,1
2144660,1001440,427,7,3108,0,3535,7,1
3206499,3812548,1337,1,32033,0,33370,1,1
571147,594237,364,151,5484,0,5848,151,1
501914,4795783,217,21,5217,0,5434,21,1
1763353,1970531,126,1,10072,0,10198,1,1
3058068,3110566,124,1,12734,0,12858,1,1
2994391,3774990,315,135,6520,0,6835,135,1
765601,1355669,1485,50,101510,0,102995,50,1
3514277,3660772,1338,52,13269,0,14607,52,1
1580988,1318157,2821,2,400133,0,402954,2,1
4011264,2358599,1360,23,116777,0,118137,23,1
4161986,1426734,114,79,1978,0,2092,79,1
427805,2817921,483,1,156906,0,157389,1,1
3846966,3610407,22,88,136,82,158,170,1
4596817,1268270,160,6,1879,0,2039,6,1
298465,4236712,34,24,98,66,132,90,1
1086912,2261491,907,3,33396,0,34303,3,1
1428477,1784999,255,3,15459,0,15714,3,1
4319972,2267769,640,19,35279,0,35919,19,1
153871,1791289,333,1,3892,0,4225,1,1
4360960,897559,1642,53,110084,0,111726,53,1
1339861,3714061,200,84,1212,3348,1412,3432,1
1536341,3041000,53,437,1995,0,2048,437,1
3128197,2440456,122,67,6176,0,6298,67,1
1436216,2488760,1068,171,68770,0,69838,171,1
1817799,3137431,402,199,15932,0,16334,199,1
2724971,293274,35,1272,955,0,990,1272,1
1887709,3912803,217,25,28983,0,29200,25,1
129567,3749635,65,17,932,0,997,17,1
3066330,3378022,97,17,2081,0,2178,17,1
2985909,4305149,706,77,43348,0,44054,77,1
2198488,3911304,37,87,2593,982,2630,1069,1
3280389,115780,1101,1,411419,0,412520,1,1
3219524,3623944,554,3,1128,0,1682,3,1
1250021,1432660,4637,26,85913,0,90550,26,1
4621952,4710420,922,87,5245,0,6167,87,1
4209323,1434628,1630,5,89460,309,91090,314,1
2281709,2998073,95,13,2301,0,2396,13,1
3761102,2285172,279,134,11592,0,11871,134,1
2150273,1391336,649,95,6442,0,7091,95,1
4313641,4289473,215,187,1879,0,2094,187,1
2342664,779982,1181,218,26502,0,27683,218,1
4672319,369537,483,90,9652,0,10135,90,1
3873768,4027279,449,62,35424,0,35873,62,1
4547438,1554709,1291,91,25237,0,26528,91,1
1079363,3234736,75,81,586,0,661,81,1
2148937,3150325,672,1,47361,0,48033,1,1
1387865,2657284,18,2605,477,690,495,3295,1
1994281,3889129,139,185,2492,0,2631,185,1
2174130,3731133,86,2,1368,0,1454,2,1
4619326,359722,539,1,22721,0,23260,1,1
3454888,304969,162,223,7886,0,8048,223,1
4183784,1240955,931,108,59894,0,60825,108,1
1575009,3877046,429,112,37745,0,38174,112,1
3509903,2143215,1530,10,509445,0,510975,10,1
743837,3660889,613,357,2344,1769,2957,2126,1
1497278,1184635,1869,432,35111,0,36980,432,1
4140279,951872,337,2,49384,0,49721,2,1
2502456,2923946,719,41,50725,0,51444,41,1
4209323,3191964,1630,13,89460,0,91090,13,1
3835618,2269330,694,75,25433,0,26127,75,1
6618,252873,892,36,68849,0,69741,36,1
3910135,4637484,298,3,14348,0,14646,3,1
1966548,1106032,208,2,53149,0,53357,2,1
2093911,3543341,121,14,1212,0,1333,14,1
2068128,1790855,76,45,2000,0,2076,45,1
2482338,985876,712,5,24222,0,24934,5,1
1047075,805251,100,34,768,417,868,451,1
4782707,3597302,513,1,31665,0,32178,1,1
1847461,2612259,1211,19,51149,0,52360,19,1
1751085,2863176,31,3,502,0,533,3,1
146317,855821,146,770,708,5493,854,6263,1
3214893,149360,1087,31,6553,0,7640,31,1
2464401,580361,577,5,23681,0,24258,5,1
958615,1372183,56,37,2225,0,2281,37,1
427805,4820022,483,2,156906,0,157389,2,1
932720,4588812,1411,15,111323,0,112734,15,1
3655915,1290940,176,3,1999,0,2175,3,1
4547438,987626,1291,238,25237,1743,26528,1981,1
4011264,1491376,1360,24,116777,0,118137,24,1
4727207,719178,925,23,84581,0,85506,23,1
4360960,4854798,1642,5,110084,0,111726,5,1
2989110,1745796,1042,12,19283,0,20325,12,1
837553,344271,1249,91,61665,0,62914,91,1
4179343,2548095,119,3,9822,0,9941,3,1
4387278,59465,6,1,1963,0,1969,1,1
3294702,3393428,991,197,68888,0,69879,197,1
1103332,2559927,732,31,59415,0,60147,31,1
3416126,4080388,5,11,247,0,252,11,1
2694929,1061190,186,26,4613,0,4799,26,1
3361377,3523088,4841,1,761793,0,766634,1,1
598774,4360960,36,1642,287,110084,323,111726,1
1544048,4238001,206,869,4200,61161,4406,62030,1
4272102,3381080,1608,15,104171,0,105779,15,1
2976040,2862394,86,13,441,0,527,13,1
3836080,4624384,1197,37,59457,0,60654,37,1
3449530,1769652,717,28,73648,0,74365,28,1
2007331,3999823,249,57,2102,0,2351,57,1
3609927,1986954,101,35,497,0,598,35,1
4416945,922451,417,16,33228,0,33645,16,1
60980,2054459,649,107,20708,0,21357,107,1
2906472,1206409,199,91,3865,0,4064,91,1
1494665,2068162,668,91,37638,0,38306,91,1
2553405,2359120,568,228,12913,0,13481,228,1
2490914,1151209,570,125,22965,0,23535,125,1
405955,566562,109,9,6949,0,7058,9,1
307250,2959836,919,1,35588,0,36507,1,1
4151915,864142,726,84,3886,0,4612,84,1
3638272,3144996,2022,2,370904,0,372926,2,1
1583804,840878,39,45,404,0,443,45,1
4360799,2074443,910,82,10476,0,11386,82,1
1710474,4360960,154,1642,1649,110084,1803,111726,1
3115867,3721291,1350,77,61232,0,62582,77,1
1206697,433181,685,67,5595,0,6280,67,1
2448456,2033650,14,177,96,533,110,710,1
2981537,4473012,1252,1,118718,0,119970,1,1
2375878,4459029,248,123,14925,0,15173,123,1
805360,1212949,1514,65,119306,0,120820,65,1
4678614,15760,452,1,16881,0,17333,1,1
1086912,2718886,907,85,33396,0,34303,85,1
3257465,4809941,541,75,27614,0,28155,75,1
4712782,2571318,171,80,4681,1318,4852,1398,1
805360,1372175,1514,55,119306,0,120820,55,1
3638272,4448309,2022,1,370904,0,372926,1,1
2893334,992030,889,62,30148,0,31037,62,1
4193551,1685759,314,43,1572,0,1886,43,1
1731071,1443634,72,54,948,0,1020,54,1
3281555,982093,73,1,1792,0,1865,1,1
3115867,2409534,1350,171,61232,0,62582,171,1
3387987,772491,268,38,19035,0,19303,38,1
1063358,932473,1350,55,63494,0,64844,55,1
4624595,3398041,722,331,53368,0,54090,331,1
1880135,3180578,810,68,71924,0,72734,68,1
673776,583998,150,380,1513,0,1663,380,1
3059686,245891,460,7,4530,0,4990,7,1
593740,4607829,1107,674,62807,0,63914,674,1
3361377,3289971,4841,1,761793,0,766634,1,1
3992144,4034839,402,161,23683,0,24085,161,1
3280389,1939060,1101,1,411419,0,412520,1,1
4727207,1133771,925,7,84581,0,85506,7,1
401947,3508679,367,185,7890,0,8257,185,1
2075015,4003640,2664,95,85781,0,88445,95,1
3501270,4235403,214,8,2145,0,2359,8,1
1580988,4450753,2821,34,400133,0,402954,34,1
815517,550985,312,213,4322,0,4634,213,1
1063358,2264927,1350,88,63494,0,64844,88,1
2498087,1298792,1630,131,32582,0,34212,131,1
3987684,1422824,286,3,17372,0,17658,3,1
957197,3215232,614,4,37109,0,37723,4,1
3509903,3535223,1530,1,509445,0,510975,1,1
3638272,1177863,2022,1,370904,0,372926,1,1
2276175,2094276,262,260,4860,2234,5122,2494,1
4455659,3984877,342,345,2879,0,3221,345,1
2198813,3514791,908,254,282,2148,1190,2402,1
427805,2832949,483,1,156906,0,157389,1,1
2887240,1985868,1143,3,118405,0,119548,3,1
1580988,2054946,2821,1,400133,0,402954,1,1
1654099,4082871,1180,64,26347,0,27527,64,1
4108836,486744,97,96,4234,0,4331,96,1
3701625,1352942,86,21,2327,0,2413,21,1
1939510,3310125,74,90,206,330,280,420,1
1301815,1623179,752,45,48944,0,49696,45,1
1428477,1915185,255,2,15459,0,15714,2,1
3650366,2033650,263,177,578,533,841,710,1
3509903,997430,1530,1,509445,0,510975,1,1
4782707,1367207,513,54,31665,0,32178,54,1
1093682,3611086,25,93,113,0,138,93,1
3632293,1498830,570,52,21294,0,21864,52,1
1822719,759569,285,2,22351,0,22636,2,1
4344159,3679910,53,39,425,374,478,413,1
4013601,2142489,653,31,14886,0,15539,31,1
1382833,354904,99,3193,442,105780,541,108973,1
2827436,2146203,882,35,271525,0,272407,35,1
6618,1287658,892,7,68849,0,69741,7,1
2260121,2391752,262,1458,521,98,783,1556,1
2736702,2537292,144,8,412,0,556,8,1
1534362,4362950,1531,52,105859,0,107390,52,1
1250021,2472583,4637,3,85913,0,90550,3,1
2999986,3753233,120,434,1369,1,1489,435,1
3638272,3411880,2022,2,370904,0,372926,2,1
2490914,3872451,570,75,22965,0,23535,75,1
2790006,703565,367,5,14747,0,15114,5,1
3402545,2572450,253,240,2083,0,2336,240,1
4348977,2618101,55,8,1054,0,1109,8,1
860473,3958161,751,33,20450,0,21201,33,1
4516604,1806649,314,7,13314,0,13628,7,1
4653941,66842,951,3,45883,0,46834,3,1
2075015,3082641,2664,12,85781,0,88445,12,1
4727207,3907132,925,3,84581,0,85506,3,1
1652056,1904867,326,1,66845,0,67171,1,1
4238001,3641044,869,98,61161,0,62030,98,1
4727207,1860695,925,3,84581,0,85506,3,1
2148937,4281315,672,3,47361,0,48033,3,1
3800793,773803,12,4,134,0,146,4,1
2723940,1135919,38,2,1986,0,2024,2,1
3509903,1103737,1530,4,509445,0,510975,4,1
2827436,4567841,882,1,271525,0,272407,1,1
1534362,3656432,1531,54,105859,0,107390,54,1
3361377,4564529,4841,4,761793,0,766634,4,1
4115960,3585459,172,1,1656,0,1828,1,1
1601403,3752902,35,59,395,0,430,59,1
3577145,2652760,43,7,520,0,563,7,1
873006,1640878,375,37,33630,0,34005,37,1
408965,4602421,903,13,38623,0,39526,13,1
1580988,3160049,2821,2,400133,0,402954,2,1
4191410,2166038,1590,75,96434,0,98024,75,1
663087,2802704,551,73,3410,0,3961,73,1
3509903,3950915,1530,4,509445,0,510975,4,1
4272102,3836956,1608,47,104171,0,105779,47,1
3449530,23525,717,29,73648,0,74365,29,1
1306260,3794328,233,1,3200,0,3433,1,1
636814,3851418,116,13,9387,0,9503,13,1
1135323,340228,169,2,12240,0,12409,2,1
873241,2433173,616,38,22633,0,23249,38,1
670296,2933498,632,255,10586,0,11218,255,1
2979123,3680362,65,91,808,0,873,91,1
815277,4853007,139,274,268,200,407,474,1
3361377,3483078,4841,1,761793,0,766634,1,1
2827436,705306,882,37,271525,0,272407,37,1
3290204,874699,256,113,931,0,1187,113,1
3206499,1929780,1337,1,32033,0,33370,1,1
1719802,3331433,3,1,456,0,459,1,1
3815269,3660220,213,336,7440,0,7653,336,1
4411870,3296376,948,28,60517,0,61465,28,1
3037049,3831282,43,2,1584,0,1627,2,1
4361636,247958,186,868,1867,0,2053,868,1
3051212,1118466,957,71,8349,0,9306,71,1
1148474,966698,214,20,2785,0,2999,20,1
3260961,706149,288,419,7637,0,7925,419,1
2961552,2843135,562,79,16546,0,17108,79,1
3658703,2086088,42,5,202,0,244,5,1
61959,2887240,48,1143,368,118405,416,119548,1
932720,1653570,1411,57,111323,0,112734,57,1
281939,4016909,80,2,2031,0,2111,2,1
3058068,3075992,124,3,12734,0,12858,3,1
4843360,1054239,355,190,7866,0,8221,190,1
515290,3846929,285,36,34080,0,34365,36,1
4006119,168823,31,533,491,152,522,685,1
324143,930638,73,91,326,0,399,91,1
2897926,4519600,565,8,25983,0,26548,8,1
3758692,4027574,711,144,34731,0,35442,144,1
4295952,3789635,808,58,57369,0,58177,58,1
4750855,3628669,355,91,18880,0,19235,91,1
4274877,4694033,25,1,307,0,332,1,1
3765475,136381,873,4,107914,0,108787,4,1
449646,837553,29,1249,257,61665,286,62914,1
1436216,571212,1068,1,68770,0,69838,1,1
1326428,717716,153,4,2569,0,2722,4,1
153377,2913932,154,28,589,0,743,28,1
1428477,4208001,255,1,15459,0,15714,1,1
2147720,2622391,1608,36,78786,0,80394,36,1
2498087,263681,1630,17,32582,0,34212,17,1
3742930,4629625,410,27,22242,0,22652,27,1
3408428,4024924,71,17,449,0,520,17,1
3138130,1273923,76,99,849,646,925,745,1
4649206,3113756,566,184,31367,0,31933,184,1
3361377,2770826,4841,2,761793,0,766634,2,1
843445,433008,302,54,1763,0,2065,54,1
4518123,3054491,300,96,6419,0,6719,96,1
354904,1503092,3193,8,105780,0,108973,8,1
3380947,4864989,526,24,367,0,893,24,1
3914135,4345934,2152,57,60084,0,62236,57,1
3454888,2496441,162,203,7886,0,8048,203,1
149674,2937118,29,411,109,0,138,411,1
765601,293864,1485,3,101510,0,102995,3,1
3509903,4435180,1530,3,509445,0,510975,3,1
1822719,2222744,285,3,22351,0,22636,3,1
3163398,4015080,60,144,838,1337,898,1481,1
2786853,3509903,91,1530,922,509445,1013,510975,1
3361377,719049,4841,2,761793,0,766634,2,1
2762372,3669901,818,47,6089,0,6907,47,1
837553,2590787,1249,78,61665,0,62914,78,1
2981537,4732232,1252,27,118718,0,119970,27,1
1839283,2797270,765,125,36658,0,37423,125,1
2152173,1205945,196,99,969,250,1165,349,1
3808085,1381600,66,1,143,0,209,1,1
3280389,1870061,1101,1,411419,0,412520,1,1
1234540,4800555,1071,104,75251,0,76322,104,1
4838376,1656757,606,37,26838,0,27444,37,1
2841394,1375882,159,870,3045,0,3204,870,1
4528103,976715,268,3,14258,0,14526,3,1
4711909,414486,440,180,2933,0,3373,180,1
3509903,4692327,1530,149,509445,2092,510975,2241,1
4479581,891321,601,4,19545,0,20146,4,1
1247786,4448346,69,111,359,380,428,491,1
2067060,1670848,81,160,716,17,797,177,1
1822719,1654470,285,10,22351,0,22636,10,1
3340239,4818977,221,45,922,0,1143,45,1
4451122,943794,985,38,41669,0,42654,38,1
3638272,4532931,2022,1,370904,0,372926,1,1
1580988,1532016,2821,110,400133,227,402954,337,1
2187320,3905182,208,66,3143,0,3351,66,1
595757,2572450,340,240,26738,0,27078,240,1
4209323,854826,1630,25,89460,0,91090,25,1
1913445,4276423,564,7,47943,0,48507,7,1
1787075,3434449,894,43,28305,0,29199,43,1
4013601,4266306,653,72,14886,0,15539,72,1
1733957,3639323,554,50,15185,0,15739,50,1
3361377,3276937,4841,1,761793,0,766634,1,1
1469880,1880399,275,7,3409,0,3684,7,1
3280389,123867,1101,1,411419,0,412520,1,1
1483094,1276165,146,204,3104,0,3250,204,1
2940588,2724893,554,63,9477,0,10031,63,1
2981537,2853228,1252,2,118718,0,119970,2,1
2801790,4135316,15,1,45,0,60,1,1
4423184,868444,384,49,29809,0,30193,49,1
2195890,711537,134,166,5208,0,5342,166,1
3815269,3605779,213,47,7440,0,7653,47,1
3280389,873360,1101,1,411419,0,412520,1,1
1521082,4193047,766,89,6562,1266,7328,1355,1
2827436,2849144,882,1,271525,0,272407,1,1
2260014,652286,2466,40,98622,0,101088,40,1
3522049,2317317,301,8,12347,0,12648,8,1
3438576,1895176,3424,4,137753,0,141177,4,1
2182339,1608010,55,78,503,0,558,78,1
2092359,2219163,421,106,26936,0,27357,106,1
1250021,2383008,4637,8,85913,0,90550,8,1
805360,3599190,1514,161,119306,0,120820,161,1
515290,3218891,285,102,34080,0,34365,102,1
3824547,4089854,1075,4,14337,0,15412,4,1
3764528,250053,95,46,1133,0,1228,46,1
4011264,4450504,1360,46,116777,0,118137,46,1
4319972,1150522,640,26,35279,0,35919,26,1
3383252,284517,281,34,3966,0,4247,34,1
1994281,3033166,139,312,2492,4444,2631,4756,1
2851109,2271695,450,1,98552,0,99002,1,1
3764177,417831,1036,44,64563,0,65599,44,1
4801471,2840674,585,72,17979,0,18564,72,1
3419989,1897240,350,185,16316,0,16666,185,1
1534362,3598503,1531,85,105859,0,107390,85,1
4705188,4288404,336,54,8658,0,8994,54,1
2465665,1829962,167,29,1159,0,1326,29,1
1787075,3321723,894,140,28305,0,29199,140,1
4477971,2389135,32,10,542,0,574,10,1
2209136,318090,620,74,33789,1957,34409,2031,1
3157809,991824,397,12,1176,0,1573,12,1
2662654,1415541,224,49,1542,0,1766,49,1
3038921,4577905,240,57,1721,400,1961,457,1
4834694,4821088,18,7,376,0,394,7,1
3561502,1280877,1144,26,68800,0,69944,26,1
3638272,322781,2022,16,370904,0,372926,16,1
3786156,2003714,23,16,240,0,263,16,1
3765475,3308348,873,2,107914,0,108787,2,1
2490914,1800154,570,1,22965,0,23535,1,1
1234540,4456554,1071,37,75251,0,76322,37,1
3761507,4052552,137,562,373,5417,510,5979,1
1613202,3391673,566,6,8639,0,9205,6,1
3383083,3277085,96,7,1075,0,1171,7,1
1611386,1720988,187,112,10932,0,11119,112,1
855051,4435504,26,2,357,0,383,2,1
3291145,4439917,105,89,4218,0,4323,89,1
1927211,2853918,1668,4,113322,0,114990,4,1
1311307,4398409,358,88,10864,0,11222,88,1
1633053,3599392,533,40,8638,0,9171,40,1
4528103,2041260,268,153,14258,0,14526,153,1
878433,2819364,15,8,162,0,177,8,1
1633022,1987846,246,1,23530,0,23776,1,1
3853410,2307042,33,384,780,0,813,384,1
4357854,4280192,300,37,2963,0,3263,37,1
1331940,3708025,802,2,32617,0,33419,2,1
3137585,4395015,1196,35,77354,0,78550,35,1
4492248,3185019,237,9,17127,0,17364,9,1
2604190,915979,129,11,1011,0,1140,11,1
3001891,779910,304,138,4550,0,4854,138,1
2297625,3532804,512,28,6498,0,7010,28,1
3676295,804994,374,2,70881,0,71255,2,1
648163,1164098,238,262,1998,0,2236,262,1
3587846,1761162,136,6,501,0,637,6,1
3509903,2659987,1530,2,509445,0,510975,2,1
3691520,4451491,533,817,9121,8836,9654,9653,1
1086912,2825322,907,18,33396,0,34303,18,1
2310300,1254033,229,12,1157,0,1386,12,1
1880135,3354447,810,63,71924,0,72734,63,1
2536472,3734033,344,281,9725,0,10069,281,1
1196844,16082,548,64,36289,0,36837,64,1
1533546,1928928,703,169,22095,5084,22798,5253,1
1471685,873973,1681,45,25550,0,27231,45,1
4360960,1627827,1642,22,110084,0,111726,22,1
665164,1354952,396,77,12610,0,13006,77,1
4423559,4191410,77,1590,1412,96434,1489,98024,1
3361377,3711054,4841,1,761793,0,766634,1,1
4229482,3220048,182,682,1285,0,1467,682,1
3361377,2522549,4841,1,761793,0,766634,1,1
3469653,3943423,32,1,2818,0,2850,1,1
1580988,2752845,2821,1,400133,0,402954,1,1
60980,1191454,649,2,20708,0,21357,2,1
1151593,2653996,231,38,5501,0,5732,38,1
817090,3581114,188,3,4245,0,4433,3,1
3671141,683151,1444,130,48400,0,49844,130,1
2613814,462240,242,246,1818,0,2060,246,1
2620287,1673920,78,11,2306,0,2384,11,1
3137585,3719114,1196,16,77354,0,78550,16,1
4621719,1470856,306,164,4102,0,4408,164,1
2941178,1775775,121,10,1943,0,2064,10,1
3638272,169631,2022,1,370904,0,372926,1,1
3004174,281826,258,1,5546,0,5804,1,1
1250021,1473618,4637,1,85913,0,90550,1,1
1527599,1638695,176,87,3575,0,3751,87,1
3271484,1073258,1507,51,34093,0,35600,51,1
1526503,1745181,29,19,999,0,1028,19,1
1787075,1223841,894,395,28305,0,29199,395,1
3638272,4807947,2022,1,370904,0,372926,1,1
1534362,4799294,1531,9,105859,0,107390,9,1
2342664,1583501,1181,82,26502,0,27683,82,1
4282517,2166312,103,164,855,0,958,164,1
1471685,1950085,1681,113,25550,0,27231,113,1
3016810,3506122,164,282,4329,0,4493,282,1
6618,1481893,892,39,68849,0,69741,39,1
4596817,3572996,160,51,1879,0,2039,51,1
427805,482754,483,1,156906,0,157389,1,1
668325,648405,484,91,4655,0,5139,91,1
4295952,1130737,808,4,57369,0,58177,4,1
3645402,2887645,153,139,7400,0,7553,139,1
1534362,4006158,1531,29,105859,0,107390,29,1
4440160,4260933,736,2,20522,0,21258,2,1
2260014,3671819,2466,9,98622,0,101088,9,1
2950311,1310425,807,49,85116,0,85923,49,1
3361377,1411204,4841,6,761793,0,766634,6,1
755739,3230376,1117,56,58043,0,59160,56,1
24443,319947,7,1,288,0,295,1,1
2436781,3449751,689,17,9972,0,10661,17,1
4360799,1880269,910,22,10476,0,11386,22,1
1912031,4763936,226,387,2674,0,2900,387,1
4525011,483577,172,4,6076,0,6248,4,1
2827436,4045100,882,2,271525,0,272407,2,1
4649206,4273990,566,5,31367,0,31933,5,1
3214323,630372,147,41,12543,0,12690,41,1
1062967,3128004,260,59,15276,0,15536,59,1
3280389,3492878,1101,1,411419,0,412520,1,1
1225988,102291,157,59,8881,0,9038,59,1
1516853,1909408,426,44,10168,0,10594,44,1
1652056,2129714,326,1,66845,0,67171,1,1
3280389,984267,1101,1,411419,0,412520,1,1
2092359,1802522,421,4,26936,0,27357,4,1
966625,2027108,114,1172,269,5587,383,6759,1
3638272,3744927,2022,1,370904,0,372926,1,1
4011264,934029,1360,87,116777,0,118137,87,1
135332,381881,86,213,526,0,612,213,1
480984,937129,59,1,640,0,699,1,1
3225310,800206,320,128,10537,0,10857,128,1
1103332,3942856,732,43,59415,0,60147,43,1
6618,1107661,892,94,68849,0,69741,94,1
873241,4524612,616,53,22633,0,23249,53,1
1534362,3999219,1531,9,105859,0,107390,9,1
3509903,4509013,1530,7,509445,0,510975,7,1
3765475,2524895,873,15,107914,0,108787,15,1
920553,4468044,349,12,8968,0,9317,12,1
873241,1400640,616,48,22633,0,23249,48,1
4860485,663617,89,82,3655,0,3744,82,1
4208044,1041351,247,23,3919,0,4166,23,1
3051212,793323,957,15,8349,0,9306,15,1
4238001,4092616,869,51,61161,0,62030,51,1
551730,1753385,25,33,1271,0,1296,33,1
1927211,3852510,1668,22,113322,0,114990,22,1
4739361,84235,32,134,261,32,293,166,1
837553,867350,1249,145,61665,0,62914,145,1
4219479,3908187,158,77,4945,0,5103,77,1
408965,1811245,903,176,38623,0,39526,176,1
1493489,631946,523,42,17512,0,18035,42,1
2310265,1843507,241,537,6278,11729,6519,12266,1
1580474,2082225,67,38,5377,0,5444,38,1
1539837,2150608,1127,28,62979,0,64106,28,1
1634335,923581,144,27,849,0,993,27,1
2772113,3205709,792,49,42907,0,43699,49,1
932720,2220314,1411,22,111323,0,112734,22,1
4104158,3412500,128,41,1909,733,2037,774,1
3509903,2760638,1530,1,509445,0,510975,1,1
3549674,2645615,602,24,38542,0,39144,24,1
2405789,3144933,1010,32,93387,0,94397,32,1
3676295,34018,374,2,70881,0,71255,2,1
2403192,4191727,163,463,5302,26315,5465,26778,1
1196844,2521463,548,86,36289,0,36837,86,1
3509903,3617212,1530,2,509445,0,510975,2,1
3671141,4155602,1444,78,48400,0,49844,78,1
2478272,2289920,36,29,146,0,182,29,1
2503097,2710040,414,1130,3628,0,4042,1130,1
307250,3698559,919,85,35588,0,36507,85,1
3263148,485416,174,3,2060,0,2234,3,1
2544987,2970846,50,32,255,0,305,32,1
2004231,583636,119,4,538,0,657,4,1
530200,3193721,2035,26,62809,0,64844,26,1
354904,2520682,3193,193,105780,73,108973,266,1
3764177,2156401,1036,61,64563,0,65599,61,1
3906136,3113645,387,68,41169,0,41556,68,1
4217975,1497278,58,1869,1546,35111,1604,36980,1
860473,1522021,751,34,20450,0,21201,34,1
1533546,3593577,703,5,22095,0,22798,5,1
749953,658037,10,3,82,0,92,3,1
3638272,3618258,2022,1,370904,0,372926,1,1
2092359,3282010,421,60,26936,0,27357,60,1
1897168,873061,85,2,1905,0,1990,2,1
4624595,678571,722,22,53368,0,54090,22,1
471706,2606284,794,7,65616,0,66410,7,1
1769943,4864644,553,45,7901,0,8454,45,1
2650412,714522,931,61,29038,0,29969,61,1
3294702,1138602,991,31,68888,0,69879,31,1
2267633,1436746,422,3,13247,0,13669,3,1
4179002,3911864,235,120,1340,0,1575,120,1
4644889,61027,144,151,3031,0,3175,151,1
1178312,604892,1213,105,2028,0,3241,105,1
3014139,1241815,75,2,1511,0,1586,2,1
3065808,1561350,1235,43,82317,0,83552,43,1
1192480,4846528,397,2,20737,0,21134,2,1
3671141,4694045,1444,16,48400,0,49844,16,1
1063358,2562562,1350,20,63494,0,64844,20,1
3304867,585594,217,3,1983,0,2200,3,1
3638272,1283731,2022,4,370904,0,372926,4,1
4304056,2967255,164,15,12698,0,12862,15,1
3395938,2213639,546,1,39878,0,40424,1,1
4238001,4519536,869,20,61161,0,62030,20,1
2405789,1094199,1010,143,93387,0,94397,143,1
2281580,2992123,309,173,1051,56,1360,229,1
4656285,4737818,1446,1,35428,0,36874,1,1
3280389,1909882,1101,2,411419,0,412520,2,1
1250021,1290917,4637,17,85913,0,90550,17,1
1483094,3034068,146,279,3104,0,3250,279,1
1580988,1743852,2821,49,400133,0,402954,49,1
4782707,3123864,513,242,31665,0,32178,242,1
1234540,2071790,1071,51,75251,0,76322,51,1
4193534,951447,82,3,6961,0,7043,3,1
1064989,1823516,140,29,1201,0,1341,29,1
1064989,2666134,140,291,1201,4395,1341,4686,1
3361377,2703687,4841,1,761793,0,766634,1,1
1103332,1792597,732,4,59415,0,60147,4,1
77213,837245,214,17,1656,0,1870,17,1
802229,2723671,168,69,3140,0,3308,69,1
2308819,802658,141,80,5491,0,5632,80,1
3638272,135182,2022,2,370904,0,372926,2,1
3671141,4708034,1444,79,48400,0,49844,79,1
307250,955230,919,3,35588,0,36507,3,1
3361377,4595211,4841,1,761793,0,766634,1,1
877158,2061631,34,20,986,0,1020,20,1
2092359,2965593,421,13,26936,0,27357,13,1
521586,393663,782,12,18489,0,19271,12,1
2342664,980397,1181,1,26502,0,27683,1,1
471706,827994,794,17,65616,0,66410,17,1
2827436,4501786,882,195,271525,0,272407,195,1
3361377,3516333,4841,53,761793,0,766634,53,1
530200,3410766,2035,1,62809,0,64844,1,1
2853969,1287430,1051,1,42591,0,43642,1,1
2533451,504885,65,48,110,0,175,48,1
4624595,4430769,722,17,53368,0,54090,17,1
250177,4634841,330,3,3969,0,4299,3,1
2050190,60360,153,5,9156,0,9309,5,1
4272102,2292890,1608,17,104171,0,105779,17,1
3065808,1098066,1235,6,82317,0,83552,6,1
1301815,1580238,752,91,48944,0,49696,91,1
2755456,971580,15,97,136,0,151,97,1
427805,1069896,483,1,156906,0,157389,1,1
382977,2619880,143,4,5934,0,6077,4,1
1243612,4788195,394,63,2553,0,2947,63,1
2436470,4384814,194,213,2248,0,2442,213,1
4272102,3284231,1608,95,104171,0,105779,95,1
979316,4857928,867,160,3442,0,4309,160,1
3361377,1998902,4841,1,761793,0,766634,1,1
2950311,3184743,807,50,85116,0,85923,50,1
4062175,1084042,248,36,8522,0,8770,36,1
2075015,3932518,2664,6,85781,0,88445,6,1
4705188,2854337,336,159,8658,0,8994,159,1
4527016,2955251,187,39,1921,0,2108,39,1
2464401,2494130,577,2,23681,0,24258,2,1
4007838,3884339,86,3,122,0,208,3,1
3115867,1577165,1350,4,61232,0,62582,4,1
3271484,2024066,1507,7,34093,0,35600,7,1
932720,1569193,1411,46,111323,0,112734,46,1
4379508,1420788,122,215,709,0,831,215,1
2307868,1513370,1131,7,38777,0,39908,7,1
3655915,3903909,176,7,1999,0,2175,7,1
3123201,3788159,126,4,5539,0,5665,4,1
4360960,3976714,1642,46,110084,0,111726,46,1
2195890,1777911,134,207,5208,0,5342,207,1
1637447,2987936,555,5,8549,0,9104,5,1
3395938,121435,546,123,39878,0,40424,123,1
3509903,1491217,1530,3,509445,0,510975,3,1
4113414,2151983,403,15,3521,0,3924,15,1
4195259,4365404,148,1,861,0,1009,1,1
911192,259153,106,1,6327,0,6433,1,1
1628356,4726324,49,220,1715,0,1764,220,1
4181760,2803178,359,29,7855,0,8214,29,1
3509903,3332,1530,3,509445,0,510975,3,1
1545237,3496064,381,3,14327,0,14708,3,1
4160619,2703050,152,555,745,266,897,821,1
1637447,1197674,555,68,8549,0,9104,68,1
2981537,1627809,1252,7,118718,0,119970,7,1
1803208,3906398,101,34,906,0,1007,34,1
3849054,1766668,417,90,13259,0,13676,90,1
3065808,3539957,1235,67,82317,0,83552,67,1
4534401,2459615,103,114,4125,0,4228,114,1
439557,2977785,2090,24,61744,0,63834,24,1
3361377,275450,4841,148,761793,0,766634,148,1
2694929,514914,186,13,4613,0,4799,13,1
4183784,2056663,931,43,59894,0,60825,43,1
842476,3587131,898,6,12479,0,13377,6,1
4261998,1169644,54,156,462,184,516,340,1
4735218,373520,252,31,5309,0,5561,31,1
4417253,1590787,1130,26,68389,0,69519,26,1
2654633,4598882,151,5,2699,0,2850,5,1
1787075,508144,894,1,28305,0,29199,1,1
4721617,488223,307,3,12885,0,13192,3,1
873006,2344892,375,119,33630,0,34005,119,1
2375878,960506,248,166,14925,0,15173,166,1
3128197,366334,122,6,6176,0,6298,6,1
3361377,420413,4841,13,761793,0,766634,13,1
2962038,2497076,495,28,14236,0,14731,28,1
2553405,1943600,568,79,12913,0,13481,79,1
3361377,3287946,4841,1,761793,0,766634,1,1
2569009,2372469,424,198,13423,0,13847,198,1
1785615,3234094,153,7,2575,0,2728,7,1
3876737,4459843,2951,24,1921,0,4872,24,1
4272102,1297561,1608,67,104171,0,105779,67,1
3449530,3138574,717,18,73648,0,74365,18,1
1020529,2825410,489,61,2075,0,2564,61,1
3235479,1734451,999,27,66486,0,67485,27,1
354904,4188162,3193,22,105780,0,108973,22,1
2261139,1686362,2014,48,42851,0,44865,48,1
3361377,1542182,4841,1,761793,0,766634,1,1
1390907,758012,94,671,2072,0,2166,671,1
2327109,4291058,175,134,1877,0,2052,134,1
636814,1979032,116,1,9387,0,9503,1,1
697165,4116863,20,5,885,0,905,5,1
3280389,1715487,1101,9,411419,0,412520,9,1
3638272,778570,2022,4,370904,0,372926,4,1
1196844,4770064,548,70,36289,0,36837,70,1
2772113,1216208,792,142,42907,0,43699,142,1
3759853,4165021,451,108,16330,0,16781,108,1
3764177,1286967,1036,72,64563,0,65599,72,1
1588705,1384399,1000,57,11879,0,12879,57,1
212421,1627800,11,3035,433,3,444,3038,1
2343253,1156392,1882,35,86401,0,88283,35,1
3280389,232691,1101,1,411419,0,412520,1,1
3065808,2439326,1235,35,82317,0,83552,35,1
2556526,4271464,28,3,141,0,169,3,1
2851109,4623892,450,1,98552,0,99002,1,1
3481008,4437207,201,198,1452,0,1653,198,1
1580988,1386149,2821,5,400133,0,402954,5,1
1588330,2384266,694,6,10280,0,10974,6,1
1580988,2226531,2821,2,400133,0,402954,2,1
1063233,185718,97,16,672,0,769,16,1
4751453,2901995,520,7,27570,0,28090,7,1
2851109,3104840,450,2,98552,0,99002,2,1
4584128,3023674,57,1637,128,59,185,1696,1
1086912,1411647,907,47,33396,0,34303,47,1
3119857,1060661,353,34,1460,0,1813,34,1
4183784,2555704,931,63,59894,0,60825,63,1
3438576,68504,3424,1,137753,0,141177,1,1
2267633,2510090,422,52,13247,0,13669,52,1
427805,2798078,483,185,156906,0,157389,185,1
940526,79159,475,3,20786,0,21261,3,1
765601,1817892,1485,39,101510,0,102995,39,1
2853969,4331655,1051,30,42591,0,43642,30,1
3337583,1661035,126,32,3240,0,3366,32,1
4054733,3116105,217,217,1907,0,2124,217,1
1775742,2212656,7,16,80,0,87,16,1
3445328,4467521,5,5,175,0,180,5,1
2715611,30820,73,10,1227,0,1300,10,1
2436304,4334937,559,300,1979,0,2538,300,1
831951,2332649,68,4,781,0,849,4,1
1301815,3401967,752,92,48944,0,49696,92,1
497262,356181,80,1,1897,0,1977,1,1
2314038,935547,456,23,16347,0,16803,23,1
2798865,567799,25,80,2109,0,2134,80,1
2853969,1316633,1051,2,42591,0,43642,2,1
3561502,1896255,1144,61,68800,0,69944,61,1
4399390,2998950,42,35,301,90,343,125,1
1580988,969930,2821,3,400133,0,402954,3,1
1736555,1818438,60,89,829,0,889,89,1
3361377,3483434,4841,1,761793,0,766634,1,1
2569758,1490239,97,993,1649,0,1746,993,1
1499272,4736500,48,11,294,0,342,11,1
1355114,1840009,47,1,2747,0,2794,1,1
471706,3819847,794,4,65616,0,66410,4,1
2266398,3910133,209,2,1473,0,1682,2,1
3438576,737556,3424,122,137753,0,141177,122,1
1534362,4558069,1531,41,105859,0,107390,41,1
4302921,2568327,509,9,13289,0,13798,9,1
1436216,4376442,1068,1,68770,0,69838,1,1
2784961,4611455,221,28,3707,0,3928,28,1
3764177,104234,1036,139,64563,0,65599,139,1
3983436,1262677,376,57,3267,0,3643,57,1
1654099,3113314,1180,8,26347,0,27527,8,1
2096270,1712021,970,48,26018,0,26988,48,1
1545237,1052535,381,25,14327,0,14708,25,1
4272102,3858865,1608,58,104171,0,105779,58,1
3638272,2636850,2022,14,370904,0,372926,14,1
3438576,2866986,3424,102,137753,0,141177,102,1
573641,2011998,253,42,5074,0,5327,42,1
4209323,2650412,1630,931,89460,29038,91090,29969,1
3242275,1962040,551,110,17400,0,17951,110,1
528463,1433845,40,145,784,0,824,145,1
821089,4136003,394,897,4820,0,5214,897,1
439557,1565286,2090,222,61744,0,63834,222,1
427805,3734180,483,1,156906,0,157389,1,1
3629404,1150938,185,150,6681,0,6866,150,1
3280389,3984195,1101,1,411419,0,412520,1,1
2388735,3098322,403,5,4921,0,5324,5,1
2755798,2614409,494,2,24862,0,25356,2,1
1575009,3076338,429,76,37745,0,38174,76,1
4431832,548269,55,29,287,0,342,29,1
47194,3982014,148,1,4662,0,4810,1,1
2662809,193465,303,4,10704,0,11007,4,1
939339,3453615,36,112,1157,0,1193,112,1
4451122,1593516,985,68,41669,0,42654,68,1
1652056,2707566,326,2,66845,0,67171,2,1
3361377,4374312,4841,2,761793,0,766634,2,1
4160129,4858180,30,79,453,0,483,79,1
4450642,3711396,57,6,452,0,509,6,1
3280389,194006,1101,2,411419,0,412520,2,1
3509903,1192663,1530,2,509445,0,510975,2,1
712729,1490626,28,147,195,249,223,396,1
2998026,3855153,919,1,24182,0,25101,1,1
940526,3787509,475,1,20786,0,21261,1,1
4735218,2703183,252,199,5309,0,5561,199,1
349378,1367489,72,10,583,0,655,10,1
4570464,2424612,282,36,2968,0,3250,36,1
4417253,1877356,1130,44,68389,0,69519,44,1
4140279,562508,337,1,49384,0,49721,1,1
948375,3984427,113,22,4186,0,4299,22,1
2262193,425679,48,24,374,0,422,24,1
981464,4453441,38,1,291,0,329,1,1
1545237,2063209,381,132,14327,0,14708,132,1
323258,4165655,50,95,577,0,627,95,1
1023621,2851612,103,37,1104,0,1207,37,1
961349,1209442,154,36,5849,0,6003,36,1
3509903,3750580,1530,2,509445,0,510975,2,1
2597909,1392238,251,4,1527,0,1778,4,1
1533314,2441425,361,803,6007,18561,6368,19364,1
1124240,3468959,60,20,1040,0,1100,20,1
3384159,481761,415,10,6659,0,7074,10,1
2981537,3610690,1252,2,118718,0,119970,2,1
2516076,4021273,1455,15,77782,0,79237,15,1
4830192,3483305,78,860,1935,41,2013,901,1
2333372,3699724,35,12,350,0,385,12,1
3140664,3505947,268,143,16099,0,16367,143,1
2277070,1993683,751,4,4932,0,5683,4,1
2569009,1400621,424,106,13423,0,13847,106,1
1139873,4546507,670,59,10236,0,10906,59,1
4137391,1997953,109,99,88,79,197,178,1
2897926,2053070,565,269,25983,0,26548,269,1
2553405,3781889,568,67,12913,0,13481,67,1
2343253,4397055,1882,1,86401,0,88283,1,1
3235479,4644675,999,40,66486,0,67485,40,1
765601,2001204,1485,10,101510,0,102995,10,1
2669216,916849,280,28,1050,0,1330,28,1
3579205,4131384,4,7,88,0,92,7,1
3509903,2109169,1530,1,509445,0,510975,1,1
1545237,3319020,381,53,14327,0,14708,53,1
3298300,4487900,128,125,4498,0,4626,125,1
2851109,1939286,450,3,98552,0,99002,3,1
1022123,2935557,126,4,8212,0,8338,4,1
2851109,258030,450,2,98552,0,99002,2,1
3361377,1784987,4841,16,761793,0,766634,16,1
3671141,2875775,1444,176,48400,0,49844,176,1
4191410,1876130,1590,95,96434,0,98024,95,1
1281708,1561407,106,144,1629,0,1735,144,1
2950311,1978298,807,33,85116,0,85923,33,1
932720,517992,1411,63,111323,0,112734,63,1
1738725,863014,46,2,291,0,337,2,1
4191410,396081,1590,36,96434,0,98024,36,1
448517,3313677,625,7,12450,0,13075,7,1
3907996,3806299,485,206,18964,0,19449,206,1
4272102,3246482,1608,131,104171,0,105779,131,1
4192206,3535016,468,56,18229,0,18697,56,1
2772113,4409027,792,37,42907,0,43699,37,1
3081778,4386011,211,40,1969,80,2180,120,1
483251,204061,154,1,5257,0,5411,1,1
3509903,4323658,1530,1,509445,0,510975,1,1
3361377,4150268,4841,1,761793,0,766634,1,1
4417253,194976,1130,28,68389,0,69519,28,1
3683235,297992,311,11,23110,0,23421,11,1
3517811,1615023,60,1,11929,0,11989,1,1
3065808,929642,1235,78,82317,0,83552,78,1
4209323,2354329,1630,34,89460,0,91090,34,1
912467,1293126,51,20,1317,0,1368,20,1
2123018,734991,15,6,315,0,330,6,1
3989108,3127138,372,22,7033,0,7405,22,1
2945411,2582799,15,180,136,0,151,180,1
3275914,1688477,20,12,291,0,311,12,1
3918313,1471685,146,1681,915,25550,1061,27231,1
765601,3172470,1485,8,101510,0,102995,8,1
338194,3232820,73,644,552,0,625,644,1
2677334,4605405,377,50,6774,0,7151,50,1
1615261,4638720,955,1,12715,0,13670,1,1
1580988,4650905,2821,2,400133,0,402954,2,1
4198771,106555,207,2,8543,0,8750,2,1
3514277,2641131,1338,59,13269,100,14607,159,1
3438576,3878813,3424,16,137753,0,141177,16,1
923454,4399281,125,158,2422,0,2547,158,1
2342664,2907299,1181,136,26502,0,27683,136,1
2046124,1997406,289,71,1436,0,1725,71,1
226540,3662587,463,23,10650,0,11113,23,1
941509,4247587,106,5,3066,0,3172,5,1
3065808,2659152,1235,163,82317,0,83552,163,1
1189314,4799621,229,11,2366,0,2595,11,1
1140134,1254451,311,11,11111,0,11422,11,1
1875,4039456,656,15,61388,0,62044,15,1
1966548,2955180,208,1,53149,0,53357,1,1
2261139,3164117,2014,114,42851,1234,44865,1348,1
2309618,1391752,980,45,5354,0,6334,45,1
4782707,1637866,513,112,31665,0,32178,112,1
4437944,1716315,262,15,3324,0,3586,15,1
4552666,2105201,341,159,9279,0,9620,159,1
846208,4444230,600,29,17288,0,17888,29,1
3396719,4202432,660,598,8141,0,8801,598,1
4574571,2680309,186,157,6965,0,7151,157,1
4084348,3605448,38,202,243,2022,281,2224,1
1580988,415807,2821,1,400133,0,402954,1,1
2255162,3172913,92,5,1209,0,1301,5,1
3294702,1051464,991,18,68888,0,69879,18,1
3280389,3658642,1101,1,411419,0,412520,1,1
2144660,3665001,427,160,3108,0,3535,160,1
593740,1579784,1107,102,62807,0,63914,102,1
4751453,4508524,520,7,27570,0,28090,7,1
3836080,4722144,1197,10,59457,0,60654,10,1
1103332,1054343,732,3,59415,0,60147,3,1
2827436,1220459,882,2,271525,0,272407,2,1
3280389,925912,1101,1,411419,0,412520,1,1
1512714,3091010,253,178,6663,0,6916,178,1
2057864,3730678,307,80,3995,0,4302,80,1
1171914,2326736,2431,44,795,0,3226,44,1
781211,1412546,976,6,51781,0,52757,6,1
4183784,2015460,931,61,59894,0,60825,61,1
3361377,4672871,4841,43,761793,0,766634,43,1
427805,4639436,483,1,156906,0,157389,1,1
532681,3548032,433,82,35023,0,35456,82,1
439557,387396,2090,18,61744,0,63834,18,1
1880135,4142378,810,115,71924,0,72734,115,1
3501482,463049,522,61,28046,0,28568,61,1
3179838,1209578,56,2,201,0,257,2,1
2772113,3621057,792,18,42907,0,43699,18,1
141067,4715972,432,247,2002,0,2434,247,1
4492248,300239,237,254,17127,560,17364,814,1
2516076,3117426,1455,44,77782,0,79237,44,1
4360960,3592003,1642,106,110084,0,111726,106,1
3323519,4358110,133,1,4787,0,4920,1,1
3638272,3496935,2022,6,370904,0,372926,6,1
1534362,4445257,1531,88,105859,0,107390,88,1
4264630,1338656,9,5,47,0,56,5,1
4299641,3494785,44,1253,528,539,572,1792,1
4183784,148762,931,35,59894,0,60825,35,1
3914135,4299416,2152,28,60084,0,62236,28,1
2955381,4527983,70,426,736,0,806,426,1
3112136,728301,406,1,41366,0,41772,1,1
2853969,2615328,1051,1,42591,0,43642,1,1
4738916,494036,1165,29,34124,0,35289,29,1
4738916,2042540,1165,42,34124,0,35289,42,1
4313572,504704,930,31,16971,0,17901,31,1
1611386,2907437,187,42,10932,0,11119,42,1
1588705,183132,1000,370,11879,2556,12879,2926,1
2147720,833442,1608,29,78786,0,80394,29,1
3002746,3670959,286,20,3847,0,4133,20,1
4593330,1939526,203,35,8083,0,8286,35,1
4801471,718890,585,53,17979,0,18564,53,1
2580348,3071706,164,86,1662,0,1826,86,1
915390,4272102,1345,1608,5262,104171,6607,105779,1
1653268,2542316,183,9,5919,0,6102,9,1
2248686,357199,168,143,1937,0,2105,143,1
1806130,1024152,15,1,76,0,91,1,1
1503116,3214695,415,32,37079,0,37494,32,1
1807330,2266740,62,234,1136,0,1198,234,1
1534362,3568424,1531,56,105859,0,107390,56,1
3361377,476593,4841,1,761793,0,766634,1,1
3438576,2553700,3424,4,137753,0,141177,4,1
1880135,741412,810,1,71924,0,72734,1,1
1580988,1036640,2821,3,400133,0,402954,3,1
4269895,1592664,123,113,1039,0,1162,113,1
1127093,1049495,554,102,6014,0,6568,102,1
1201711,3201609,357,89,15948,0,16305,89,1
1276253,1148552,407,1,46534,0,46941,1,1
4011264,54203,1360,45,116777,0,118137,45,1
2872979,4148889,341,30,28510,0,28851,30,1
309445,4331495,33,58,99,331,132,389,1
1563315,289918,23,551,142,369,165,920,1
3674250,3300865,155,498,2204,0,2359,498,1
4416945,4561171,417,119,33228,0,33645,119,1
3438576,4851488,3424,16,137753,0,141177,16,1
2621271,2063929,82,75,350,0,432,75,1
1063358,3963108,1350,46,63494,0,64844,46,1
1054898,4257769,33,189,1374,0,1407,189,1
842398,1565330,115,136,2280,0,2395,136,1
1301815,2505241,752,70,48944,0,49696,70,1
2827436,4404258,882,1,271525,0,272407,1,1
808896,4599134,35,62,519,42,554,104,1
2637259,404160,151,15,3592,0,3743,15,1
4297498,1624437,55,11,1240,0,1295,11,1
4191410,4096213,1590,60,96434,0,98024,60,1
310708,1734816,83,159,1665,2395,1748,2554,1
3910508,3826087,16,3,936,0,952,3,1
1575009,233525,429,1,37745,0,38174,1,1
4411870,4760069,948,12,60517,0,61465,12,1
2827436,665661,882,1,271525,0,272407,1,1
1179906,4604363,316,180,14467,0,14783,180,1
4011264,1902864,1360,13,116777,0,118137,13,1
2342664,2277433,1181,35,26502,0,27683,35,1
2961801,2811350,1483,51,101962,0,103445,51,1
1539837,879994,1127,214,62979,0,64106,214,1
1249227,4578783,621,4,7423,0,8044,4,1
3509903,1809435,1530,4,509445,0,510975,4,1
3549674,1397227,602,74,38542,0,39144,74,1
196521,3610365,1176,127,11269,0,12445,127,1
4524163,4196618,81,33,477,0,558,33,1
381300,2483056,114,126,1986,0,2100,126,1
1580508,1973862,720,26,19611,0,20331,26,1
4649206,3286643,566,1,31367,0,31933,1,1
1880135,2404979,810,6,71924,0,72734,6,1
725974,3582102,83,2,2505,0,2588,2,1
1063857,2815264,248,54,15849,0,16097,54,1
55855,53275,245,36,5888,0,6133,36,1
628351,1004260,333,3,4229,0,4562,3,1
3361377,50880,4841,1,761793,0,766634,1,1
43834,529670,132,17,731,69,863,86,1
2827436,100456,882,32,271525,0,272407,32,1
3638272,1964256,2022,1,370904,0,372926,1,1
4342519,1415177,138,65,11317,0,11455,65,1
1615261,822950,955,74,12715,0,13670,74,1
354904,456154,3193,48,105780,581,108973,629,1
2101215,4100419,128,69,1547,0,1675,69,1
3936039,572791,799,4,23884,0,24683,4,1
1250021,2143898,4637,26,85913,0,90550,26,1
26760,4440160,179,736,2100,20522,2279,21258,1
755739,816655,1117,53,58043,0,59160,53,1
3361377,4722664,4841,1,761793,0,766634,1,1
4238001,374554,869,3,61161,0,62030,3,1
1051108,2110232,262,100,7542,809,7804,909,1
4035655,2228540,913,3,5979,0,6892,3,1
2950311,2897074,807,152,85116,0,85923,152,1
3294702,987397,991,84,68888,0,69879,84,1
1723506,3043695,733,30,21835,0,22568,30,1
2503097,709454,414,56,3628,0,4042,56,1
307250,4198136,919,2,35588,0,36507,2,1
2650412,2024592,931,6,29038,0,29969,6,1
2956248,1658483,346,134,6702,0,7048,134,1
2861639,774698,481,9,10848,0,11329,9,1
515290,1944959,285,3,34080,0,34365,3,1
2343253,4571096,1882,1,86401,0,88283,1,1
1103332,529644,732,129,59415,0,60147,129,1
1381310,4757858,51,1,280,0,331,1,1
532681,2300418,433,37,35023,0,35456,37,1
1664942,4086714,176,123,2000,0,2176,123,1
2441425,3926598,803,211,18561,0,19364,211,1
3361377,3624088,4841,1,761793,0,766634,1,1
1875,1357723,656,35,61388,0,62044,35,1
3736196,886546,159,904,1349,1080,1508,1984,1
2751572,3573036,481,40,44036,0,44517,40,1
4417253,2485817,1130,64,68389,0,69519,64,1
3361377,892109,4841,1,761793,0,766634,1,1
4191410,243547,1590,80,96434,0,98024,80,1
1847461,1402928,1211,170,51149,0,52360,170,1
376238,2298163,91,4,289,0,380,4,1
1242225,1626906,145,70,1469,0,1614,70,1
2464401,3282171,577,65,23681,0,24258,65,1
3793936,3063505,258,284,2342,0,2600,284,1
3509903,1899024,1530,2,509445,0,510975,2,1
1580988,533358,2821,5,400133,0,402954,5,1
4114692,4809678,113,29,1885,0,1998,29,1
2949409,4807002,175,4,2185,0,2360,4,1
1416419,3254825,401,67,2098,0,2499,67,1
1968010,1574902,786,105,10371,0,11157,105,1
3144238,857054,326,77,28455,0,28781,77,1
3316620,4225288,214,4,5083,0,5297,4,1
3438576,3688122,3424,16,137753,0,141177,16,1
1063358,618260,1350,26,63494,0,64844,26,1
1937293,4026038,434,47,16761,0,17195,47,1
3845119,2005007,461,25,28609,0,29070,25,1
4864826,3170145,10,2,157,0,167,2,1
354788,4058438,203,26,5964,0,6167,26,1
1534362,4648229,1531,32,105859,0,107390,32,1
1094821,2118154,223,128,2745,0,2968,128,1
1521082,4158987,766,6,6562,0,7328,6,1
3361377,2963361,4841,1,761793,0,766634,1,1
3157597,4658051,183,1,10247,0,10430,1,1
4238001,1877256,869,20,61161,0,62030,20,1
3907996,4506170,485,67,18964,0,19449,67,1
544230,3255442,1532,12,60768,0,62300,12,1
4054996,3881634,117,641,221,8471,338,9112,1
3094886,1425829,675,44,6621,0,7296,44,1
551730,406645,25,25,1271,0,1296,25,1
2260014,2907801,2466,217,98622,0,101088,217,1
2075015,1551835,2664,85,85781,0,88445,85,1
2311472,1345736,91,341,2259,0,2350,341,1
2307868,785118,1131,5,38777,0,39908,5,1
312275,3569531,21,61,1114,0,1135,61,1
1591435,3191927,387,122,31245,0,31632,122,1
3633019,2463096,746,50,32317,0,33063,50,1
3227850,1123713,191,33,641,0,832,33,1
3586713,4207865,51,110,564,0,615,110,1
745032,1900619,510,133,3189,0,3699,133,1
4417253,3689924,1130,111,68389,0,69519,111,1
2981537,1943836,1252,3,118718,0,119970,3,1
4360960,1177581,1642,16,110084,0,111726,16,1
4692327,2083300,149,34,2092,0,2241,34,1
2092359,874584,421,21,26936,0,27357,21,1
1968010,3936960,786,124,10371,0,11157,124,1
755739,1715561,1117,13,58043,0,59160,13,1
2267633,4640551,422,106,13247,0,13669,106,1
4411870,432735,948,69,60517,0,61465,69,1
681618,2713017,75,2,8789,0,8864,2,1
1503116,4459355,415,53,37079,0,37494,53,1
61085,3088957,159,146,1809,366,1968,512,1
4782707,4426730,513,44,31665,0,32178,44,1
3157597,2528270,183,35,10247,0,10430,35,1
1735116,1067092,503,425,16146,0,16649,425,1
595757,4548251,340,59,26738,0,27078,59,1
2985909,2743394,706,118,43348,0,44054,118,1
401947,3353895,367,28,7890,0,8257,28,1
1875,1256808,656,222,61388,0,62044,222,1
42654,3112519,97,28,1166,0,1263,28,1
3954325,4586218,1743,47,16616,444,18359,491,1
427805,441206,483,1,156906,0,157389,1,1
250177,4689999,330,12,3969,0,4299,12,1
4423184,3734355,384,70,29809,0,30193,70,1
2989110,981514,1042,148,19283,0,20325,148,1
3514791,3263148,254,174,2148,2060,2402,2234,1
2260014,2219907,2466,1,98622,0,101088,1,1
2380608,2100736,360,23,3399,0,3759,23,1
2311271,1250021,44,4637,212,85913,256,90550,1
2403192,2905702,163,28,5302,0,5465,28,1
4492248,3448355,237,46,17127,0,17364,46,1
3280389,2454284,1101,1,411419,0,412520,1,1
1880135,4575154,810,55,71924,0,72734,55,1
636814,3577318,116,25,9387,0,9503,25,1
933859,932720,206,1411,1051,111323,1257,112734,1
805360,1170504,1514,117,119306,0,120820,117,1
708440,2812526,302,6,9329,0,9631,6,1
4460077,1717224,142,170,1071,0,1213,170,1
3768155,1503847,3,54,21,0,24,54,1
3225310,2165129,320,6,10537,0,10857,6,1
4708541,759605,981,18,15678,0,16659,18,1
3361771,149330,113,2,770,0,883,2,1
2343253,1074747,1882,85,86401,0,88283,85,1
3280389,1099247,1101,1,411419,0,412520,1,1
2772113,3978741,792,142,42907,0,43699,142,1
1325245,222688,144,97,5103,0,5247,97,1
1580988,631547,2821,1,400133,0,402954,1,1
2981537,1896647,1252,1,118718,0,119970,1,1
3683235,2906650,311,1,23110,0,23421,1,1
50614,1831524,253,52,2444,0,2697,52,1
4619326,2269862,539,75,22721,0,23260,75,1
4319972,1655605,640,54,35279,0,35919,54,1
502082,833104,589,2,16428,0,17017,2,1
708440,2194599,302,14,9329,0,9631,14,1
3836080,2279834,1197,37,59457,0,60654,37,1
716189,879212,85,16,2000,0,2085,16,1
805360,2985167,1514,19,119306,0,120820,19,1
4374509,1822410,770,6,9940,0,10710,6,1
4680723,3911593,69,6,961,0,1030,6,1
4485028,1434061,445,103,14565,0,15010,103,1
1364801,2337656,450,471,4704,0,5154,471,1
646587,4695694,122,40,5819,0,5941,40,1
3253532,1715758,84,43,276,0,360,43,1
796130,4140401,22,3,1456,0,1478,3,1
74861,3071220,56,9,459,0,515,9,1
4517163,3273499,13,82,1020,0,1033,82,1
1919631,4391511,185,48,2750,0,2935,48,1
837553,2301084,1249,16,61665,0,62914,16,1
2278719,4431832,107,55,786,287,893,342,1
3222140,1336627,389,201,557,0,946,201,1
1503116,4621822,415,165,37079,0,37494,165,1
3271898,2492883,227,54,2028,0,2255,54,1
2950311,3756013,807,30,85116,0,85923,30,1
3361377,2249089,4841,7,761793,0,766634,7,1
2307868,4174471,1131,1,38777,0,39908,1,1
2189067,4501367,356,2,6408,0,6764,2,1
1880135,3487028,810,23,71924,0,72734,23,1
2516076,146211,1455,67,77782,0,79237,67,1
866357,4598923,825,79,18479,0,19304,79,1
4274115,904329,145,3,1025,0,1170,3,1
4850593,2181287,169,91,4365,0,4534,91,1
499918,3936460,36,9,311,0,347,9,1
3361377,4765047,4841,1,761793,0,766634,1,1
805360,922837,1514,17,119306,0,120820,17,1
4178055,4838794,260,80,8186,0,8446,80,1
18762,2573625,82,1,1159,0,1241,1,1
716189,628202,85,6,2000,0,2085,6,1
3271484,4862272,1507,39,34093,0,35600,39,1
1503116,2862167,415,130,37079,0,37494,130,1
912470,4609979,30,1,438,0,468,1,1
3115867,3401439,1350,1,61232,0,62582,1,1
3509903,460623,1530,1,509445,0,510975,1,1
1706005,4391971,31,66,446,0,477,66,1
2522799,2744944,253,274,3062,375,3315,649,1
2887240,4126638,1143,2,118405,0,119548,2,1
687713,4674442,436,18,47160,0,47596,18,1
471706,2748706,794,237,65616,0,66410,237,1
4653941,3208614,951,1,45883,0,46834,1,1
1276425,2214381,102,1,8318,0,8420,1,1
3361377,4815133,4841,7,761793,0,766634,7,1
4360960,1869497,1642,66,110084,0,111726,66,1
1534362,56423,1531,54,105859,0,107390,54,1
2981537,3046473,1252,1,118718,0,119970,1,1
1580988,1099564,2821,1,400133,0,402954,1,1
1053923,1322901,490,236,4567,0,5057,236,1
1652056,2843839,326,1,66845,0,67171,1,1
1201711,2351660,357,256,15948,0,16305,256,1
2755798,870790,494,6,24862,0,25356,6,1
805360,2912821,1514,31,119306,0,120820,31,1
3361377,3004695,4841,1,761793,0,766634,1,1
3992144,1075515,402,3,23683,0,24085,3,1
2879897,2081048,164,3,3212,0,3376,3,1
3460440,1998964,193,353,1134,0,1327,353,1
4680108,4316751,49,31,1965,0,2014,31,1
2938068,2594719,112,114,4178,0,4290,114,1
2911269,2114721,740,113,20606,0,21346,113,1
4467395,2961833,2084,20,14574,0,16658,20,1
3944761,4140712,590,106,138,235,728,341,1
3610598,2246131,380,102,17343,0,17723,102,1
1580988,4664751,2821,3,400133,0,402954,3,1
4624595,735813,722,25,53368,0,54090,25,1
1814268,1621350,59,4,4650,0,4709,4,1
522588,1097182,496,75,20091,0,20587,75,1
1580988,2295614,2821,1,400133,0,402954,1,1
3914135,491562,2152,9,60084,0,62236,9,1
860993,3725343,64,8,370,0,434,8,1
3280389,4857789,1101,2,411419,0,412520,2,1
2405789,2535244,1010,8,93387,0,94397,8,1
4435044,2062852,228,34,1042,0,1270,34,1
3995686,3975999,113,1,6154,0,6267,1,1
3094886,1865747,675,432,6621,0,7296,432,1
4751453,4024600,520,78,27570,0,28090,78,1
1847461,571423,1211,17,51149,0,52360,17,1
3561502,2082328,1144,41,68800,0,69944,41,1
863215,697974,199,40,1158,0,1357,40,1
4411870,3855228,948,57,60517,0,61465,57,1
3115867,1893345,1350,30,61232,0,62582,30,1
2483991,2647601,161,21,74,0,235,21,1
1591435,128509,387,28,31245,0,31632,28,1
2599181,230289,116,138,632,335,748,473,1
307250,775593,919,1,35588,0,36507,1,1
2490914,767350,570,10,22965,0,23535,10,1
4713062,3383422,191,74,37,0,228,74,1
4099305,3872710,118,112,5174,0,5292,112,1
4167572,136076,81,1,6924,0,7005,1,1
3549674,105495,602,225,38542,0,39144,225,1
3004174,3978195,258,10,5546,0,5804,10,1
1817799,442332,402,104,15932,0,16334,104,1
3721550,1967863,188,111,14527,0,14715,111,1
2591754,2140739,70,149,285,87,355,236,1
1339664,4801182,228,354,6682,0,6910,354,1
530200,133175,2035,2,62809,0,64844,2,1
1293807,4150812,1837,45,30865,0,32702,45,1
544230,2479596,1532,46,60768,0,62300,46,1
4593330,3672105,203,22,8083,0,8286,22,1
3638272,720187,2022,1,370904,0,372926,1,1
1232882,2801471,75,22,6386,0,6461,22,1
4406687,2183207,44,1,1022,0,1066,1,1
1580988,85366,2821,2,400133,0,402954,2,1
1723506,300524,733,172,21835,0,22568,172,1
1455058,219359,129,8,3856,0,3985,8,1
3569179,3344742,1064,318,40015,0,41079,318,1
408965,4547204,903,154,38623,0,39526,154,1
831272,1170856,76,4,2383,0,2459,4,1
64357,4012631,309,7,6329,0,6638,7,1
1847461,2016312,1211,30,51149,0,52360,30,1
1580988,4483903,2821,1,400133,0,402954,1,1
3395938,1752388,546,8,39878,0,40424,8,1
1580988,1239360,2821,1,400133,0,402954,1,1
2827436,4688694,882,1,271525,0,272407,1,1
408965,3844858,903,1591,38623,28974,39526,30565,1
3059686,4400966,460,5,4530,0,4990,5,1
3835978,3810977,45,63,143,0,188,63,1
1887709,4650324,217,33,28983,0,29200,33,1
1196844,1627800,548,3035,36289,3,36837,3038,1
2934549,4794435,255,10,2836,0,3091,10,1
1533314,2580629,361,149,6007,0,6368,149,1
4054733,338194,217,73,1907,552,2124,625,1
1437646,4152494,253,568,1753,138,2006,706,1
2343253,2762913,1882,20,86401,0,88283,20,1
882198,2132646,18,14,379,0,397,14,1
4744878,1571866,68,436,1896,0,1964,436,1
3966421,637459,104,11,1999,0,2103,11,1
3509903,2618237,1530,1,509445,0,510975,1,1
4269895,3879485,123,9,1039,0,1162,9,1
3070849,2619523,83,100,2913,0,2996,100,1
2985909,2277681,706,180,43348,0,44054,180,1
3361377,2977440,4841,59,761793,0,766634,59,1
3638272,2731511,2022,96,370904,0,372926,96,1
4846817,1421968,76,3,5055,0,5131,3,1
1091128,3182259,88,716,1720,0,1808,716,1
431086,3786478,619,52,14910,0,15529,52,1
4731849,1874354,455,43,10886,0,11341,43,1
2405789,2684808,1010,111,93387,0,94397,111,1
4189798,4061273,140,143,1874,2219,2014,2362,1
354904,1781624,3193,4,105780,0,108973,4,1
2095514,4376912,45,115,997,0,1042,115,1
4782707,2782115,513,14,31665,0,32178,14,1
3549674,4647561,602,516,38542,0,39144,516,1
584906,2784723,253,169,6639,0,6892,169,1
268844,1460314,422,211,5070,0,5492,211,1
55855,2146046,245,89,5888,0,6133,89,1
1831198,1473127,450,21,5884,0,6334,21,1
3730188,4097918,16,1,112,0,128,1,1
4517163,4785679,13,2,1020,0,1033,2,1
354788,494155,203,117,5964,0,6167,117,1
595757,3353681,340,78,26738,0,27078,78,1
401947,2118539,367,614,7890,0,8257,614,1
3088798,1561284,5,322,38,0,43,322,1
3509903,901164,1530,1,509445,0,510975,1,1
3672238,1301181,518,45,12172,0,12690,45,1
1341178,1877650,899,57,16829,0,17728,57,1
3509903,3289193,1530,1,509445,0,510975,1,1
1103332,323722,732,11,59415,0,60147,11,1
2985909,2696566,706,4,43348,0,44054,4,1
1446824,1965285,569,55,4958,0,5527,55,1
2851109,51310,450,134,98552,0,99002,134,1
2818749,1067800,92,125,3797,0,3889,125,1
455994,1781921,95,18,2615,0,2710,18,1
3235358,3832364,6,1353,55,0,61,1353,1
4360960,3015822,1642,23,110084,0,111726,23,1
1069020,243754,85,47,1408,0,1493,47,1
3705070,2884346,740,77,14938,0,15678,77,1
4272102,1616492,1608,310,104171,5893,105779,6203,1
4416945,2072770,417,18,33228,0,33645,18,1
1577162,1002896,71,9,1118,0,1189,9,1
3115867,4764985,1350,1,61232,0,62582,1,1
3137585,374061,1196,35,77354,0,78550,35,1
4209323,4164877,1630,13,89460,0,91090,13,1
1913862,1464639,358,86,4027,0,4385,86,1
4191410,48788,1590,152,96434,0,98024,152,1
3361377,2364375,4841,1,761793,0,766634,1,1
3691520,1230099,533,48,9121,0,9654,48,1
1785615,1055046,153,86,2575,0,2728,86,1
3561502,1190315,1144,43,68800,0,69944,43,1
2281149,4753146,282,785,28082,0,28364,785,1
2827436,2400418,882,1,271525,0,272407,1,1
2772552,4143899,135,8,300,0,435,8,1
3954325,1197121,1743,1,16616,0,18359,1,1
593740,2854169,1107,35,62807,0,63914,35,1
4624595,1616639,722,35,53368,0,54090,35,1
2877907,4521476,508,15,16021,0,16529,15,1
2897926,3350363,565,2,25983,0,26548,2,1
4520526,3679080,33,2,1224,0,1257,2,1
4191410,1019689,1590,108,96434,0,98024,108,1
3123201,3707356,126,515,5539,0,5665,515,1
92352,2205389,1138,4,20575,0,21713,4,1
3638272,3281677,2022,1,370904,0,372926,1,1
4295952,1295653,808,55,57369,0,58177,55,1
1611386,2854575,187,33,10932,0,11119,33,1
3364157,825436,6,5,1705,0,1711,5,1
3638272,145435,2022,4,370904,0,372926,4,1
3765475,77338,873,3,107914,0,108787,3,1
3509903,2252831,1530,1,509445,0,510975,1,1
4188662,519776,42,3,642,0,684,3,1
3839956,4479370,183,702,1443,0,1626,702,1
3437068,692162,295,3,1597,0,1892,3,1
4279508,4852139,35,12,82,0,117,12,1
1580988,2804975,2821,2,400133,0,402954,2,1
765601,1244208,1485,14,101510,0,102995,14,1
2751572,2551230,481,28,44036,0,44517,28,1
1006975,3290598,14,7,113,0,127,7,1
2897926,83934,565,376,25983,0,26548,376,1
3638272,2043729,2022,9,370904,0,372926,9,1
1759782,1318770,173,4,862,0,1035,4,1
996752,416281,173,489,3538,0,3711,489,1
595757,25291,340,172,26738,0,27078,172,1
448517,1284668,625,116,12450,0,13075,116,1
1276253,949771,407,1,46534,0,46941,1,1
3936039,3784483,799,20,23884,0,24683,20,1
837553,4715972,1249,247,61665,0,62914,247,1
3764177,1199056,1036,116,64563,0,65599,116,1
1927211,3571937,1668,80,113322,0,114990,80,1
1927211,3080483,1668,91,113322,0,114990,91,1
2961801,2598763,1483,15,101962,0,103445,15,1
269982,2006557,351,11,9019,0,9370,11,1
92352,1128191,1138,85,20575,0,21713,85,1
2948092,1404336,412,2,18486,0,18898,2,1
3501482,4705333,522,4,28046,0,28568,4,1
3645034,1609338,102,12,1041,0,1143,12,1
2110232,4378532,100,883,809,0,909,883,1
2722942,4739810,240,32,8655,0,8895,32,1
1534362,1729004,1531,23,105859,0,107390,23,1
3280389,2836212,1101,1,411419,0,412520,1,1
3115867,1258437,1350,1,61232,0,62582,1,1
1250021,184173,4637,50,85913,0,90550,50,1
3361377,2049550,4841,1,761793,0,766634,1,1
1983211,2044668,136,112,1225,1553,1361,1665,1
3638272,3713775,2022,1,370904,0,372926,1,1
4708541,853313,981,156,15678,0,16659,156,1
439557,1884882,2090,49,61744,0,63834,49,1
2751572,816629,481,230,44036,0,44517,230,1
471706,3808024,794,1,65616,0,66410,1,1
1103332,626471,732,5,59415,0,60147,5,1
3167388,2087301,203,53,9760,0,9963,53,1
3824547,4461851,1075,2,14337,0,15412,2,1
1937293,2731799,434,319,16761,0,17195,319,1
3509903,1395060,1530,1,509445,0,510975,1,1
354904,3298867,3193,27,105780,0,108973,27,1
765601,2342187,1485,87,101510,0,102995,87,1
755739,1228675,1117,107,58043,0,59160,107,1
3438576,756078,3424,39,137753,0,141177,39,1
3361377,3404207,4841,2,761793,0,766634,2,1
4624595,1763808,722,373,53368,0,54090,373,1
3144238,1160141,326,52,28455,0,28781,52,1
3333510,1576860,26,85,63,0,89,85,1
1234540,1598226,1071,5,75251,0,76322,5,1
3638272,2158446,2022,2,370904,0,372926,2,1
3509903,3003578,1530,1,509445,0,510975,1,1
1034814,2500067,117,216,3359,0,3476,216,1
1580988,2537033,2821,4,400133,0,402954,4,1
3638272,4175035,2022,22,370904,0,372926,22,1
646587,4114149,122,2,5819,0,5941,2,1
2981537,1443346,1252,3,118718,0,119970,3,1
3873128,2588973,96,41,3581,0,3677,41,1
1293807,509385,1837,19,30865,0,32702,19,1
2109216,4649206,386,566,4712,31367,5098,31933,1
262893,3448553,161,239,3792,380,3953,619,1
1196844,2859496,548,70,36289,0,36837,70,1
1792987,2341684,97,90,3867,0,3964,90,1
765601,3990603,1485,27,101510,0,102995,27,1
522588,3636343,496,2,20091,0,20587,2,1
3449530,96758,717,62,73648,0,74365,62,1
3734245,357199,915,143,34965,0,35880,143,1
1355114,4637527,47,2,2747,0,2794,2,1
1913445,187058,564,14,47943,0,48507,14,1
4245253,3029199,14,967,242,0,256,967,1
3561502,2415309,1144,56,68800,0,69944,56,1
3318434,2453173,55,46,1995,0,2050,46,1
4417253,226766,1130,139,68389,0,69519,139,1
1580988,2233083,2821,2,400133,0,402954,2,1
2696500,4389472,267,221,4128,0,4395,221,1
3872736,478036,258,5,12660,0,12918,5,1
2021745,1464275,72,54,2948,0,3020,54,1
2247463,3077752,388,803,2747,0,3135,803,1
3732555,956530,171,90,1363,0,1534,90,1
866357,2830393,825,113,18479,0,19304,113,1
1249227,3725426,621,153,7423,0,8044,153,1
2148937,3384106,672,1,47361,0,48033,1,1
1609659,4294250,523,617,29763,0,30286,617,1
4798192,4009309,816,9,20426,0,21242,9,1
815517,1975818,312,20,4322,0,4634,20,1
3228493,3670595,19,1,2744,0,2763,1,1
2989110,3884823,1042,68,19283,0,20325,68,1
3235479,3749982,999,29,66486,0,67485,29,1
3875114,2435739,233,429,3154,0,3387,429,1
4633540,1567645,27,52,245,0,272,52,1
3361377,658235,4841,2,761793,0,766634,2,1
1196844,4786330,548,34,36289,0,36837,34,1
2998026,1073218,919,13,24182,0,25101,13,1
2529661,2547798,493,202,27309,0,27802,202,1
3115867,118298,1350,5,61232,0,62582,5,1
837553,3335479,1249,8,61665,0,62914,8,1
4238001,4267499,869,7,61161,0,62030,7,1
4167572,926920,81,3,6924,0,7005,3,1
3610598,488044,380,152,17343,0,17723,152,1
695505,2147670,98,467,2720,0,2818,467,1
6618,4661286,892,3,68849,0,69741,3,1
3624002,146031,12,1,315,0,327,1,1
2961801,1733683,1483,25,101962,0,103445,25,1
427805,4651201,483,2,156906,0,157389,2,1
873241,1591988,616,168,22633,0,23249,168,1
2948092,1550926,412,1,18486,0,18898,1,1
3638272,760996,2022,2,370904,0,372926,2,1
2514271,509738,387,182,19070,0,19457,182,1
3514277,821023,1338,529,13269,0,14607,529,1
3290983,2306093,25,155,219,0,244,155,1
2851109,4148661,450,4,98552,0,99002,4,1
3561502,3041299,1144,736,68800,0,69944,736,1
3898825,253406,116,185,401,2002,517,2187,1
1580988,3978589,2821,95,400133,0,402954,95,1
439557,965515,2090,4,61744,0,63834,4,1
3835618,361669,694,195,25433,0,26127,195,1
1471685,2389574,1681,1,25550,0,27231,1,1
522588,3877088,496,5,20091,0,20587,5,1
2381929,1469735,294,3,572,0,866,3,1
4117293,514731,39,66,34,0,73,66,1
2950311,3237572,807,209,85116,0,85923,209,1
3346033,1015488,320,37,9541,0,9861,37,1
3491692,2330326,76,129,1361,0,1437,129,1
2512040,2079934,7,22,52,0,59,22,1
3509903,4531517,1530,1,509445,0,510975,1,1
4619326,3281375,539,24,22721,0,23260,24,1
3465982,2473238,195,120,102,0,297,120,1
3764177,501842,1036,2,64563,0,65599,2,1
3449530,4481504,717,63,73648,0,74365,63,1
1293807,1243273,1837,3,30865,0,32702,3,1
2851109,2404297,450,2,98552,0,99002,2,1
1735116,1704462,503,265,16146,0,16649,265,1
3911304,962972,87,96,982,231,1069,327,1
3199242,3319300,210,295,197,0,407,295,1
3235479,889773,999,17,66486,0,67485,17,1
1395822,3520232,14,6,183,0,197,6,1
4727207,2187225,925,2,84581,0,85506,2,1
592541,3431110,132,2,6913,0,7045,2,1
1319659,3353340,200,31,520,0,720,31,1
427805,284343,483,2,156906,0,157389,2,1
258641,4435044,119,228,1182,1042,1301,1270,1
3638272,395968,2022,6,370904,0,372926,6,1
1879594,1889466,277,400,1761,0,2038,400,1
2032442,4617444,109,1,10458,0,10567,1,1
4011264,461851,1360,34,116777,0,118137,34,1
687713,42659,436,1,47160,0,47596,1,1
111922,1313650,303,50,6879,0,7182,50,1
2052485,3510047,59,91,2664,85,2723,176,1
3509903,866674,1530,2,509445,0,510975,2,1
2922002,4581843,5,2,57,0,62,2,1
2148937,4568393,672,10,47361,0,48033,10,1
522588,1320921,496,222,20091,0,20587,222,1
2514271,433060,387,66,19070,0,19457,66,1
2828183,2747895,192,30,3138,0,3330,30,1
3003173,1659825,111,327,1004,0,1115,327,1
3477930,1778776,35,50,528,0,563,50,1
3280389,4748187,1101,1,411419,0,412520,1,1
3115867,1662227,1350,7,61232,0,62582,7,1
4712782,176245,171,90,4681,0,4852,90,1
2203506,1615874,134,2,2432,0,2566,2,1
3638272,1806460,2022,1,370904,0,372926,1,1
1966548,3462248,208,1,53149,0,53357,1,1
4011264,3872280,1360,56,116777,0,118137,56,1
3765475,1698461,873,3,107914,0,108787,3,1
3206499,3024037,1337,16,32033,0,33370,16,1
370123,2334622,110,32,7231,0,7341,32,1
2280977,1251902,2,1,47,0,49,1,1
2147720,4466941,1608,54,78786,0,80394,54,1
3510150,3863202,171,137,1981,785,2152,922,1
2772113,1695794,792,15,42907,0,43699,15,1
4811103,1677541,110,43,1639,0,1749,43,1
3638272,4552361,2022,4,370904,0,372926,4,1
1655354,2584718,64,68,742,0,806,68,1
6618,4860893,892,19,68849,0,69741,19,1
2985909,3591724,706,43,43348,0,44054,43,1
2092359,4306228,421,11,26936,0,27357,11,1
4768755,3041385,259,45,1579,0,1838,45,1
3082645,4769777,932,48,1825,332,2757,380,1
3898007,2443093,10,2,21,0,31,2,1
2514271,2727916,387,89,19070,0,19457,89,1
1588330,4495193,694,55,10280,0,10974,55,1
295156,611806,33,49,188,0,221,49,1
1913445,1521318,564,19,47943,0,48507,19,1
3071504,2218803,80,314,3797,0,3877,314,1
2281149,32282,282,57,28082,0,28364,57,1
1880135,1829170,810,39,71924,0,72734,39,1
1339664,219864,228,641,6682,0,6910,641,1
137847,3023881,105,1035,192,996,297,2031,1
1196844,2380240,548,43,36289,0,36837,43,1
3257465,4532995,541,119,27614,0,28155,119,1
2879897,732670,164,31,3212,0,3376,31,1
3509903,1912934,1530,2,509445,0,510975,2,1
2961801,1267462,1483,80,101962,0,103445,80,1
1420359,2308808,56,28,361,0,417,28,1
4272102,1821089,1608,40,104171,0,105779,40,1
3995686,3077075,113,136,6154,0,6267,136,1
4069373,2441073,97,126,3470,3161,3567,3287,1
1534362,2820513,1531,130,105859,0,107390,130,1
4203262,4455672,28,4,61,0,89,4,1
3922194,3454347,175,87,1847,0,2022,87,1
1580988,2386324,2821,79,400133,0,402954,79,1
151693,2905356,436,12,12181,0,12617,12,1
1604753,4377225,78,1,3240,0,3318,1,1
4004339,3099181,153,1,6086,0,6239,1,1
408965,1024184,903,14,38623,0,39526,14,1
1966548,2905199,208,6,53149,0,53357,6,1
787416,541849,115,59,9954,0,10069,59,1
259575,3657805,260,1,13949,0,14209,1,1
3509903,3052170,1530,1,509445,0,510975,1,1
2985909,3771362,706,11,43348,0,44054,11,1
4705188,4552037,336,1,8658,0,8994,1,1
4168549,2386594,48,22,818,0,866,22,1
3638272,1980304,2022,3,370904,0,372926,3,1
940526,2717432,475,46,20786,0,21261,46,1
2182964,4355496,214,113,6975,0,7189,113,1
2044668,1415171,112,8,1553,0,1665,8,1
2075015,3876459,2664,5,85781,0,88445,5,1
99723,946038,19,300,592,301,611,601,1
1302093,978434,48,104,1219,0,1267,104,1
3451152,2047167,30,5,287,0,317,5,1
4272102,1015061,1608,27,104171,0,105779,27,1
4604311,3803089,29,1,7472,0,7501,1,1
2881894,2479694,211,16,7468,0,7679,16,1
4068910,1573130,131,52,1470,0,1601,52,1
4272102,3116056,1608,21,104171,0,105779,21,1
4408813,1941193,288,77,10077,0,10365,77,1
2457029,4574472,77,268,10427,0,10504,268,1
4738916,1718231,1165,6,34124,0,35289,6,1
2961801,4505006,1483,44,101962,0,103445,44,1
1539837,10355,1127,7,62979,0,64106,7,1
2339149,1652729,97,154,4258,0,4355,154,1
3910135,3310333,298,2,14348,0,14646,2,1
4096880,2474770,71,23,790,0,861,23,1
948768,3541806,587,8,14768,0,15355,8,1
4064346,3852907,195,42,1521,0,1716,42,1
3501482,2167006,522,137,28046,0,28568,137,1
932720,3656940,1411,54,111323,0,112734,54,1
3213789,4164822,123,43,679,124,802,167,1
2436781,2878746,689,11,9972,0,10661,11,1
3065808,123390,1235,37,82317,0,83552,37,1
805360,1573885,1514,41,119306,0,120820,41,1
1818911,3730021,425,101,2972,0,3397,101,1
3230621,4592747,355,730,1149,0,1504,730,1
4570638,1677541,29,43,261,0,290,43,1
544230,3576855,1532,47,60768,0,62300,47,1
765601,273437,1485,34,101510,0,102995,34,1
1906776,240193,63,1,1962,0,2025,1,1
3549674,633875,602,54,38542,0,39144,54,1
439557,3162668,2090,55,61744,0,63834,55,1
1185954,4013240,125,115,1646,0,1771,115,1
4846817,3512877,76,3,5055,0,5131,3,1
3756233,431332,40,39,1481,0,1521,39,1
3065808,2938342,1235,48,82317,0,83552,48,1
307250,2406011,919,5,35588,0,36507,5,1
3137585,1886983,1196,183,77354,0,78550,183,1
553041,1483204,455,394,5962,0,6417,394,1
4202576,4679530,600,3,10697,0,11297,3,1
577580,1627987,187,11,3831,0,4018,11,1
3509903,1710966,1530,1,509445,0,510975,1,1
530200,2135890,2035,28,62809,0,64844,28,1
3906136,3166599,387,7,41169,0,41556,7,1
4853234,3165275,1256,70,29554,0,30810,70,1
2827436,69262,882,1,271525,0,272407,1,1
4678416,2976930,31,114,1988,0,2019,114,1
842476,2007880,898,36,12479,0,13377,36,1
1968010,164405,786,240,10371,0,11157,240,1
4815919,182114,367,1,3361,0,3728,1,1
1580988,4824065,2821,3,400133,0,402954,3,1
1276253,1060347,407,1,46534,0,46941,1,1
1123367,2326398,387,1,3721,0,4108,1,1
2998788,3760345,3,23,1284,0,1287,23,1
370119,1824831,42,24,1057,0,1099,24,1
1103332,4205919,732,70,59415,0,60147,70,1
3598452,2161367,49,4,329,0,378,4,1
2774493,4689802,551,18,12712,0,13263,18,1
4642569,2522413,872,28,27586,0,28458,28,1
3638272,4325994,2022,36,370904,0,372926,36,1
3914135,978267,2152,68,60084,0,62236,68,1
474137,1314826,330,7,246,0,576,7,1
354904,2794852,3193,27,105780,0,108973,27,1
837553,2481072,1249,335,61665,0,62914,335,1
1847461,4034381,1211,57,51149,0,52360,57,1
3854592,1672290,108,1,3483,0,3591,1,1
805360,3655925,1514,6,119306,0,120820,6,1
932720,4307879,1411,28,111323,0,112734,28,1
1103332,2325159,732,18,59415,0,60147,18,1
4183784,4212430,931,27,59894,0,60825,27,1
515537,3341342,74,7,1883,0,1957,7,1
6618,1941193,892,77,68849,0,69741,77,1
232646,2947067,321,47,1741,0,2062,47,1
3638272,2877907,2022,508,370904,16021,372926,16529,1
1639434,4637235,587,36,8053,0,8640,36,1
4060074,3248852,178,41,7305,0,7483,41,1
4274115,915065,145,41,1025,0,1170,41,1
2827436,3550252,882,1,271525,0,272407,1,1
4705188,67953,336,40,8658,0,8994,40,1
3408985,197599,205,56,6002,0,6207,56,1
4286284,1959637,272,2,1571,0,1843,2,1
4167572,475491,81,6,6924,0,7005,6,1
3987684,963967,286,4,17372,0,17658,4,1
849756,57315,91,30,531,0,622,30,1
481603,1952594,243,82,2118,0,2361,82,1
354904,2649270,3193,99,105780,0,108973,99,1
4723320,899888,250,35,915,0,1165,35,1
1212079,2867788,61,1,1208,0,1269,1,1
3361377,4319618,4841,1,761793,0,766634,1,1
2307868,4842086,1131,53,38777,0,39908,53,1
3242275,1329780,551,783,17400,0,17951,783,1
4249273,3667074,225,909,3063,0,3288,909,1
3361377,522742,4841,3,761793,0,766634,3,1
1310800,2029298,200,32,6100,0,6300,32,1
3924296,4144298,104,2,1326,0,1430,2,1
770399,4134096,242,20,113,0,355,20,1
3361377,1644305,4841,3,761793,0,766634,3,1
2514271,2784723,387,169,19070,0,19457,169,1
3361377,3429253,4841,1,761793,0,766634,1,1
471706,1845934,794,1,65616,0,66410,1,1
1999174,4148124,493,5,2435,0,2928,5,1
2477256,2424387,1124,326,7025,0,8149,326,1
1284483,3781188,25,7,215,0,240,7,1
3257653,2772120,100,8,5222,0,5322,8,1
3361377,2268764,4841,2,761793,0,766634,2,1
1534362,1865364,1531,33,105859,0,107390,33,1
3131838,3124835,107,41,1225,0,1332,41,1
4417253,1826387,1130,370,68389,0,69519,370,1
765601,1947781,1485,11,101510,0,102995,11,1
3246724,1586111,194,48,669,0,863,48,1
1031334,79906,459,341,16840,0,17299,341,1
4224492,3863987,123,46,1308,0,1431,46,1
3270646,1957922,390,1,3571,0,3961,1,1
354904,4195088,3193,7,105780,0,108973,7,1
3384074,908147,72,14,1677,0,1749,14,1
4705188,4475961,336,2,8658,0,8994,2,1
2307868,4353381,1131,171,38777,0,39908,171,1
740765,4442658,101,11,173,0,274,11,1
2950311,3433839,807,36,85116,0,85923,36,1
2877907,1146757,508,12,16021,0,16529,12,1
4593330,2591558,203,79,8083,0,8286,79,1
3106700,4330386,157,278,1980,1246,2137,1524,1
3235479,2697693,999,50,66486,0,67485,50,1
427805,849867,483,1,156906,0,157389,1,1
3509903,1393108,1530,3,509445,0,510975,3,1
3635468,374896,3,58,130,0,133,58,1
3561502,2241908,1144,28,68800,0,69944,28,1
3467959,1622298,161,51,2179,0,2340,51,1
3448868,3370963,248,172,833,0,1081,172,1
2793437,4665769,582,1,25447,0,26029,1,1
4010500,606363,67,114,600,0,667,114,1
196521,651656,1176,185,11269,0,12445,185,1
2314038,1778145,456,6,16347,0,16803,6,1
2733969,4619541,143,38,372,89,515,127,1
4073917,2377153,24,8,1529,0,1553,8,1
4678614,3447825,452,128,16881,0,17333,128,1
1611386,368618,187,27,10932,0,11119,27,1
3676295,1013773,374,2,70881,0,71255,2,1
4297498,3190698,55,1,1240,0,1295,1,1
2957859,10130,190,44,4518,0,4708,44,1
1580988,2248874,2821,2,400133,0,402954,2,1
2893334,2524332,889,113,30148,0,31037,113,1
3517811,3627220,60,8,11929,0,11989,8,1
4360960,3902586,1642,30,110084,0,111726,30,1
990798,1575086,194,68,2812,0,3006,68,1
471706,3824997,794,157,65616,0,66410,157,1
4789203,984017,355,42,11315,0,11670,42,1
1580988,972340,2821,4,400133,0,402954,4,1
2882060,4727450,163,73,1992,0,2155,73,1
153198,362317,40,9,284,0,324,9,1
1064952,2730668,32,563,100,1,132,564,1
4360960,4266304,1642,19,110084,0,111726,19,1
2961552,1682027,562,4,16546,0,17108,4,1
1138515,4461955,341,18,12443,0,12784,18,1
2075015,2233287,2664,51,85781,0,88445,51,1
247842,3390899,112,5,1905,0,2017,5,1
3509903,177088,1530,8,509445,0,510975,8,1
4023687,1690129,69,30,7295,0,7364,30,1
1179906,1542757,316,283,14467,5996,14783,6279,1
3361377,2485639,4841,2,761793,0,766634,2,1
4624595,2942415,722,101,53368,0,54090,101,1
4642496,4520863,105,3432,292,908,397,4340,1
2779329,242323,217,130,6021,0,6238,130,1
1710474,385139,154,233,1649,1016,1803,1249,1
3849054,4408681,417,34,13259,0,13676,34,1
4569021,42246,168,98,265,0,433,98,1
1887709,1474718,217,27,28983,0,29200,27,1
3361377,3743694,4841,55,761793,0,766634,55,1
4575649,1591155,470,495,2915,0,3385,495,1
1521855,1500015,228,100,7649,0,7877,100,1
1350290,1551433,49,19,1273,0,1322,19,1
724436,1909412,217,18,2547,0,2764,18,1
3065808,2701459,1235,139,82317,0,83552,139,1
1966548,2154283,208,4,53149,0,53357,4,1
1301815,4730695,752,340,48944,0,49696,340,1
1580988,131648,2821,1,400133,0,402954,1,1
3853341,3302628,210,85,768,0,978,85,1
3280389,4294644,1101,2,411419,0,412520,2,1
1847461,378780,1211,20,51149,0,52360,20,1
4015080,3163398,144,60,1337,838,1481,898,1
4515355,1434738,21,1,8176,0,8197,1,1
3137585,1145799,1196,97,77354,0,78550,97,1
3509903,2189797,1530,1,509445,0,510975,1,1
354904,4192338,3193,56,105780,0,108973,56,1
493062,2413221,34,17,2722,0,2756,17,1
2738160,1995892,229,30,414,0,643,30,1
3509903,4678786,1530,1,509445,0,510975,1,1
4183784,2935481,931,76,59894,0,60825,76,1
4241838,2865361,45,8,1983,0,2028,8,1
3065808,4510301,1235,80,82317,0,83552,80,1
3914135,272425,2152,21,60084,0,62236,21,1
3050544,3832364,16,1353,147,0,163,1353,1
3280389,829549,1101,3,411419,0,412520,3,1
2261139,3096794,2014,41,42851,0,44865,41,1
883901,1532833,44,418,292,546,336,964,1
429643,3742163,767,76,19668,0,20435,76,1
3924296,2293122,104,57,1326,623,1430,680,1
3509903,2108771,1530,1,509445,0,510975,1,1
3676295,697332,374,1,70881,0,71255,1,1
3360059,1252520,69,1443,68,26,137,1469,1
1580988,267849,2821,3,400133,0,402954,3,1
2886626,4680385,192,13,6077,0,6269,13,1
3502068,4459664,378,765,2133,0,2511,765,1
3906136,2076144,387,112,41169,0,41556,112,1
2569009,139964,424,23,13423,0,13847,23,1
3505066,2801812,131,11,3630,0,3761,11,1
2827436,2761988,882,1,271525,0,272407,1,1
1887669,2854075,733,62,23145,0,23878,62,1
3836080,4525651,1197,31,59457,0,60654,31,1
2851109,2630992,450,32,98552,0,99002,32,1
4110087,4455659,127,342,1010,2879,1137,3221,1
720158,2962391,475,2532,320,241,795,2773,1
805360,3733489,1514,44,119306,0,120820,44,1
3065808,4705087,1235,5,82317,0,83552,5,1
781211,4349317,976,49,51781,0,52757,49,1
3943091,4708136,53,3,10283,0,10336,3,1
2906370,1139041,271,573,4802,0,5073,573,1
309382,595671,135,5,4536,0,4671,5,1
765601,2261735,1485,31,101510,0,102995,31,1
2950311,381041,807,46,85116,0,85923,46,1
1545210,3764474,8,6,23,0,31,6,1
1479093,4657145,47,22,608,0,655,22,1
2620077,1077560,136,6,491,0,627,6,1
2888602,351718,59,72,544,0,603,72,1
571147,835179,364,44,5484,0,5848,44,1
1125432,2990640,298,143,2434,0,2732,143,1
3163452,1758976,84,7,297,0,381,7,1
1580988,4578547,2821,7,400133,0,402954,7,1
3387814,1517704,198,39,1943,0,2141,39,1
3638272,278065,2022,2,370904,0,372926,2,1
1580988,1745221,2821,5,400133,0,402954,5,1
2677334,3839308,377,2,6774,0,7151,2,1
4360960,1154057,1642,12,110084,0,111726,12,1
652714,2080852,64,3,1815,0,1879,3,1
3280389,2814478,1101,1,411419,0,412520,1,1
2340671,3681784,17,100,126,0,143,100,1
1804173,744953,7,114,22,0,29,114,1
3782931,2577006,139,189,2547,206,2686,395,1
519175,1478394,173,13,7221,0,7394,13,1
1063857,2307225,248,26,15849,0,16097,26,1
4360960,17121,1642,7,110084,0,111726,7,1
954784,3657209,567,11,14450,0,15017,11,1
4649206,543068,566,39,31367,0,31933,39,1
2851109,576117,450,2,98552,0,99002,2,1
4451122,3805667,985,240,41669,0,42654,240,1
2687552,3018066,238,28,25574,0,25812,28,1
2770509,2303045,798,148,316,731,1114,879,1
1609659,3947625,523,15,29763,0,30286,15,1
2308819,839485,141,95,5491,0,5632,95,1
3897103,1063358,85,1350,501,63494,586,64844,1
3438576,642179,3424,64,137753,0,141177,64,1
3569179,4854942,1064,9,40015,0,41079,9,1
3106700,3029923,157,78,1980,0,2137,78,1
648163,3915987,238,38,1998,0,2236,38,1
1516853,1874628,426,27,10168,0,10594,27,1
2829725,1899501,25,177,201,423,226,600,1
3673472,4527983,50,426,478,0,528,426,1
1847461,927806,1211,10,51149,0,52360,10,1
3824547,1968667,1075,7,14337,0,15412,7,1
3638272,4736155,2022,4,370904,0,372926,4,1
4220190,738667,320,70,15994,0,16314,70,1
2662809,2341748,303,95,10704,0,11007,95,1
3280389,4723319,1101,3,411419,0,412520,3,1
3509903,2742942,1530,1,509445,0,510975,1,1
4302921,4698156,509,2,13289,0,13798,2,1
2075015,4024635,2664,14,85781,0,88445,14,1
1633053,3477483,533,3,8638,0,9171,3,1
2961801,574035,1483,28,101962,0,103445,28,1
2827436,680451,882,1,271525,0,272407,1,1
1875,611728,656,383,61388,0,62044,383,1
2403192,4784301,163,110,5302,0,5465,110,1
1367871,2806393,104,11,6433,0,6537,11,1
2441425,4603004,803,102,18561,0,19364,102,1
3988413,2370635,83,48,1410,123,1493,171,1
2343253,2883441,1882,15,86401,0,88283,15,1
4519069,2223792,387,32,20799,0,21186,32,1
3074145,3263277,205,76,5623,0,5828,76,1
402837,3206499,94,1337,180,32033,274,33370,1
1580988,4316819,2821,1,400133,0,402954,1,1
474172,2220855,471,6,38713,0,39184,6,1
1580508,1266471,720,102,19611,0,20331,102,1
3509903,2939743,1530,2,509445,0,510975,2,1
813554,236221,252,32,17214,0,17466,32,1
1234540,47153,1071,44,75251,0,76322,44,1
4629176,760982,2058,184,9211,0,11269,184,1
2981537,3439104,1252,2,118718,0,119970,2,1
3346033,411286,320,56,9541,0,9861,56,1
3689055,1504506,443,551,435,1317,878,1868,1
3294702,1910085,991,47,68888,0,69879,47,1
4854634,3387702,76,2,1396,0,1472,2,1
1436216,3862257,1068,71,68770,0,69838,71,1
2989110,2173691,1042,91,19283,0,20325,91,1
3844858,226577,1591,55,28974,0,30565,55,1
1102748,4317775,555,219,6504,242,7059,461,1
2687552,1238933,238,72,25574,0,25812,72,1
907654,4562429,798,47,24575,0,25373,47,1
708440,728748,302,22,9329,0,9631,22,1
3294702,1904412,991,39,68888,0,69879,39,1
3361377,793970,4841,2,761793,0,766634,2,1
1913445,4365169,564,20,47943,0,48507,20,1
3051212,687144,957,679,8349,859,9306,1538,1
1601507,3105976,129,3,6006,0,6135,3,1
3280389,4840432,1101,1,411419,0,412520,1,1
2260014,457682,2466,79,98622,0,101088,79,1
427805,1745485,483,1,156906,0,157389,1,1
3509903,127528,1530,1,509445,0,510975,1,1
3514277,2161760,1338,96,13269,0,14607,96,1
593740,4048027,1107,26,62807,0,63914,26,1
4052496,1834669,107,88,4222,0,4329,88,1
4503880,3579400,72,15,1028,0,1100,15,1
2498087,2210915,1630,325,32582,1678,34212,2003,1
2851109,2630076,450,66,98552,0,99002,66,1
3509903,1070450,1530,1,509445,0,510975,1,1
3361377,3613006,4841,1,761793,0,766634,1,1
1875,1958792,656,88,61388,0,62044,88,1
2726187,1131279,162,668,1230,0,1392,668,1
3081778,686897,211,104,1969,0,2180,104,1
1283690,953814,102,48,1462,0,1564,48,1
4750855,1829944,355,40,18880,0,19235,40,1
866357,1222206,825,256,18479,1387,19304,1643,1
3229211,3859368,96,186,365,133,461,319,1
1161189,4001717,112,118,3964,0,4076,118,1
3395938,2935605,546,47,39878,0,40424,47,1
2516076,794721,1455,25,77782,0,79237,25,1
2989110,530909,1042,64,19283,0,20325,64,1
4560313,4053424,284,150,4566,0,4850,150,1
2426489,802229,521,168,2911,3140,3432,3308,1
1580988,3036439,2821,1,400133,0,402954,1,1
2087206,681262,95,17,1349,0,1444,17,1
2617350,2552266,256,45,6547,0,6803,45,1
489584,4304056,421,164,12098,12698,12519,12862,1
3361377,4717063,4841,1,761793,0,766634,1,1
4013601,4561111,653,22,14886,0,15539,22,1
3361377,714285,4841,1,761793,0,766634,1,1
3509903,1689949,1530,14,509445,0,510975,14,1
2405789,2102760,1010,104,93387,0,94397,104,1
4653941,4018731,951,65,45883,0,46834,65,1
1839863,2557901,39,31,71,23,110,54,1
2101710,4781331,152,352,6934,0,7086,352,1
1192480,4509775,397,2,20737,0,21134,2,1
3644915,1732828,153,26,197,0,350,26,1
588533,4131662,84,1468,2858,0,2942,1468,1
435064,588997,75,6,1031,0,1106,6,1
1039525,1424252,337,16,3453,0,3790,16,1
2860764,509983,93,125,421,0,514,125,1
1063358,2476262,1350,7,63494,0,64844,7,1
1534362,2708110,1531,25,105859,0,107390,25,1
1250021,431346,4637,2,85913,0,90550,2,1
3280389,1053417,1101,1,411419,0,412520,1,1
3509903,3442189,1530,1,509445,0,510975,1,1
1880135,3441640,810,30,71924,0,72734,30,1
3395853,2584567,252,41,3685,0,3937,41,1
2956248,3711024,346,318,6702,0,7048,318,1
2502456,884736,719,3,50725,0,51444,3,1
3676295,652205,374,2,70881,0,71255,2,1
1819836,4585930,269,647,1652,0,1921,647,1
4621719,1898211,306,8,4102,0,4408,8,1
1847461,3835569,1211,171,51149,0,52360,171,1
2790006,3409893,367,79,14747,0,15114,79,1
1436216,302516,1068,8,68770,0,69838,8,1
595757,1254117,340,32,26738,0,27078,32,1
2872979,587491,341,20,28510,0,28851,20,1
337208,2728123,174,7,1581,0,1755,7,1
2147720,4517003,1608,100,78786,0,80394,100,1
4326568,3998170,21,14,355,0,376,14,1
3438576,1781374,3424,39,137753,0,141177,39,1
837553,3327981,1249,26,61665,0,62914,26,1
3455396,2501867,10,12,56,0,66,12,1
4011264,548664,1360,31,116777,0,118137,31,1
3257465,2327344,541,219,27614,0,28155,219,1
2341838,3445979,75,16,3932,0,4007,16,1
1079257,1841375,141,104,193,308,334,412,1
2373866,1859935,142,350,255,163,397,513,1
1103332,1376950,732,51,59415,0,60147,51,1
2122084,1303579,41,8,902,0,943,8,1
180517,4103967,118,209,4246,0,4364,209,1
1580988,3159837,2821,1,400133,0,402954,1,1
2861639,3355226,481,203,10848,0,11329,203,1
2343253,3832990,1882,12,86401,0,88283,12,1
2032442,3121270,109,1,10458,0,10567,1,1
2132225,2061354,7,27,140,0,147,27,1
4036898,2116762,182,30,683,153,865,183,1
1580988,1710259,2821,5,400133,0,402954,5,1
2075015,2133725,2664,43,85781,0,88445,43,1
3509903,4250580,1530,2,509445,0,510975,2,1
2029671,1180916,142,134,1241,0,1383,134,1
3651129,1613215,44,2,554,0,598,2,1
532681,1135098,433,122,35023,0,35456,122,1
370461,2096034,103,776,1991,0,2094,776,1
2812784,1673225,25,475,122,2319,147,2794,1
2209891,1703337,204,52,4060,0,4264,52,1
3367289,1241768,553,49,765,0,1318,49,1
3569179,736015,1064,27,40015,0,41079,27,1
337280,4708541,244,981,1297,15678,1541,16659,1
3300452,4741096,114,106,1992,0,2106,106,1
3849054,926071,417,863,13259,0,13676,863,1
4314280,3057447,568,143,9552,0,10120,143,1
3280389,2464543,1101,2,411419,0,412520,2,1
4653271,1583262,43,7,591,0,634,7,1
1615261,3953986,955,35,12715,0,13670,35,1
354904,634314,3193,52,105780,0,108973,52,1
920553,1313696,349,27,8968,0,9317,27,1
1493489,4620304,523,73,17512,0,18035,73,1
3914135,990539,2152,45,60084,0,62236,45,1
3397281,3199507,743,45,15050,0,15793,45,1
1225988,815730,157,141,8881,0,9038,141,1
3841840,2968462,195,105,2931,814,3126,919,1
2516076,1451694,1455,72,77782,0,79237,72,1
2120733,2860114,819,61,20803,0,21622,61,1
3280389,2103117,1101,1,411419,0,412520,1,1
525570,129567,470,65,3665,932,4135,997,1
3271484,2484831,1507,26,34093,0,35600,26,1
3069382,2784723,113,169,5201,0,5314,169,1
912467,3140183,51,1,1317,0,1368,1,1
1822719,3409196,285,124,22351,0,22636,124,1
3867232,183556,71,319,1994,0,2065,319,1
1927211,1315006,1668,75,113322,0,114990,75,1
2827436,3369446,882,16,271525,0,272407,16,1
2059990,3752934,69,11,342,0,411,11,1
2670449,2372478,277,76,3488,0,3765,76,1
4121239,2849172,64,161,5330,0,5394,161,1
1521855,1018271,228,66,7649,0,7877,66,1
4195951,519546,55,15,3156,0,3211,15,1
507060,2347385,191,24,6141,0,6332,24,1
3509903,2602330,1530,1,509445,0,510975,1,1
1062967,1399818,260,1,15276,0,15536,1,1
771985,4618418,98,76,1298,495,1396,571,1
4209323,726404,1630,25,89460,0,91090,25,1
4319972,2534146,640,12,35279,0,35919,12,1
2490914,2570001,570,1,22965,0,23535,1,1
765601,3465751,1485,51,101510,0,102995,51,1
3449530,3940004,717,42,73648,0,74365,42,1
2781817,1573981,704,240,24613,0,25317,240,1
2304340,4455659,114,342,988,2879,1102,3221,1
3167388,825334,203,52,9760,0,9963,52,1
3361377,3209383,4841,1,761793,0,766634,1,1
1545237,1175986,381,26,14327,0,14708,26,1
4011264,3097627,1360,6,116777,0,118137,6,1
873006,164804,375,88,33630,0,34005,88,1
932720,1915283,1411,20,111323,0,112734,20,1
4209323,1998763,1630,3,89460,0,91090,3,1
3543099,4294368,52,30,670,0,722,30,1
439557,2177974,2090,5,61744,0,63834,5,1
1534362,3722489,1531,4,105859,0,107390,4,1
1242199,2554770,207,97,6182,0,6389,97,1
4629176,4637530,2058,11,9211,0,11269,11,1
3645402,1868793,153,97,7400,0,7553,97,1
3851674,3456463,22,11,287,0,309,11,1
1436216,2185732,1068,1,68770,0,69838,1,1
2650412,1355516,931,315,29038,2436,29969,2751,1
813554,956887,252,14,17214,0,17466,14,1
3361377,491744,4841,3,761793,0,766634,3,1
1234540,4271024,1071,22,75251,0,76322,22,1
1353265,4517092,128,11,6709,0,6837,11,1
2718650,2463532,39,28,971,0,1010,28,1
1953883,694259,6,12,125,72,131,84,1
26760,120623,179,36,2100,0,2279,36,1
3672238,3019703,518,29,12172,0,12690,29,1
2502456,1573624,719,235,50725,0,51444,235,1
2887240,1794647,1143,5,118405,0,119548,5,1
2525373,1617805,63,89,122,0,185,89,1
4653007,4060525,169,50,728,0,897,50,1
595757,1806008,340,62,26738,0,27078,62,1
1546171,3409694,147,5,683,0,830,5,1
593740,860473,1107,751,62807,20450,63914,21201,1
4485028,483752,445,65,14565,0,15010,65,1
2261139,2373584,2014,72,42851,0,44865,72,1
1629019,1151673,351,7,5823,0,6174,7,1
182728,3217319,15,4,364,0,379,4,1
3734245,4772991,915,29,34965,0,35880,29,1
1221281,4653471,133,69,1378,0,1511,69,1
1887709,2724274,217,44,28983,0,29200,44,1
1875,3701967,656,30,61388,0,62044,30,1
2260014,3942421,2466,5,98622,0,101088,5,1
1461854,2446959,180,3,1401,0,1581,3,1
2755798,3914206,494,64,24862,0,25356,64,1
2669924,3491219,226,152,1977,0,2203,152,1
3153925,2839396,242,11,1315,0,1557,11,1
2893334,3141830,889,49,30148,0,31037,49,1
3438576,1689206,3424,3,137753,0,141177,3,1
397096,1106203,4,6,166,0,170,6,1
2950311,789756,807,92,85116,0,85923,92,1
4209323,1755444,1630,56,89460,0,91090,56,1
4479581,453832,601,22,19545,0,20146,22,1
2827436,718113,882,1,271525,0,272407,1,1
439557,926055,2090,45,61744,0,63834,45,1
2781817,4329587,704,1,24613,0,25317,1,1
2784572,2704675,69,6,3478,0,3547,6,1
2651023,4249558,140,316,2189,0,2329,316,1
2681935,3144895,35,14,157,0,192,14,1
805360,1636494,1514,36,119306,0,120820,36,1
547347,1003108,71,64,627,0,698,64,1
607449,2789598,380,67,19369,0,19749,67,1
2869151,4769352,395,162,1304,368,1699,530,1
3361377,1670707,4841,3,761793,0,766634,3,1
1436216,2978049,1068,1,68770,0,69838,1,1
611927,4863696,305,61,8695,0,9000,61,1
3638272,2219532,2022,46,370904,0,372926,46,1
3361377,1928181,4841,1,761793,0,766634,1,1
4866446,3936278,65,118,855,0,920,118,1
3364515,2090485,109,30,3529,0,3638,30,1
544230,737118,1532,77,60768,0,62300,77,1
765601,494900,1485,15,101510,0,102995,15,1
4319972,3682032,640,94,35279,0,35919,94,1
932720,64377,1411,31,111323,0,112734,31,1
2669216,1189314,280,229,1050,2366,1330,2595,1
4016805,123386,237,1,3059,0,3296,1,1
4183784,1354062,931,8,59894,0,60825,8,1
3271484,1891296,1507,3,34093,0,35600,3,1
3671141,3049072,1444,3,48400,0,49844,3,1
2154017,742799,10,41,116,0,126,41,1
2751572,1456811,481,80,44036,0,44517,80,1
2405789,4450335,1010,29,93387,0,94397,29,1
3280389,177243,1101,1,411419,0,412520,1,1
4433918,4645279,51,24,1621,0,1672,24,1
3638272,1573502,2022,1,370904,0,372926,1,1
2164338,3891207,292,7,1746,0,2038,7,1
4780185,59331,42,11,706,0,748,11,1
1227855,1111233,157,8,4545,0,4702,8,1
2323779,609135,28,4,1100,0,1128,4,1
2343253,2236491,1882,5,86401,0,88283,5,1
2762372,3226992,818,7,6089,0,6907,7,1
860473,1494174,751,7,20450,0,21201,7,1
4621335,2128480,7,2,42,0,49,2,1
515290,3637848,285,2,34080,0,34365,2,1
1301815,947844,752,33,48944,0,49696,33,1
3243295,409523,10,26,108,0,118,26,1
3065808,3573519,1235,27,82317,0,83552,27,1
4653941,910810,951,8,45883,0,46834,8,1
3509903,323356,1530,3,509445,0,510975,3,1
1839283,4473550,765,3,36658,0,37423,3,1
3065808,4352416,1235,327,82317,0,83552,327,1
3509903,2540255,1530,1,509445,0,510975,1,1
3644757,552588,21,14,244,0,265,14,1
4217975,689607,58,123,1546,0,1604,123,1
1295332,2393808,109,27,677,0,786,27,1
2405789,2715325,1010,54,93387,0,94397,54,1
77213,1271058,214,132,1656,0,1870,132,1
4360960,105792,1642,95,110084,0,111726,95,1
3845119,2594777,461,48,28609,0,29070,48,1
2405789,2537239,1010,48,93387,0,94397,48,1
427805,82576,483,6,156906,0,157389,6,1
4283503,2535659,125,26,4904,0,5029,26,1
3638272,1685107,2022,4,370904,0,372926,4,1
3870376,2499376,195,215,511,0,706,215,1
3612446,2108400,32,19,1944,0,1976,19,1
2075015,3127441,2664,41,85781,0,88445,41,1
3509903,3190323,1530,31,509445,0,510975,31,1
1780804,1268179,15,406,58,0,73,406,1
3638272,4377125,2022,1,370904,0,372926,1,1
636814,3653178,116,1,9387,0,9503,1,1
1534362,136478,1531,14,105859,0,107390,14,1
2119841,299026,272,69,1846,0,2118,69,1
3271484,2413274,1507,5,34093,0,35600,5,1
1847461,3180164,1211,6,51149,0,52360,6,1
2827436,3112239,882,1,271525,0,272407,1,1
2441425,4632085,803,56,18561,0,19364,56,1
3501482,420383,522,113,28046,0,28568,113,1
522588,2217918,496,49,20091,0,20587,49,1
1123367,2978475,387,5,3721,0,4108,5,1
3638272,887554,2022,5,370904,0,372926,5,1
1541866,4807780,542,67,16481,0,17023,67,1
3873768,3726793,449,15,35424,0,35873,15,1
3361377,3827452,4841,1,761793,0,766634,1,1
3361377,4798252,4841,28,761793,0,766634,28,1
4798192,3209174,816,4,20426,0,21242,4,1
1337919,2669990,250,20,10276,0,10526,20,1
1345777,176074,187,178,1667,0,1854,178,1
1803131,3759830,16,58,132,0,148,58,1
2962038,4358096,495,23,14236,0,14731,23,1
4360960,3550333,1642,21,110084,0,111726,21,1
3403228,48213,83,9,374,0,457,9,1
930038,4189428,59,6,142,0,201,6,1
3671141,56695,1444,5,48400,0,49844,5,1
4468935,4518054,205,12,203,0,408,12,1
1580988,152263,2821,1,400133,0,402954,1,1
2332074,4847079,40,76,289,114,329,190,1
4656285,3518082,1446,4,35428,0,36874,4,1
4594361,909030,103,28,3448,0,3551,28,1
2853969,1979684,1051,9,42591,0,43642,9,1
3361377,787519,4841,8,761793,0,766634,8,1
4496416,4760492,38,111,178,0,216,111,1
3509903,1659089,1530,9,509445,0,510975,9,1
3361377,1085810,4841,1,761793,0,766634,1,1
4302921,2268445,509,1,13289,0,13798,1,1
3569179,1547022,1064,3,40015,0,41079,3,1
4710206,1227302,134,26,1116,0,1250,26,1
4319972,1216838,640,585,35279,0,35919,585,1
2755798,4532005,494,71,24862,0,25356,71,1
4058687,3639367,418,100,3486,0,3904,100,1
2405789,3542632,1010,39,93387,0,94397,39,1
2961801,583153,1483,99,101962,0,103445,99,1
1534362,1258592,1531,56,105859,0,107390,56,1
765601,566498,1485,14,101510,0,102995,14,1
2854973,577013,10,8,57,0,67,8,1
1705425,1891218,248,1376,6280,0,6528,1376,1
4067716,1722601,622,120,4349,0,4971,120,1
2824797,1376234,83,22,4829,0,4912,22,1
1580988,706280,2821,28,400133,0,402954,28,1
3280389,1664309,1101,3,411419,0,412520,3,1
2851109,2030910,450,50,98552,0,99002,50,1
4371330,3109206,327,762,1639,0,1966,762,1
2617350,3757380,256,7,6547,0,6803,7,1
3468453,3402731,3,3654,27,18,30,3672,1
3137585,833476,1196,55,77354,0,78550,55,1
1580988,3232516,2821,8,400133,0,402954,8,1
4334275,3954493,90,156,850,151,940,307,1
2498087,3219400,1630,93,32582,0,34212,93,1
4411870,363750,948,1001,60517,10994,61465,11995,1
4289995,106919,525,263,4959,0,5484,263,1
3638272,4065975,2022,2,370904,0,372926,2,1
1927211,2040594,1668,96,113322,0,114990,96,1
2861639,530200,481,2035,10848,62809,11329,64844,1
2642344,1140134,10,311,29,11111,39,11422,1
4183784,1349853,931,25,59894,0,60825,25,1
408965,3870830,903,67,38623,0,39526,67,1
2772113,2077709,792,53,42907,0,43699,53,1
990798,824948,194,1,2812,0,3006,1,1
2827436,2741762,882,3,271525,0,272407,3,1
805360,474613,1514,100,119306,0,120820,100,1
3907996,710702,485,145,18964,0,19449,145,1
2446968,622202,452,319,20110,0,20562,319,1
173493,2340074,46,39,1959,0,2005,39,1
2772113,2359743,792,141,42907,0,43699,141,1
487744,4165102,138,15,2488,0,2626,15,1
2818749,2650604,92,66,3797,0,3889,66,1
3395938,1362885,546,7,39878,0,40424,7,1
3361377,3775813,4841,2,761793,0,766634,2,1
530200,55174,2035,7,62809,0,64844,7,1
2209136,4083920,620,39,33789,0,34409,39,1
439557,964043,2090,1,61744,0,63834,1,1
1399174,2878628,27,5,912,0,939,5,1
1705425,2120418,248,70,6280,0,6528,70,1
4429751,1556554,150,10,6616,0,6766,10,1
2089261,98419,29,75,168,370,197,445,1
435003,1007161,92,872,1730,0,1822,872,1
1887709,1624581,217,32,28983,0,29200,32,1
1973082,229041,1036,190,18915,0,19951,190,1
2827436,3617949,882,1,271525,0,272407,1,1
455037,2648904,61,2,973,0,1034,2,1
3065808,3111670,1235,2,82317,0,83552,2,1
1875,4606617,656,14,61388,0,62044,14,1
1927211,3277849,1668,63,113322,0,114990,63,1
2752180,4091984,154,7,717,0,871,7,1
3914135,4108525,2152,123,60084,0,62236,123,1
3115867,78719,1350,7,61232,0,62582,7,1
4295341,2090354,246,2,1478,0,1724,2,1
1386860,4052189,193,165,3250,0,3443,165,1
2040761,324175,19,3,578,0,597,3,1
4119505,601218,344,57,1991,0,2335,57,1
3539650,718783,194,47,2264,0,2458,47,1
4106501,3989108,224,372,1969,7033,2193,7405,1
3492414,3623013,67,4,260,0,327,4,1
2343253,4797074,1882,3,86401,0,88283,3,1
1135323,3964000,169,3,12240,0,12409,3,1
1847461,3537600,1211,84,51149,0,52360,84,1
2281149,4740195,282,3,28082,0,28364,3,1
3065808,1173498,1235,86,82317,0,83552,86,1
3549674,3707901,602,60,38542,0,39144,60,1
3671141,4225436,1444,160,48400,0,49844,160,1
3481008,2253056,201,14,1452,0,1653,14,1
4020443,2005643,81,8,1697,0,1778,8,1
354904,2516573,3193,1,105780,0,108973,1,1
214631,542608,319,2,2590,0,2909,2,1
4653941,278074,951,111,45883,0,46834,111,1
515290,2795002,285,25,34080,0,34365,25,1
4507659,3977221,115,4,1270,0,1385,4,1
3384159,4450981,415,15,6659,0,7074,15,1
791851,642819,10,2,250,0,260,2,1
1966548,3950958,208,3,53149,0,53357,3,1
596012,112690,192,12,3561,0,3753,12,1
4468814,1644171,48,1071,722,3690,770,4761,1
4672596,1085613,107,6,3286,0,3393,6,1
4272102,2705125,1608,8,104171,0,105779,8,1
2617350,187714,256,35,6547,0,6803,35,1
474172,2116034,471,8,38713,0,39184,8,1
1927211,3836384,1668,39,113322,0,114990,39,1
3449530,1801492,717,11,73648,0,74365,11,1
2940588,1519275,554,8,9477,0,10031,8,1
2314038,1819775,456,8,16347,0,16803,8,1
2961801,938757,1483,20,101962,0,103445,20,1
4004339,876622,153,1,6086,0,6239,1,1
3671141,4604481,1444,1,48400,0,49844,1,1
2779329,4447795,217,102,6021,0,6238,102,1
3280389,4802839,1101,1,411419,0,412520,1,1
688537,2130158,94,86,1363,0,1457,86,1
1014658,2982484,200,14,2003,0,2203,14,1
1063857,3397577,248,27,15849,0,16097,27,1
1063857,2190113,248,7,15849,0,16097,7,1
2446968,3806579,452,135,20110,0,20562,135,1
3907996,3381677,485,22,18964,0,19449,22,1
429643,118536,767,104,19668,0,20435,104,1
1499177,742799,168,41,1229,0,1397,41,1
337280,3860602,244,239,1297,0,1541,239,1
2122741,3761390,190,44,6085,0,6275,44,1
1604753,3418746,78,1,3240,0,3318,1,1
3549674,3433281,602,34,38542,0,39144,34,1
1428477,4607667,255,2,15459,0,15714,2,1
2207944,4464791,165,198,4573,0,4738,198,1
3655915,1542168,176,5,1999,0,2175,5,1
3216427,3261324,262,11,6471,0,6733,11,1
276216,3506299,312,29,12600,0,12912,29,1
781211,1238057,976,117,51781,0,52757,117,1
4360960,4102200,1642,26,110084,0,111726,26,1
4417253,1849445,1130,435,68389,0,69519,435,1
3870873,2851999,36,8,1423,0,1459,8,1
354904,2800012,3193,78,105780,0,108973,78,1
3379164,3842148,74,719,889,11430,963,12149,1
4411870,2925411,948,33,60517,0,61465,33,1
474172,10846,471,72,38713,0,39184,72,1
3115867,4557870,1350,2,61232,0,62582,2,1
4649206,1767591,566,67,31367,0,31933,67,1
4624595,840956,722,24,53368,0,54090,24,1
2170503,973133,15,3,196,0,211,3,1
1436216,20898,1068,1,68770,0,69838,1,1
2075015,1584331,2664,18,85781,0,88445,18,1
600498,4145036,418,111,436,0,854,111,1
2466056,3473583,72,305,945,385,1017,690,1
4727207,4133063,925,2,84581,0,85506,2,1
2938068,2370308,112,115,4178,0,4290,115,1
3992144,2245029,402,1,23683,0,24085,1,1
1062967,895334,260,4,15276,0,15536,4,1
4256261,2519430,177,321,2001,0,2178,321,1
4191410,1209431,1590,56,96434,0,98024,56,1
1294660,576919,48,431,600,16,648,447,1
294412,4213709,41,16,283,0,324,16,1
515537,300920,74,75,1883,0,1957,75,1
439557,1405581,2090,2,61744,0,63834,2,1
3509903,3467236,1530,2,509445,0,510975,2,1
3765475,1982970,873,1,107914,0,108787,1,1
3225310,396466,320,43,10537,0,10857,43,1
2446968,2897611,452,71,20110,0,20562,71,1
2109919,4594097,46,2,5772,0,5818,2,1
2950311,3850052,807,9,85116,0,85923,9,1
3641600,3606836,751,80,9269,0,10020,80,1
3271484,4306882,1507,13,34093,0,35600,13,1
525299,1400621,337,106,4714,0,5051,106,1
1163589,4092664,97,29,437,0,534,29,1
173493,4391111,46,31,1959,0,2005,31,1
606419,902993,22,1,220,0,242,1,1
870181,4312377,278,20,1377,0,1655,20,1
4513854,4151345,135,8,383,0,518,8,1
3907996,1603242,485,34,18964,0,19449,34,1
1702465,1279860,173,73,6319,0,6492,73,1
2950311,3085004,807,52,85116,0,85923,52,1
2261139,4113418,2014,29,42851,0,44865,29,1
1702465,2437730,173,1,6319,0,6492,1,1
2827436,2067240,882,1,271525,0,272407,1,1
3638272,1672742,2022,39,370904,0,372926,39,1
1493489,56225,523,7,17512,0,18035,7,1
3509903,324289,1530,2,509445,0,510975,2,1
805360,2649866,1514,301,119306,0,120820,301,1
3906136,424731,387,36,41169,0,41556,36,1
42654,3987850,97,10,1166,0,1263,10,1
2887240,371043,1143,6,118405,0,119548,6,1
2516076,2097059,1455,31,77782,0,79237,31,1
2093622,4030779,9,2,124,0,133,2,1
3764177,1648649,1036,53,64563,0,65599,53,1
1651321,1278574,28,60,269,0,297,60,1
2906370,2605789,271,1,4802,0,5073,1,1
1877681,1954788,166,31,1823,0,1989,31,1
4108836,1386773,97,89,4234,0,4331,89,1
4374509,3786936,770,92,9940,0,10710,92,1
1031761,2381542,735,5,866,0,1601,5,1
2938068,258137,112,112,4178,0,4290,112,1
400117,1398468,419,100,1225,0,1644,100,1
4654860,1833314,317,115,1516,0,1833,115,1
2940588,1507113,554,27,9477,0,10031,27,1
2031305,997046,396,149,23435,0,23831,149,1
2181203,4359646,151,3,1587,0,1738,3,1
2092359,265163,421,36,26936,0,27357,36,1
4309630,516411,105,85,476,42,581,127,1
1301815,1163637,752,42,48944,0,49696,42,1
3898535,4314745,59,11,9303,0,9362,11,1
3509903,2268327,1530,2,509445,0,510975,2,1
3844858,304579,1591,393,28974,0,30565,393,1
3206499,2308711,1337,2,32033,0,33370,2,1
3509903,290875,1530,1,509445,0,510975,1,1
3442800,4361971,15,6,58,27,73,33,1
3423256,4152776,289,30,2138,0,2427,30,1
765601,4132346,1485,78,101510,0,102995,78,1
765601,450658,1485,31,101510,0,102995,31,1
1831774,3442041,228,11,1883,0,2111,11,1
3190749,4610766,116,693,291,200,407,893,1
1154180,2088703,248,732,2361,0,2609,732,1
1580988,3002967,2821,5,400133,0,402954,5,1
3509903,3751771,1530,1,509445,0,510975,1,1
2827436,524391,882,7,271525,0,272407,7,1
3033166,1621055,312,35,4444,0,4756,35,1
3936039,3863730,799,61,23884,0,24683,61,1
4804614,3841884,151,89,2725,0,2876,89,1
3549674,4662396,602,53,38542,0,39144,53,1
3438576,1482199,3424,46,137753,0,141177,46,1
1822719,1248316,285,23,22351,0,22636,23,1
3280389,2858736,1101,3,411419,0,412520,3,1
1580988,4509459,2821,4,400133,0,402954,4,1
2950311,4513910,807,23,85116,0,85923,23,1
378943,2970821,340,179,12563,0,12903,179,1
805360,2440903,1514,19,119306,0,120820,19,1
940526,50436,475,16,20786,0,21261,16,1
3795221,1450298,332,47,5749,0,6081,47,1
2342664,1886464,1181,11,26502,0,27683,11,1
4371411,1274046,189,613,648,2455,837,3068,1
52770,1171914,58,2431,466,795,524,3226,1
2911269,3468030,740,4,20606,0,21346,4,1
3883912,59603,109,283,802,12,911,295,1
2674718,4608785,136,9,5233,0,5369,9,1
2040749,4276984,596,29,3834,0,4430,29,1
3992721,2802704,107,73,650,0,757,73,1
2542968,1316433,444,5,4728,0,5172,5,1
4350722,72243,333,17,1956,0,2289,17,1
828101,3993818,33,5,546,0,579,5,1
2109675,1007809,273,19,513,11,786,30,1
2702192,4430710,980,1,488,0,1468,1,1
4131582,3514277,25,1338,105,13269,130,14607,1
1927211,965601,1668,34,113322,0,114990,34,1
3758692,4740701,711,9,34731,0,35442,9,1
230289,4455659,138,342,335,2879,473,3221,1
2681811,3087210,284,1,6285,0,6569,1,1
3361377,4778348,4841,1,761793,0,766634,1,1
1652056,3597973,326,225,66845,0,67171,225,1
781211,92813,976,50,51781,0,52757,50,1
1822719,1464433,285,91,22351,0,22636,91,1
1022123,2939139,126,3,8212,0,8338,3,1
3850588,158492,99,85,400,1069,499,1154,1
3845119,1082477,461,12,28609,0,29070,12,1
363750,44083,1001,48,10994,0,11995,48,1
1921268,719652,174,6,651,0,825,6,1
873006,2113394,375,47,33630,0,34005,47,1
2569009,2476488,424,47,13423,0,13847,47,1
3361377,2273911,4841,22,761793,0,766634,22,1
1550824,2211451,165,132,3841,0,4006,132,1
2148937,3581969,672,2,47361,0,48033,2,1
3509903,3823741,1530,1,509445,0,510975,1,1
4140279,2483031,337,1,49384,0,49721,1,1
2723171,581847,99,205,3999,0,4098,205,1
2260014,561726,2466,7,98622,0,101088,7,1
1751669,2153032,860,89,9825,0,10685,89,1
2147720,4046361,1608,61,78786,0,80394,61,1
1633053,972751,533,94,8638,0,9171,94,1
1462439,2739949,777,4,5849,0,6626,4,1
1966548,2663468,208,5,53149,0,53357,5,1
532681,3824547,433,1075,35023,14337,35456,15412,1
3633019,3230007,746,28,32317,0,33063,28,1
2263130,4131036,712,17,14043,0,14755,17,1
1250021,1566799,4637,9,85913,0,90550,9,1
2569009,2947153,424,324,13423,0,13847,324,1
3962542,191526,23,10,123,0,146,10,1
515290,10820,285,1,34080,0,34365,1,1
1723506,216109,733,116,21835,0,22568,116,1
1966548,88656,208,2,53149,0,53357,2,1
1653268,1858699,183,185,5919,0,6102,185,1
1994281,2561949,139,314,2492,0,2631,314,1
310957,4739321,96,29,349,0,445,29,1
842476,2185376,898,274,12479,0,13377,274,1
1580988,4661137,2821,1,400133,0,402954,1,1
4750855,4247173,355,25,18880,0,19235,25,1
1250021,3798764,4637,75,85913,0,90550,75,1
2826379,1522403,26,142,212,1179,238,1321,1
2911269,3163778,740,29,20606,0,21346,29,1
4471661,17330,49,154,732,972,781,1126,1
2082713,61219,48,7,329,0,377,7,1
3280389,1378002,1101,1,411419,0,412520,1,1
2827436,2862694,882,3,271525,0,272407,3,1
2309618,1917864,980,229,5354,1447,6334,1676,1
1575009,3859930,429,2,37745,0,38174,2,1
1839283,108391,765,38,36658,0,37423,38,1
1540080,3940256,255,3,3594,0,3849,3,1
3065808,4636160,1235,4,82317,0,83552,4,1
1654099,40754,1180,83,26347,0,27527,83,1
4467395,595784,2084,221,14574,0,16658,221,1
2827436,4551289,882,1,271525,0,272407,1,1
1873894,2130790,65,35,176,0,241,35,1
3606650,1953803,6,76,295,1,301,77,1
765601,781332,1485,20,101510,0,102995,20,1
3632293,3954398,570,26,21294,0,21864,26,1
1037361,1771034,232,1,2017,0,2249,1,1
2827436,4701251,882,1,271525,0,272407,1,1
4390232,3552533,113,7,1949,0,2062,7,1
3361377,1653664,4841,4,761793,0,766634,4,1
4411870,3837263,948,52,60517,0,61465,52,1
97450,4195722,165,66,1955,0,2120,66,1
3671141,3784785,1444,219,48400,0,49844,219,1
2877633,4664024,152,240,5044,0,5196,240,1
2757156,4862305,237,2,8153,0,8390,2,1
3768366,4472443,334,75,12403,0,12737,75,1
3387987,931338,268,62,19035,0,19303,62,1
581535,1533779,1283,10,8414,0,9697,10,1
3438576,4120992,3424,36,137753,0,141177,36,1
4011264,1832305,1360,16,116777,0,118137,16,1
3361377,4551252,4841,1,761793,0,766634,1,1
427805,2122273,483,1,156906,0,157389,1,1
1461476,3206733,24,2,279,0,303,2,1
1517832,3871554,49,947,770,16042,819,16989,1
1633022,2158470,246,1,23530,0,23776,1,1
3361377,544449,4841,1,761793,0,766634,1,1
821089,3824259,394,24,4820,0,5214,24,1
1373083,1071845,5,1,880,0,885,1,1
290670,4393856,252,121,3851,0,4103,121,1
3397281,2585895,743,12,15050,0,15793,12,1
2075015,3996284,2664,50,85781,0,88445,50,1
3551313,2451105,452,66,470,0,922,66,1
3759853,1974288,451,153,16330,0,16781,153,1
3397281,3986087,743,403,15050,0,15793,403,1
1966548,1123023,208,2,53149,0,53357,2,1
579164,3438955,28,53,596,0,624,53,1
4727207,3207669,925,9,84581,0,85506,9,1
4692327,1673054,149,106,2092,0,2241,106,1
2661982,2577594,18,1,1790,0,1808,1,1
1497278,3138213,1869,30,35111,0,36980,30,1
1497278,4391424,1869,88,35111,0,36980,88,1
1341178,1113231,899,62,16829,0,17728,62,1
2090342,849437,155,14,2211,0,2366,14,1
1262094,2699570,145,99,243,0,388,99,1
393185,479296,591,16,7719,0,8310,16,1
3280389,1155161,1101,1,411419,0,412520,1,1
3500846,2285793,210,26,5085,0,5295,26,1
1249227,610673,621,45,7423,0,8044,45,1
2148937,632005,672,230,47361,0,48033,230,1
3361377,1667941,4841,1,761793,0,766634,1,1
4751453,2901506,520,69,27570,0,28090,69,1
917130,1770595,325,425,7017,0,7342,425,1
2989110,87357,1042,111,19283,0,20325,111,1
1324035,2326851,165,875,534,166,699,1041,1
3137585,3039926,1196,111,77354,0,78550,111,1
4208653,1426890,1820,85,21104,1165,22924,1250,1
2799417,3269295,13,46,277,76,290,122,1
26760,2700433,179,207,2100,0,2279,207,1
1063888,1023903,47,12,1756,0,1803,12,1
4304056,1164973,164,50,12698,0,12862,50,1
1276253,452923,407,1,46534,0,46941,1,1
4119505,4401197,344,38,1991,0,2335,38,1
805360,1310713,1514,436,119306,0,120820,436,1
3638272,723644,2022,1,370904,0,372926,1,1
2529661,1163724,493,11,27309,0,27802,11,1
4701417,1317880,305,32,3855,0,4160,32,1
6618,4030691,892,362,68849,0,69741,362,1
3397281,2456861,743,298,15050,0,15793,298,1
3449530,1198954,717,4,73648,0,74365,4,1
2938068,1729475,112,13,4178,0,4290,13,1
4519069,2741327,387,15,20799,0,21186,15,1
3361377,1489791,4841,8,761793,0,766634,8,1
4619326,2607931,539,2,22721,0,23260,2,1
2851109,412872,450,1,98552,0,99002,1,1
4183784,3680954,931,82,59894,0,60825,82,1
755739,2196517,1117,17,58043,0,59160,17,1
3115867,3896280,1350,52,61232,0,62582,52,1
2119707,966766,165,282,1567,512,1732,794,1
3638272,1366927,2022,1,370904,0,372926,1,1
2887240,3862525,1143,3,118405,0,119548,3,1
2827436,240247,882,9,271525,0,272407,9,1
3638272,1112908,2022,1,370904,0,372926,1,1
3633019,2336079,746,110,32317,0,33063,110,1
3632293,3538364,570,44,21294,0,21864,44,1
2827436,2049663,882,7,271525,0,272407,7,1
3344390,1195550,309,93,4274,0,4583,93,1
1580988,4510461,2821,1,400133,0,402954,1,1
4233503,3731941,224,10,7867,0,8091,10,1
2827436,93306,882,272,271525,0,272407,272,1
4011264,327705,1360,19,116777,0,118137,19,1
465530,3114645,16,2,335,0,351,2,1
2961801,4322621,1483,38,101962,0,103445,38,1
2107861,366017,535,2,25743,0,26278,2,1
2827436,1141233,882,3,271525,0,272407,3,1
3438576,3072989,3424,48,137753,0,141177,48,1
978797,2885897,599,78,12421,0,13020,78,1
868049,4807101,35,3,2387,0,2422,3,1
4799966,4152680,557,14,4819,0,5376,14,1
2823179,597534,505,2,6744,0,7249,2,1
3280389,1047953,1101,1,411419,0,412520,1,1
3549674,662260,602,85,38542,0,39144,85,1
196521,4030410,1176,64,11269,0,12445,64,1
416856,4835142,50,10,719,0,769,10,1
3289311,3715443,107,27,2041,0,2148,27,1
2962038,822646,495,142,14236,0,14731,142,1
471706,2072539,794,185,65616,0,66410,185,1
3881634,4709586,641,4,8471,0,9112,4,1
1880135,1899331,810,25,71924,0,72734,25,1
4360960,4826497,1642,1,110084,0,111726,1,1
2436781,3051161,689,15,9972,0,10661,15,1
1103332,3997918,732,51,59415,0,60147,51,1
4135599,399086,1648,52,329,0,1977,52,1
2261139,4611736,2014,32,42851,0,44865,32,1
3907996,2046798,485,101,18964,0,19449,101,1
948768,1127420,587,231,14768,0,15355,231,1
1822719,3267063,285,416,22351,0,22636,416,1
1124035,2473407,84,15,3736,0,3820,15,1
4606184,4365326,265,184,4466,0,4731,184,1
2851109,1693764,450,115,98552,0,99002,115,1
3419989,2370624,350,103,16316,0,16666,103,1
3671141,1808159,1444,2,48400,0,49844,2,1
60980,3469051,649,16,20708,0,21357,16,1
4011264,2407181,1360,11,116777,0,118137,11,1
491194,3981644,49,14,308,0,357,14,1
3765475,1169770,873,105,107914,0,108787,105,1
1924697,2244929,20,27,403,0,423,27,1
1276253,3019178,407,2,46534,0,46941,2,1
1086912,2454430,907,207,33396,0,34303,207,1
280872,4506582,18,4,94,0,112,4,1
3361377,3621590,4841,6,761793,0,766634,6,1
1309175,382245,97,60,917,0,1014,60,1
3280389,1533379,1101,1,411419,0,412520,1,1
3280389,1421757,1101,1,411419,0,412520,1,1
4121239,1338185,64,171,5330,0,5394,171,1
3736564,716189,83,85,1935,2000,2018,2085,1
3291396,505281,195,12,11502,0,11697,12,1
3198742,452924,551,25,5252,0,5803,25,1
3759853,469957,451,12,16330,0,16781,12,1
4727207,1544896,925,2,84581,0,85506,2,1
4011264,4397309,1360,23,116777,0,118137,23,1
1028971,1385619,130,58,385,0,515,58,1
4342519,3724208,138,12,11317,0,11455,12,1
2981537,3405116,1252,22,118718,0,119970,22,1
595757,933972,340,17,26738,0,27078,17,1
3318434,43937,55,410,1995,0,2050,410,1
3280389,4805945,1101,2,411419,0,412520,2,1
4360960,884618,1642,47,110084,0,111726,47,1
4011264,4608354,1360,73,116777,0,118137,73,1
1580988,3834152,2821,3,400133,0,402954,3,1
2961552,2882914,562,13,16546,0,17108,13,1
3385289,1629820,648,327,7232,0,7880,327,1
4295952,3962202,808,24,57369,0,58177,24,1
698620,1417980,215,4,1399,0,1614,4,1
3509903,642041,1530,1,509445,0,510975,1,1
2026738,2590696,37,4,710,0,747,4,1
2309618,4046489,980,236,5354,0,6334,236,1
4360960,1165098,1642,8,110084,0,111726,8,1
256934,971801,287,3,11635,0,11922,3,1
4727207,4074446,925,146,84581,0,85506,146,1
1539837,4000279,1127,55,62979,0,64106,55,1
3636190,4087098,119,116,4195,0,4314,116,1
1474822,2774340,229,26,3952,0,4181,26,1
3385289,1208550,648,4,7232,0,7880,4,1
2014153,3868838,87,11,422,0,509,11,1
4411870,1206256,948,122,60517,0,61465,122,1
256934,213425,287,27,11635,0,11922,27,1
3438576,4209638,3424,86,137753,0,141177,86,1
466667,2572450,442,240,4239,0,4681,240,1
2516076,525109,1455,70,77782,1943,79237,2013,1
1086912,2181765,907,844,33396,1019,34303,1863,1
427805,3792788,483,1,156906,0,157389,1,1
2147720,1392829,1608,24,78786,0,80394,24,1
94189,226540,251,463,2779,10650,3030,11113,1
3509903,4299832,1530,1,509445,0,510975,1,1
4360960,3870104,1642,11,110084,0,111726,11,1
3658381,2640094,238,207,1530,0,1768,207,1
427805,1815892,483,1,156906,0,157389,1,1
866357,190109,825,8,18479,0,19304,8,1
672193,4630495,11,21,352,0,363,21,1
4417253,379867,1130,108,68389,0,69519,108,1
813554,896167,252,23,17214,0,17466,23,1
354904,1263303,3193,44,105780,0,108973,44,1
3638272,1907109,2022,1,370904,0,372926,1,1
2327109,2751843,175,30,1877,0,2052,30,1
837553,703433,1249,249,61665,0,62914,249,1
4191410,2149474,1590,57,96434,0,98024,57,1
1436216,852261,1068,126,68770,0,69838,126,1
544230,157609,1532,370,60768,0,62300,370,1
2981537,1856514,1252,9,118718,0,119970,9,1
3918313,1384328,146,255,915,0,1061,255,1
2893327,2094335,100,1,2238,0,2338,1,1
1653998,3285954,24,6,1986,0,2010,6,1
974650,61246,114,7,1990,0,2104,7,1
2980600,427041,7,1,1149,0,1156,1,1
2441425,4364438,803,7,18561,0,19364,7,1
4746749,3500920,283,190,3968,0,4251,190,1
4289995,1678975,525,62,4959,0,5484,62,1
4061933,768269,182,667,1562,32,1744,699,1
2818749,4445385,92,94,3797,0,3889,94,1
260860,586759,137,579,1884,0,2021,579,1
2199673,1194111,118,172,2496,0,2614,172,1
3881634,3195278,641,2,8471,0,9112,2,1
2677334,2033290,377,1,6774,0,7151,1,1
360130,3412112,38,6,942,0,980,6,1
2883055,2842931,286,1,13198,0,13484,1,1
3142714,134857,35,4,1436,0,1471,4,1
2525425,3963236,440,5,1129,0,1569,5,1
378943,2342164,340,73,12563,0,12903,73,1
3361377,164096,4841,77,761793,0,766634,77,1
1031334,902771,459,19,16840,0,17299,19,1
441734,1985612,271,138,3594,0,3865,138,1
3361377,420482,4841,2,761793,0,766634,2,1
2705886,4324009,179,109,4447,0,4626,109,1
1503116,10015,415,18,37079,0,37494,18,1
3194560,2343253,282,1882,2856,86401,3138,88283,1
669455,2979527,52,1,1362,0,1414,1,1
1591435,223521,387,16,31245,0,31632,16,1
3280389,4060271,1101,1,411419,0,412520,1,1
1580988,2801685,2821,17,400133,0,402954,17,1
765601,1061475,1485,105,101510,0,102995,105,1
4295952,4170526,808,58,57369,0,58177,58,1
3137585,1977619,1196,103,77354,0,78550,103,1
3280389,3155735,1101,3,411419,0,412520,3,1
3280389,3278911,1101,1,411419,0,412520,1,1
3280389,2278688,1101,1,411419,0,412520,1,1
3509903,4424832,1530,2,509445,0,510975,2,1
3907996,2940406,485,87,18964,0,19449,87,1
2405789,3818488,1010,29,93387,0,94397,29,1
2866819,3844858,171,1591,613,28974,784,30565,1
4191410,2836806,1590,42,96434,0,98024,42,1
1723506,3704805,733,379,21835,0,22568,379,1
161276,623017,146,24,6548,0,6694,24,1
4140279,4502443,337,1,49384,0,49721,1,1
4404351,3561770,156,7,1195,0,1351,7,1
88059,3564442,33,70,1099,0,1132,70,1
3916976,4511576,188,189,6098,0,6286,189,1
2147720,2751268,1608,71,78786,0,80394,71,1
97450,1628275,165,97,1955,2967,2120,3064,1
1207753,4280818,533,105,9348,0,9881,105,1
544230,1760713,1532,41,60768,0,62300,41,1
3449530,3028469,717,33,73648,0,74365,33,1
1637447,2429686,555,3,8549,0,9104,3,1
4191410,611728,1590,383,96434,0,98024,383,1
4525011,2533668,172,695,6076,0,6248,695,1
2291145,4007158,221,420,3037,0,3258,420,1
3375235,4439978,562,226,3864,0,4426,226,1
4117427,75052,329,45,9639,0,9968,45,1
3280389,330941,1101,2,411419,0,412520,2,1
4124848,656221,183,94,1280,0,1463,94,1
3672238,2716958,518,29,12172,0,12690,29,1
1595565,2332845,22,1,198,0,220,1,1
3509903,3985996,1530,42,509445,0,510975,42,1
3361377,289209,4841,3,761793,0,766634,3,1
1333818,1803131,16,16,98,132,114,148,1
713416,4537425,120,14,1953,0,2073,14,1
3856348,4656814,89,160,742,0,831,160,1
2031305,1156289,396,76,23435,0,23831,76,1
1575009,4360560,429,23,37745,0,38174,23,1
2405789,574237,1010,16,93387,0,94397,16,1
3871554,696173,947,8,16042,0,16989,8,1
2436781,412875,689,1,9972,0,10661,1,1
3671141,720231,1444,32,48400,0,49844,32,1
3638272,3462406,2022,3,370904,0,372926,3,1
452761,2981086,59,4,3160,0,3219,4,1
3361377,2040966,4841,3,761793,0,766634,3,1
805360,4680385,1514,13,119306,0,120820,13,1
4653941,4778657,951,136,45883,0,46834,136,1
2828183,3617986,192,407,3138,0,3330,407,1
593740,1858807,1107,16,62807,0,63914,16,1
1580988,3963550,2821,52,400133,0,402954,52,1
1734954,3358725,369,47,5786,0,6155,47,1
530200,1665480,2035,76,62809,0,64844,76,1
2650412,3138345,931,7,29038,0,29969,7,1
4569293,3632127,191,75,5084,0,5275,75,1
3638272,1387511,2022,2,370904,0,372926,2,1
3835618,2696589,694,301,25433,0,26127,301,1
4662055,4072022,155,3,2918,0,3073,3,1
3361377,163862,4841,2,761793,0,766634,2,1
4738916,3061580,1165,23,34124,0,35289,23,1
646587,4367759,122,4,5819,0,5941,4,1
4296372,2670984,33,1,686,0,719,1,1
3946789,2629122,261,1,5606,0,5867,1,1
3438576,2477372,3424,29,137753,0,141177,29,1
3294702,928002,991,92,68888,0,69879,92,1
1927211,3779912,1668,65,113322,0,114990,65,1
2755798,3088336,494,22,24862,0,25356,22,1
4087774,2182652,578,6,10107,0,10685,6,1
2950311,333836,807,114,85116,0,85923,114,1
3569179,1014069,1064,8,40015,0,41079,8,1
4416945,1435453,417,25,33228,0,33645,25,1
414608,2294944,50,5,5531,0,5581,5,1
2655966,4792767,81,22,2804,0,2885,22,1
2827436,2868137,882,1,271525,0,272407,1,1
1242199,208844,207,25,6182,0,6389,25,1
3361377,2085904,4841,3,761793,0,766634,3,1
1196844,3977482,548,141,36289,0,36837,141,1
4519069,4721468,387,28,20799,0,21186,28,1
1609659,1592854,523,54,29763,0,30286,54,1
1249967,973809,207,213,11933,0,12140,213,1
1927211,2689717,1668,10,113322,0,114990,10,1
1606469,473693,96,2,5210,0,5306,2,1
2941178,2761828,121,15,1943,0,2064,15,1
1378976,3112835,136,195,230,323,366,518,1
2911269,167163,740,59,20606,0,21346,59,1
521586,1407215,782,63,18489,0,19271,63,1
1939437,4629176,228,2058,827,9211,1055,11269,1
501914,1530066,217,43,5217,0,5434,43,1
584906,4482754,253,5,6639,0,6892,5,1
3759853,1063850,451,476,16330,0,16781,476,1
1580988,379398,2821,1,400133,0,402954,1,1
3641113,1522183,283,310,2099,0,2382,310,1
652259,2056040,59,105,964,0,1023,105,1
2516076,319329,1455,139,77782,0,79237,139,1
1580988,2080316,2821,18,400133,0,402954,18,1
3638272,2677462,2022,8,370904,0,372926,8,1
2981537,715958,1252,1,118718,0,119970,1,1
938472,2127638,124,195,4326,0,4450,195,1
2707591,1803472,162,111,2360,0,2522,111,1
2779329,4264312,217,109,6021,0,6238,109,1
3638272,1710913,2022,2,370904,0,372926,2,1
3986468,462205,111,788,3703,589,3814,1377,1
3375235,1419903,562,39,3864,0,4426,39,1
2595727,1151791,125,6,1928,0,2053,6,1
3561502,991590,1144,125,68800,0,69944,125,1
3509903,1331713,1530,5,509445,0,510975,5,1
3638272,4771617,2022,7,370904,0,372926,7,1
4257751,3322229,109,7,8420,0,8529,7,1
805360,3325721,1514,4,119306,0,120820,4,1
4272102,3398758,1608,33,104171,0,105779,33,1
1063358,2682141,1350,51,63494,0,64844,51,1
2672195,2307868,4,1131,40,38777,44,39908,1
285124,4421582,135,9,4250,0,4385,9,1
1503116,3184620,415,16,37079,0,37494,16,1
2847192,4609257,105,171,3937,2290,4042,2461,1
1966548,721060,208,1,53149,0,53357,1,1
1331940,699934,802,8,32617,0,33419,8,1
3280389,2360360,1101,1,411419,0,412520,1,1
2687552,2377736,238,68,25574,0,25812,68,1
2902273,810636,212,25,966,0,1178,25,1
4011264,171718,1360,14,116777,0,118137,14,1
408965,4624444,903,108,38623,0,39526,108,1
1196844,1892519,548,82,36289,0,36837,82,1
4649206,462298,566,414,31367,10933,31933,11347,1
4624595,3875009,722,32,53368,0,54090,32,1
2446968,1860016,452,187,20110,0,20562,187,1
3361377,3279392,4841,3,761793,0,766634,3,1
3361377,3889493,4841,8,761793,0,766634,8,1
1580508,3855370,720,81,19611,0,20331,81,1
1494665,1857582,668,27,37638,0,38306,27,1
1103332,2789375,732,74,59415,0,60147,74,1
2314038,65634,456,59,16347,0,16803,59,1
1839283,2098953,765,22,36658,0,37423,22,1
1966548,3974210,208,1,53149,0,53357,1,1
307250,675617,919,1,35588,0,36507,1,1
2827436,1182996,882,1,271525,0,272407,1,1
2950311,1659517,807,24,85116,0,85923,24,1
2343253,2958844,1882,43,86401,0,88283,43,1
3361377,4522903,4841,4,761793,0,766634,4,1
2343253,1470458,1882,109,86401,0,88283,109,1
3524438,911391,51,9,2423,0,2474,9,1
4220190,4317381,320,10,15994,0,16314,10,1
837553,4862547,1249,107,61665,0,62914,107,1
1693361,3612302,42,10,2151,0,2193,10,1
4648695,1384348,145,37,625,0,770,37,1
3549674,842418,602,40,38542,0,39144,40,1
151693,3708994,436,141,12181,0,12617,141,1
1580988,2357324,2821,8,400133,0,402954,8,1
2482338,3212061,712,156,24222,0,24934,156,1
1100354,2212807,163,1,24439,0,24602,1,1
49935,2449879,296,40,496,0,792,40,1
3280389,1969897,1101,4,411419,0,412520,4,1
4689808,3182723,280,54,14220,0,14500,54,1
4582129,3949639,1231,106,10356,0,11587,106,1
2893334,1766446,889,2,30148,0,31037,2,1
4701417,2698788,305,382,3855,0,4160,382,1
3361377,3365343,4841,2,761793,0,766634,2,1
4209323,2794713,1630,185,89460,0,91090,185,1
41659,4778646,76,26,802,0,878,26,1
1100354,904031,163,1,24439,0,24602,1,1
3361377,3217275,4841,2,761793,0,766634,2,1
427805,2693041,483,1,156906,0,157389,1,1
1194256,3797010,75,8,370,0,445,8,1
1234540,4524681,1071,8,75251,0,76322,8,1
370123,2299410,110,1,7231,0,7341,1,1
3361377,1164992,4841,1,761793,0,766634,1,1
1031334,127561,459,102,16840,0,17299,102,1
4191727,1362504,463,12,26315,0,26778,12,1
1516853,4525892,426,16,10168,0,10594,16,1
3021639,265357,81,244,1475,12,1556,256,1
532681,3358357,433,49,35023,83,35456,132,1
1539837,2442721,1127,35,62979,0,64106,35,1
2827436,4621337,882,2,271525,0,272407,2,1
755739,3800637,1117,71,58043,0,59160,71,1
3361377,405448,4841,2,761793,0,766634,2,1
3235479,4499389,999,7,66486,0,67485,7,1
4411870,2393593,948,183,60517,0,61465,183,1
593740,47897,1107,35,62807,0,63914,35,1
2827436,270117,882,1,271525,0,272407,1,1
1185954,3162427,125,65,1646,0,1771,65,1
787416,2154018,115,12,9954,0,10069,12,1
3419989,2636820,350,58,16316,0,16666,58,1
948375,2518190,113,1,4186,0,4299,1,1
4649206,4158607,566,99,31367,0,31933,99,1
837553,352088,1249,45,61665,0,62914,45,1
372345,2687815,92,6,313,0,405,6,1
263502,21944,42,317,471,9419,513,9736,1
2551530,3732147,145,2,2250,0,2395,2,1
6618,4406739,892,3,68849,0,69741,3,1
3509903,1308554,1530,79,509445,0,510975,79,1
4767550,3141240,65,15,1636,0,1701,15,1
307250,4809102,919,1,35588,0,36507,1,1
3361377,1043996,4841,32,761793,0,766634,32,1
3638272,3075269,2022,3,370904,0,372926,3,1
3705965,3459552,190,704,1950,0,2140,704,1
2168218,3861526,404,39,3126,0,3530,39,1
2763282,1563528,321,21,10936,0,11257,21,1
4628096,1862902,219,3,5074,0,5293,3,1
4738916,1276447,1165,69,34124,0,35289,69,1
3671362,1389752,46,7,78,69,124,76,1
865889,3133399,77,44,592,740,669,784,1
1858077,2768125,450,307,289,0,739,307,1
2147720,1673935,1608,82,78786,0,80394,82,1
253352,2502456,237,719,10413,50725,10650,51444,1
2502456,1508066,719,69,50725,0,51444,69,1
1903752,35578,506,35,10494,0,11000,35,1
2827436,1518265,882,1,271525,0,272407,1,1
781211,2855724,976,35,51781,0,52757,35,1
2193513,4253538,100,1412,1276,1533,1376,2945,1
31508,2496351,53,3,646,0,699,3,1
713575,4688454,30,4,219,0,249,4,1
1847461,3923214,1211,102,51149,0,52360,102,1
4727207,4190841,925,54,84581,0,85506,54,1
1521114,1600059,749,1,1909,0,2658,1,1
3549674,4549618,602,136,38542,0,39144,136,1
1293807,2007886,1837,45,30865,0,32702,45,1
938472,12921,124,55,4326,0,4450,55,1
592541,1769080,132,2,6913,0,7045,2,1
1884787,551733,39,102,650,0,689,102,1
3235479,3133285,999,34,66486,0,67485,34,1
2148937,716303,672,2,47361,0,48033,2,1
3112136,4793430,406,39,41366,0,41772,39,1
818304,2607116,75,3,536,0,611,3,1
1878924,1782645,85,122,2012,0,2097,122,1
1469880,2207464,275,37,3409,0,3684,37,1
2502456,146282,719,137,50725,0,51444,137,1
593740,3828161,1107,101,62807,0,63914,101,1
3509903,4705886,1530,3,509445,0,510975,3,1
408965,4647847,903,100,38623,0,39526,100,1
1633022,1484398,246,2,23530,0,23776,2,1
393185,999102,591,77,7719,0,8310,77,1
4649206,2377482,566,154,31367,0,31933,154,1
4212637,4021884,35,3,2517,0,2552,3,1
1123367,991442,387,1,3721,0,4108,1,1
4590792,1972393,90,4,326,0,416,4,1
2877907,214663,508,240,16021,0,16529,240,1
3633019,1677167,746,21,32317,0,33063,21,1
2950311,2669308,807,13,85116,0,85923,13,1
3361377,3582523,4841,1,761793,0,766634,1,1
562324,2814625,15,37,166,0,181,37,1
3679433,345333,48,11,2001,0,2049,11,1
1887669,1467502,733,75,23145,0,23878,75,1
4209323,3890189,1630,341,89460,0,91090,341,1
1075646,3737308,21,468,280,235,301,703,1
2490914,4016103,570,34,22965,0,23535,34,1
3971219,1083345,304,2,1726,0,2030,2,1
2147720,1203463,1608,23,78786,0,80394,23,1
3361377,1883703,4841,2,761793,0,766634,2,1
4187354,3707473,61,72,2628,0,2689,72,1
635909,1223386,179,1,6949,0,7128,1,1
3361377,3442153,4841,5,761793,0,766634,5,1
948768,2110945,587,29,14768,0,15355,29,1
2209136,2818710,620,21,33789,0,34409,21,1
2827436,1546012,882,5,271525,0,272407,5,1
704605,816600,12,34,167,0,179,34,1
2827436,1730736,882,1,271525,0,272407,1,1
2529661,2424810,493,45,27309,0,27802,45,1
2150261,183519,332,26,2204,0,2536,26,1
1937293,2158938,434,1,16761,0,17195,1,1
907654,413237,798,12,24575,0,25373,12,1
837553,1540564,1249,21,61665,0,62914,21,1
4678614,2238387,452,159,16881,0,17333,159,1
1580988,1256577,2821,1,400133,0,402954,1,1
3361377,445317,4841,3,761793,0,766634,3,1
4011264,3468517,1360,21,116777,0,118137,21,1
1494665,4383712,668,303,37638,0,38306,303,1
892512,2425153,1505,513,11757,0,13262,513,1
3509903,2345227,1530,5,509445,0,510975,5,1
3509903,3389799,1530,1,509445,0,510975,1,1
4117427,4019719,329,314,9639,0,9968,314,1
4570481,4810667,111,156,170,255,281,411,1
4209323,2134345,1630,9,89460,0,91090,9,1
1927211,2010549,1668,2,113322,0,114990,2,1
2772113,4540880,792,18,42907,0,43699,18,1
2778168,1974399,65,362,1464,0,1529,362,1
476426,1153326,72,96,1975,0,2047,96,1
4423184,1106749,384,122,29809,0,30193,122,1
1966548,2361044,208,2,53149,0,53357,2,1
522588,2969506,496,3,20091,0,20587,3,1
733639,4715642,259,118,3744,0,4003,118,1
1787075,2959483,894,50,28305,0,29199,50,1
3361377,678362,4841,1,761793,0,766634,1,1
3857537,3657330,1008,19,5225,0,6233,19,1
765601,4448722,1485,45,101510,0,102995,45,1
968886,2727684,78,352,1821,0,1899,352,1
4437944,924896,262,257,3324,0,3586,257,1
3112136,2805241,406,37,41366,0,41772,37,1
805360,3356080,1514,7,119306,0,120820,7,1
3412172,2447890,227,4,2700,0,2927,4,1
1250021,4648632,4637,42,85913,0,90550,42,1
2144504,1675400,555,508,129,140,684,648,1
582276,1406864,298,8,10990,0,11288,8,1
2524671,2601703,140,8,7015,0,7155,8,1
3361377,1540874,4841,1,761793,0,766634,1,1
927772,1733957,26,554,320,15185,346,15739,1
4727207,4003125,925,3,84581,0,85506,3,1
584906,287238,253,58,6639,0,6892,58,1
4741813,1927665,140,140,3184,0,3324,140,1
4562361,3824547,19,1075,202,14337,221,15412,1
3361377,4115348,4841,1,761793,0,766634,1,1
1296164,1183737,103,17,302,179,405,196,1
1205945,4552792,99,52,250,0,349,52,1
1966548,4782166,208,3,53149,0,53357,3,1
3119726,3715957,299,5,11573,0,11872,5,1
3271484,1122440,1507,31,34093,0,35600,31,1
3361377,4054988,4841,2,761793,0,766634,2,1
1250021,2310300,4637,229,85913,1157,90550,1386,1
4160676,3644915,357,153,309,197,666,350,1
1325245,1153248,144,137,5103,0,5247,137,1
3361377,1094418,4841,6,761793,0,766634,6,1
393185,4258547,591,42,7719,0,8310,42,1
1533546,4585075,703,214,22095,0,22798,214,1
2283618,3592449,14,131,36,135,50,266,1
3638272,1324011,2022,1,370904,0,372926,1,1
3280389,4820729,1101,1,411419,0,412520,1,1
3280389,3013210,1101,3,411419,0,412520,3,1
687713,4357846,436,49,47160,0,47596,49,1
2092043,943807,73,37,2886,0,2959,37,1
3873128,4779501,96,3,3581,0,3677,3,1
427805,3632956,483,1,156906,0,157389,1,1
2881425,2120248,102,70,5272,0,5374,70,1
57574,410588,289,54,4616,0,4905,54,1
4119505,2612638,344,125,1991,347,2335,472,1
161276,4709860,146,14,6548,0,6694,14,1
4313572,2074034,930,4,16971,0,17901,4,1
3836080,1472791,1197,39,59457,0,60654,39,1
4330391,4219523,773,40,32759,0,33532,40,1
3679106,142909,89,42,138,125,227,167,1
841308,3685465,102,211,3967,0,4069,211,1
3842148,663082,719,197,11430,0,12149,197,1
2261139,3331638,2014,4,42851,0,44865,4,1
4295341,1445063,246,121,1478,0,1724,121,1
3759853,3197662,451,313,16330,0,16781,313,1
1927211,4389717,1668,91,113322,0,114990,91,1
1791211,1447244,23,56,290,0,313,56,1
2981537,3450994,1252,1,118718,0,119970,1,1
2267633,3886712,422,104,13247,0,13669,104,1
4272102,2167700,1608,35,104171,0,105779,35,1
4519298,2077208,577,118,14443,0,15020,118,1
1923830,1595812,181,92,2733,0,2914,92,1
522588,2153405,496,81,20091,0,20587,81,1
4789203,1176766,355,3,11315,0,11670,3,1
4195951,4575649,55,470,3156,2915,3211,3385,1
3449530,1761316,717,46,73648,0,74365,46,1
1927211,946572,1668,22,113322,0,114990,22,1
4022062,2000327,157,20,3780,0,3937,20,1
4257751,930994,109,68,8420,0,8529,68,1
3610598,4430208,380,7,17343,0,17723,7,1
2772113,3216754,792,9,42907,0,43699,9,1
4416945,1024311,417,50,33228,0,33645,50,1
331118,1170609,1,1,69,0,70,1,1
621115,4003619,66,2,6250,0,6316,2,1
2122741,2408781,190,58,6085,720,6275,778,1
4297315,2947174,195,115,7446,0,7641,115,1
3638272,2380586,2022,1,370904,0,372926,1,1
2405789,4409543,1010,73,93387,0,94397,73,1
130589,380852,7,37,106,0,113,37,1
573101,2274870,781,742,12750,0,13531,742,1
3214227,2876447,27,26,1890,0,1917,26,1
1516853,2914191,426,1,10168,0,10594,1,1
958099,4293757,63,33,2391,0,2454,33,1
3477164,704973,80,4,2851,0,2931,4,1
3768366,1256029,334,225,12403,0,12737,225,1
2826978,1929032,29,4,955,0,984,4,1
3137585,1087477,1196,51,77354,0,78550,51,1
4084121,2441535,113,74,2582,0,2695,74,1
3501482,2377583,522,379,28046,0,28568,379,1
681618,3168118,75,2,8789,0,8864,2,1
318090,2435887,74,14,1957,0,2031,14,1
3290431,2978375,65,299,1379,0,1444,299,1
2981537,3763854,1252,5,118718,0,119970,5,1
4563259,562727,136,54,4740,0,4876,54,1
25593,1400343,1914,96,502,136,2416,232,1
3759853,3003260,451,174,16330,0,16781,174,1
3361377,36496,4841,1,761793,0,766634,1,1
1534362,1094518,1531,39,105859,0,107390,39,1
2249955,4238451,136,1643,346,54,482,1697,1
1503116,500468,415,4,37079,0,37494,4,1
2075015,1818741,2664,42,85781,0,88445,42,1
1249227,4325994,621,36,7423,0,8044,36,1
3137585,4225166,1196,31,77354,0,78550,31,1
1633053,653206,533,141,8638,0,9171,141,1
1339664,3341068,228,192,6682,0,6910,192,1
3294702,3541377,991,124,68888,0,69879,124,1
366670,1365499,185,462,892,0,1077,462,1
1063358,2197837,1350,97,63494,1984,64844,2081,1
427805,1707435,483,1,156906,0,157389,1,1
846208,19874,600,333,17288,0,17888,333,1
2344793,2549336,28,27,521,0,549,27,1
4727207,4159824,925,3,84581,0,85506,3,1
3638272,3641146,2022,1,370904,0,372926,1,1
2989110,545154,1042,233,19283,0,20325,233,1
4750855,1404394,355,24,18880,0,19235,24,1
805360,4767834,1514,44,119306,0,120820,44,1
4750855,4070841,355,45,18880,0,19235,45,1
3361377,3182139,4841,3,761793,0,766634,3,1
2981537,2182950,1252,4,118718,0,119970,4,1
3721550,1575859,188,16,14527,0,14715,16,1
4016481,2172002,24,718,595,0,619,718,1
1493489,4852974,523,19,17512,0,18035,19,1
140700,701810,86,233,492,0,578,233,1
326686,1887626,49,2,772,0,821,2,1
3464608,1069323,129,4,2235,0,2364,4,1
1580988,2234397,2821,1,400133,0,402954,1,1
3361377,884573,4841,1,761793,0,766634,1,1
2345261,1252520,92,1443,1694,26,1786,1469,1
1364801,397169,450,77,4704,0,5154,77,1
4863816,1612332,213,23,649,53,862,76,1
1102748,3027935,555,115,6504,0,7059,115,1
1494665,2791258,668,1,37638,0,38306,1,1
3844858,1959092,1591,173,28974,0,30565,173,1
1494918,4206393,248,1,972,0,1220,1,1
582276,4124841,298,733,10990,0,11288,733,1
1274046,166726,613,82,2455,165,3068,247,1
4257751,3705070,109,740,8420,14938,8529,15678,1
4849993,4174541,156,49,2873,0,3029,49,1
3235479,3604199,999,148,66486,0,67485,148,1
2319861,2327580,315,286,1517,0,1832,286,1
4727207,34914,925,1,84581,0,85506,1,1
135188,1104239,51,21,5860,0,5911,21,1
3235479,2117296,999,68,66486,0,67485,68,1
1776477,432280,21,540,409,653,430,1193,1
1847461,1321711,1211,67,51149,0,52360,67,1
1824416,3395717,48,32,140,0,188,32,1
4191410,2856475,1590,195,96434,0,98024,195,1
4500014,4848209,114,1,727,0,841,1,1
3112136,736001,406,383,41366,0,41772,383,1
1815739,1499775,248,133,6590,0,6838,133,1
3405059,949215,261,5,9604,0,9865,5,1
3765475,4019034,873,8,107914,0,108787,8,1
681618,607825,75,2,8789,0,8864,2,1
3361377,3662254,4841,2,761793,0,766634,2,1
471706,1107562,794,31,65616,0,66410,31,1
3912594,3680940,178,131,2010,0,2188,131,1
1250021,3554627,4637,55,85913,0,90550,55,1
3633019,3147010,746,330,32317,0,33063,330,1
4349341,384172,24,9,1570,0,1594,9,1
2650412,4060781,931,1,29038,0,29969,1,1
4727207,2335267,925,3,84581,0,85506,3,1
3257465,4609546,541,71,27614,0,28155,71,1
1053923,2379433,490,265,4567,0,5057,265,1
354904,4415712,3193,9,105780,0,108973,9,1
3361377,3612177,4841,1,761793,0,766634,1,1
3714061,1348723,84,500,3348,0,3432,500,1
2662809,1605669,303,2,10704,0,11007,2,1
1615261,2079745,955,14,12715,0,13670,14,1
2827436,1826743,882,1,271525,0,272407,1,1
4846817,202360,76,2,5055,0,5131,2,1
1710654,1151702,35,29,616,0,651,29,1
3280389,1520470,1101,1,411419,0,412520,1,1
3509214,3086576,263,7,14139,0,14402,7,1
978341,4329849,604,154,10065,0,10669,154,1
532681,3462098,433,52,35023,0,35456,52,1
1580988,407709,2821,1,400133,0,402954,1,1
781211,3268539,976,13,51781,0,52757,13,1
3094886,3344390,675,309,6621,4274,7296,4583,1
350406,1354187,33,90,173,0,206,90,1
4209323,4239472,1630,119,89460,0,91090,119,1
2956553,2317782,610,788,314,2668,924,3456,1
3438446,1337853,783,1795,923,107,1706,1902,1
3509903,4088790,1530,2,509445,0,510975,2,1
3235479,3149606,999,57,66486,0,67485,57,1
2209891,1831222,204,8,4060,0,4264,8,1
4708541,1881173,981,22,15678,0,16659,22,1
1891127,4663912,113,173,863,0,976,173,1
2853969,2540595,1051,21,42591,0,43642,21,1
1580988,3704685,2821,30,400133,0,402954,30,1
1301815,1456652,752,49,48944,0,49696,49,1
1681422,3190749,92,116,351,291,443,407,1
2948092,4066339,412,14,18486,0,18898,14,1
3397281,3234925,743,89,15050,0,15793,89,1
3909070,680040,90,83,639,0,729,83,1
593740,1834492,1107,65,62807,0,63914,65,1
4088731,3258759,1418,2,1242,0,2660,2,1
932720,991414,1411,70,111323,0,112734,70,1
427805,4282115,483,1,156906,0,157389,1,1
513426,1310887,57,3,713,0,770,3,1
1234540,3492443,1071,64,75251,0,76322,64,1
540985,4505759,363,154,289,0,652,154,1
4705188,3962744,336,1,8658,0,8994,1,1
837553,4105419,1249,7,61665,0,62914,7,1
2021745,3374521,72,18,2948,0,3020,18,1
4272102,2084050,1608,107,104171,0,105779,107,1
1880135,1663105,810,75,71924,0,72734,75,1
2827436,1692522,882,2,271525,0,272407,2,1
3350917,1357239,71,22,324,0,395,22,1
4238001,2070180,869,40,61161,0,62030,40,1
427805,201067,483,1,156906,0,157389,1,1
2031305,4745957,396,28,23435,0,23831,28,1
2827436,2353286,882,1,271525,0,272407,1,1
2998026,739583,919,10,24182,0,25101,10,1
4011264,3143138,1360,56,116777,0,118137,56,1
582276,3875602,298,13,10990,0,11288,13,1
765601,1483645,1485,335,101510,0,102995,335,1
2793437,567758,582,16,25447,0,26029,16,1
3316620,2026698,214,53,5083,0,5297,53,1
354904,755739,3193,1117,105780,58043,108973,59160,1
1250021,1386064,4637,4,85913,0,90550,4,1
665164,3302528,396,62,12610,0,13006,62,1
4435343,636328,74,47,590,0,664,47,1
2827436,3775534,882,2,271525,0,272407,2,1
2281149,4497707,282,29,28082,0,28364,29,1
3123201,2159602,126,1,5539,0,5665,1,1
197541,534945,134,72,1912,0,2046,72,1
1206697,204837,685,296,5595,0,6280,296,1
26760,4352623,179,345,2100,1186,2279,1531,1
4593330,269982,203,351,8083,9019,8286,9370,1
1250021,3586229,4637,37,85913,0,90550,37,1
1179906,989951,316,170,14467,0,14783,170,1
855414,1266663,68,248,1268,0,1336,248,1
1512714,3079641,253,5,6663,0,6916,5,1
2165481,3820867,59,2,430,0,489,2,1
3509903,949024,1530,4,509445,0,510975,4,1
1436216,4712490,1068,12,68770,0,69838,12,1
1086912,2193501,907,497,33396,0,34303,497,1
4656799,892512,187,1505,2411,11757,2598,13262,1
3705070,3561502,740,1144,14938,68800,15678,69944,1
3638272,721309,2022,1,370904,0,372926,1,1
2269301,185085,82,26,784,0,866,26,1
3225310,2023678,320,479,10537,0,10857,479,1
768957,549484,202,83,7986,0,8188,83,1
1580988,30020,2821,78,400133,0,402954,78,1
768957,4863696,202,61,7986,0,8188,61,1
4255453,3217944,327,43,3125,0,3452,43,1
1927211,3797513,1668,40,113322,0,114990,40,1
961349,2026787,154,72,5849,0,6003,72,1
3137585,2378636,1196,84,77354,0,78550,84,1
4330391,3788174,773,1,32759,0,33532,1,1
3758692,2491268,711,755,34731,0,35442,755,1
3764177,3456921,1036,2,64563,0,65599,2,1
805360,3495969,1514,3,119306,0,120820,3,1
2516076,3300536,1455,17,77782,0,79237,17,1
3509903,3852017,1530,1,509445,0,510975,1,1
3638272,1688704,2022,2,370904,0,372926,2,1
2616927,29869,184,10,2688,0,2872,10,1
388331,3152351,618,9,1648,0,2266,9,1
3638272,4373443,2022,21,370904,0,372926,21,1
4365938,1870216,250,38,10362,0,10612,38,1
1494665,764940,668,109,37638,0,38306,109,1
4191410,479550,1590,18,96434,0,98024,18,1
4360960,3286616,1642,122,110084,0,111726,122,1
3906136,4750385,387,21,41169,0,41556,21,1
1910777,1947371,477,12,1910,0,2387,12,1
4230144,3329481,216,22,4435,0,4651,22,1
1609659,2674516,523,93,29763,0,30286,93,1
4167572,2097827,81,1,6924,0,7005,1,1
2147720,3290729,1608,108,78786,0,80394,108,1
2380608,4113200,360,103,3399,0,3759,103,1
4035655,4691233,913,6,5979,0,6892,6,1
3641600,1122342,751,48,9269,0,10020,48,1
465946,3771197,258,267,1468,36,1726,303,1
1644171,4231451,1071,15,3690,0,4761,15,1
3704464,2693793,64,36,827,0,891,36,1
4860485,3993020,89,76,3655,0,3744,76,1
2627841,3180597,418,19,12342,0,12760,19,1
781211,588300,976,1,51781,0,52757,1,1
763217,1773243,66,130,738,0,804,130,1
2670449,4228701,277,4,3488,0,3765,4,1
516423,2255565,78,11,293,0,371,11,1
439557,2587540,2090,3,61744,0,63834,3,1
837553,177144,1249,87,61665,0,62914,87,1
1386493,4359914,111,17,1396,0,1507,17,1
3280389,1665080,1101,34,411419,0,412520,34,1
768957,4803670,202,178,7986,0,8188,178,1
2849738,423711,61,19,3795,0,3856,19,1
2199247,3562534,61,1,1954,0,2015,1,1
1301815,4205482,752,41,48944,0,49696,41,1
2147720,4610533,1608,60,78786,0,80394,60,1
3361377,1468949,4841,6,761793,0,766634,6,1
3120018,2331038,31,116,982,0,1013,116,1
621115,1999822,66,2,6250,0,6316,2,1
4656285,2496757,1446,341,35428,0,36874,341,1
4011264,2846491,1360,36,116777,0,118137,36,1
1652056,3361505,326,1,66845,0,67171,1,1
427805,4828428,483,5,156906,0,157389,5,1
1353265,2546016,128,7,6709,0,6837,7,1
3361377,689631,4841,1,761793,0,766634,1,1
932720,175095,1411,16,111323,0,112734,16,1
4689808,2542282,280,127,14220,0,14500,127,1
1446938,4853234,49,1256,216,29554,265,30810,1
2285283,867163,279,3,6799,0,7078,3,1
3676295,4265511,374,35,70881,0,71255,35,1
805360,307406,1514,55,119306,0,120820,55,1
3631455,3580680,2,28,243,0,245,28,1
1185597,47194,64,148,1501,4662,1565,4810,1
1250021,3457334,4637,2,85913,0,90550,2,1
1534362,266893,1531,26,105859,0,107390,26,1
3509903,4702131,1530,98,509445,0,510975,98,1
1887709,1211033,217,7,28983,0,29200,7,1
2267131,4238371,205,32,2884,0,3089,32,1
941212,1111876,184,6,6404,0,6588,6,1
1494665,3697135,668,55,37638,0,38306,55,1
3845148,839157,44,2,3928,0,3972,2,1
1697621,1631796,47,1,408,0,455,1,1
2519890,4646982,66,8,312,0,378,8,1
3941858,3829500,202,2,5760,0,5962,2,1
1580508,616057,720,87,19611,0,20331,87,1
3638272,2979446,2022,3,370904,0,372926,3,1
1984394,4003644,52,17,237,0,289,17,1
2405789,1854196,1010,37,93387,0,94397,37,1
4497645,4326133,65,96,536,0,601,96,1
1580988,2730562,2821,1,400133,0,402954,1,1
837553,2057420,1249,46,61665,0,62914,46,1
1609659,2343075,523,54,29763,0,30286,54,1
521586,488044,782,152,18489,0,19271,152,1
4727207,3129095,925,1,84581,0,85506,1,1
3632293,4349783,570,70,21294,0,21864,70,1
777257,2294983,93,29,1559,0,1652,29,1
2851109,606549,450,36,98552,0,99002,36,1
4106906,2168218,119,404,1068,3126,1187,3530,1
4374509,1054870,770,22,9940,0,10710,22,1
471706,2781027,794,6,65616,0,66410,6,1
4547438,909548,1291,78,25237,0,26528,78,1
2527114,515423,225,24,409,61,634,85,1
2687552,653018,238,16,25574,0,25812,16,1
2887240,1602494,1143,3,118405,0,119548,3,1
2260014,290302,2466,71,98622,0,101088,71,1
3509903,3257833,1530,208,509445,0,510975,208,1
3137585,1831357,1196,21,77354,0,78550,21,1
4851206,2392114,93,34,752,0,845,34,1
3323519,2784982,133,38,4787,0,4920,38,1
2145181,4152850,114,6,1746,0,1860,6,1
805360,3323039,1514,71,119306,0,120820,71,1
3501482,2572881,522,18,28046,0,28568,18,1
2405789,315557,1010,22,93387,0,94397,22,1
2482351,2233500,76,1,328,0,404,1,1
2209136,3387907,620,123,33789,0,34409,123,1
3668051,1370835,89,3,3044,0,3133,3,1
307250,2925353,919,1,35588,0,36507,1,1
3663048,637945,155,1,1959,0,2114,1,1
1580988,2364003,2821,4,400133,0,402954,4,1
3449530,9083,717,58,73648,0,74365,58,1
3361377,1269244,4841,1,761793,0,766634,1,1
354904,2496568,3193,1,105780,0,108973,1,1
2590487,4423699,438,181,3617,0,4055,181,1
2981537,4853180,1252,2,118718,0,119970,2,1
3361377,3827614,4841,1,761793,0,766634,1,1
3280389,2205628,1101,9,411419,0,412520,9,1
1927211,2963585,1668,38,113322,0,114990,38,1
378943,4613785,340,21,12563,0,12903,21,1
1467044,90090,99,92,870,0,969,92,1
1633100,1990749,163,4,8737,0,8900,4,1
978797,202366,599,59,12421,0,13020,59,1
2428341,1848648,826,46,10151,0,10977,46,1
2887240,4523689,1143,2,118405,0,119548,2,1
2827436,977858,882,1,271525,0,272407,1,1
1628302,80145,11,32,4819,0,4830,32,1
805360,4533350,1514,30,119306,0,120820,30,1
2514271,2376109,387,64,19070,0,19457,64,1
4011264,1577424,1360,250,116777,0,118137,250,1
1100354,1926753,163,1,24439,0,24602,1,1
842476,2197872,898,69,12479,0,13377,69,1
4439803,762948,85,179,530,387,615,566,1
2529661,3657867,493,2,27309,0,27802,2,1
236836,4394219,27,2,784,0,811,2,1
932720,702661,1411,74,111323,0,112734,74,1
2961801,1088367,1483,35,101962,0,103445,35,1
4443577,1284433,509,62,11936,0,12445,62,1
3638272,1071354,2022,1,370904,0,372926,1,1
3383252,1058878,281,291,3966,0,4247,291,1
2261139,16872,2014,14,42851,0,44865,14,1
427805,495393,483,1,156906,0,157389,1,1
47194,3494785,148,1253,4662,539,4810,1792,1
1845574,1470669,60,29,453,0,513,29,1
3671141,1936912,1444,38,48400,0,49844,38,1
2887240,1396877,1143,1,118405,0,119548,1,1
2514271,2427804,387,26,19070,0,19457,26,1
3088808,4077117,227,376,7820,0,8047,376,1
687713,1487171,436,5,47160,0,47596,5,1
4519298,4342155,577,192,14443,0,15020,192,1
4547438,4404351,1291,156,25237,1195,26528,1351,1
965744,4706063,10,32,89,0,99,32,1
1428477,2762538,255,49,15459,0,15714,49,1
1395717,4864873,32,6,510,0,542,6,1
2120733,3005378,819,456,20803,0,21622,456,1
932720,180044,1411,44,111323,0,112734,44,1
3280389,3251970,1101,33,411419,0,412520,33,1
4304056,1768546,164,215,12698,0,12862,215,1
2339149,3972029,97,134,4258,0,4355,134,1
82918,1996461,88,173,3786,0,3874,173,1
2465641,1871649,383,83,2507,0,2890,83,1
3280389,3038061,1101,1,411419,0,412520,1,1
4425126,3404451,25,2,136,0,161,2,1
2050190,2676437,153,6,9156,0,9309,6,1
4641209,4819996,21,65,247,0,268,65,1
3065808,427590,1235,32,82317,0,83552,32,1
3767831,3267664,19,53,198,0,217,53,1
3509903,3580212,1530,1,509445,0,510975,1,1
3872736,1505461,258,6,12660,0,12918,6,1
3361377,1036512,4841,1,761793,0,766634,1,1
2763282,4506802,321,2,10936,0,11257,2,1
2343253,1159575,1882,4,86401,0,88283,4,1
3514277,2640743,1338,53,13269,0,14607,53,1
4644889,1299844,144,17,3031,0,3175,17,1
4416945,4577709,417,55,33228,0,33645,55,1
2514271,2859814,387,86,19070,0,19457,86,1
3242275,4722276,551,125,17400,0,17951,125,1
253352,202878,237,229,10413,0,10650,229,1
2553405,4380630,568,92,12913,0,13481,92,1
1116703,2141292,533,7,2891,0,3424,7,1
435003,4807231,92,242,1730,0,1822,242,1
3514277,399158,1338,18,13269,0,14607,18,1
94649,2581406,21,5,513,0,534,5,1
2961801,4361661,1483,102,101962,0,103445,102,1
871344,4424632,263,140,1863,304,2126,444,1
1966548,3410339,208,1,53149,0,53357,1,1
2405789,4441878,1010,1,93387,0,94397,1,1
1403753,4201686,31,48,132,0,163,48,1
2522799,3890700,253,1,3062,0,3315,1,1
1903752,3293587,506,73,10494,0,11000,73,1
4272102,63081,1608,31,104171,0,105779,31,1
1580988,2604077,2821,1,400133,0,402954,1,1
690157,2237802,128,77,1856,0,1984,77,1
3449530,1340442,717,221,73648,0,74365,221,1
3542719,873740,90,23,880,0,970,23,1
4072323,2230522,144,421,194,0,338,421,1
4451122,2506613,985,44,41669,0,42654,44,1
3835618,1628085,694,47,25433,0,26127,47,1
2961552,2979151,562,7,16546,0,17108,7,1
3837347,3113009,169,87,2761,0,2930,87,1
3361377,2836874,4841,4,761793,0,766634,4,1
2887240,4207932,1143,3,118405,0,119548,3,1
431709,619139,205,1,5602,0,5807,1,1
3995686,4700546,113,122,6154,0,6267,122,1
3567974,3662555,35,6,521,0,556,6,1
3280389,4100332,1101,1,411419,0,412520,1,1
3765475,2473789,873,2,107914,0,108787,2,1
4058687,699117,418,6,3486,0,3904,6,1
3361377,1485751,4841,2,761793,0,766634,2,1
2569009,4682865,424,94,13423,0,13847,94,1
3655780,4516121,342,13,1301,0,1643,13,1
3272604,256882,4,164,487,0,491,164,1
348068,2207248,123,63,112,0,235,63,1
2494800,2497908,752,222,5329,0,6081,222,1
4576493,3273669,679,3,933,0,1612,3,1
708440,995220,302,4,9329,0,9631,4,1
3135952,611071,56,27,593,0,649,27,1
2961552,4156165,562,85,16546,0,17108,85,1
802229,4164048,168,94,3140,0,3308,94,1
1420087,2707418,204,500,1781,0,1985,500,1
4058687,958397,418,1351,3486,0,3904,1351,1
2513691,1812549,244,7,17485,0,17729,7,1
3280389,1744680,1101,2,411419,0,412520,2,1
1100354,4139723,163,1,24439,0,24602,1,1
1652056,2356558,326,3,66845,0,67171,3,1
1621187,2183946,165,1,1812,0,1977,1,1
3509903,4812164,1530,15,509445,0,510975,15,1
4778890,4116806,46,48,664,0,710,48,1
3836080,4568027,1197,107,59457,0,60654,107,1
932720,1284203,1411,30,111323,0,112734,30,1
2887240,3604092,1143,2,118405,0,119548,2,1
1645716,2193847,70,27,1361,0,1431,27,1
3898535,3406019,59,13,9303,0,9362,13,1
161276,3866482,146,77,6548,0,6694,77,1
4004339,267682,153,47,6086,463,6239,510,1
2202415,1109717,113,35,1713,0,1826,35,1
1880135,3608251,810,50,71924,0,72734,50,1
382977,3937380,143,73,5934,0,6077,73,1
1927974,2286149,107,38,9317,0,9424,38,1
4087774,3014073,578,31,10107,0,10685,31,1
3364515,1662319,109,1,3529,0,3638,1,1
2343253,3385279,1882,66,86401,0,88283,66,1
1632970,910118,68,9,1727,0,1795,9,1
1973082,2680126,1036,105,18915,225,19951,330,1
1580988,2165277,2821,2,400133,0,402954,2,1
805360,2909067,1514,153,119306,0,120820,153,1
4209323,4444107,1630,28,89460,0,91090,28,1
1609659,2212939,523,15,29763,0,30286,15,1
3734245,1450237,915,165,34965,0,35880,165,1
2849622,2800630,117,1,2673,0,2790,1,1
4360960,4104183,1642,4,110084,0,111726,4,1
4360960,1704043,1642,28,110084,0,111726,28,1
408965,4811977,903,60,38623,0,39526,60,1
2592965,2927886,567,214,1811,0,2378,214,1
2674718,4220946,136,5,5233,0,5369,5,1
4140279,719364,337,15,49384,0,49721,15,1
4593330,3469886,203,178,8083,0,8286,178,1
663087,3333011,551,79,3410,0,3961,79,1
4519298,1144491,577,3,14443,0,15020,3,1
2341040,1984172,75,177,648,0,723,177,1
4451122,577573,985,51,41669,0,42654,51,1
4295952,1200209,808,32,57369,0,58177,32,1
835513,4640821,67,62,644,0,711,62,1
1250021,794501,4637,24,85913,0,90550,24,1
4423184,1583462,384,84,29809,0,30193,84,1
2375878,1088345,248,4,14925,0,15173,4,1
4220190,3573424,320,106,15994,0,16314,106,1
1217747,3382646,30,2,208,0,238,2,1
2308819,2513052,141,7,5491,0,5632,7,1
4417253,3284782,1130,164,68389,0,69519,164,1
4011264,3488714,1360,166,116777,0,118137,166,1
963245,1657040,207,24,1849,0,2056,24,1
1580508,301805,720,25,19611,0,20331,25,1
1761151,2984234,260,14,4153,0,4413,14,1
3825502,3509422,62,255,235,1344,297,1599,1
4411870,1789605,948,5,60517,0,61465,5,1
3509903,1208047,1530,3,509445,0,510975,3,1
474172,773345,471,6,38713,0,39184,6,1
3137900,2035838,357,79,6655,0,7012,79,1
3438576,1478748,3424,9,137753,0,141177,9,1
4133593,2365306,161,146,1900,0,2061,146,1
1652056,1666424,326,1,66845,0,67171,1,1
3361377,2904095,4841,1,761793,0,766634,1,1
4192206,4086564,468,50,18229,0,18697,50,1
3043130,426285,285,149,1773,0,2058,149,1
2342664,2806428,1181,232,26502,4940,27683,5172,1
3294702,2575608,991,175,68888,0,69879,175,1
259575,3744135,260,5,13949,0,14209,5,1
4404761,4641751,247,35,1238,0,1485,35,1
2536472,3079345,344,7,9725,0,10069,7,1
3758692,2274225,711,64,34731,0,35442,64,1
3294702,1612785,991,397,68888,0,69879,397,1
259575,4380179,260,14,13949,0,14209,14,1
940526,4030763,475,63,20786,0,21261,63,1
4816740,693181,141,128,7750,0,7891,128,1
4417253,4165652,1130,30,68389,0,69519,30,1
4317718,2560605,111,1,3149,0,3260,1,1
262893,1194212,161,60,3792,0,3953,60,1
439557,1727311,2090,14,61744,0,63834,14,1
941509,2285172,106,134,3066,0,3172,134,1
4313572,3582234,930,3,16971,0,17901,3,1
408965,1290322,903,144,38623,0,39526,144,1
4183784,2260264,931,82,59894,0,60825,82,1
648313,2051827,75,58,666,0,741,58,1
2685897,4448503,38,121,4789,0,4827,121,1
2837948,4541367,83,175,1320,476,1403,651,1
2088912,2021130,64,1,1178,0,1242,1,1
1594907,1676904,301,301,1458,1455,1759,1756,1
3509903,3424962,1530,2,509445,0,510975,2,1
4798392,3517392,80,38,373,0,453,38,1
3509903,1982857,1530,2,509445,0,510975,2,1
3280389,4175273,1101,1,411419,0,412520,1,1
4604311,4467281,29,1,7472,0,7501,1,1
4735218,162239,252,152,5309,0,5561,152,1
3545321,3833837,239,16,4366,0,4605,16,1
4448612,1449443,11,4,270,0,281,4,1
4417253,4339888,1130,28,68389,0,69519,28,1
941640,1603289,336,360,677,873,1013,1233,1
3361377,4465705,4841,2,761793,0,766634,2,1
2356664,3918688,273,128,6808,0,7081,128,1
3936039,4209323,799,1630,23884,89460,24683,91090,1
1580988,3269456,2821,13,400133,0,402954,13,1
2209136,207780,620,49,33789,0,34409,49,1
1752071,3981,175,5,1035,0,1210,5,1
2260014,1415800,2466,67,98622,301,101088,368,1
6618,2152677,892,24,68849,0,69741,24,1
94742,817948,264,340,1526,1983,1790,2323,1
1549334,3619182,81,3,6693,0,6774,3,1
2283004,2768815,143,5,2253,0,2396,5,1
2851109,3564832,450,86,98552,0,99002,86,1
3839956,3094886,183,675,1443,6621,1626,7296,1
3632293,1857507,570,1,21294,0,21864,1,1
3449530,4140465,717,36,73648,0,74365,36,1
592541,2543611,132,3,6913,0,7045,3,1
2249093,1971168,134,11,2139,0,2273,11,1
427805,3693862,483,4,156906,0,157389,4,1
3509903,4278829,1530,2,509445,0,510975,2,1
2022555,1730398,35,4,1068,0,1103,4,1
1541866,332003,542,306,16481,0,17023,306,1
273363,4087474,768,1058,11045,0,11813,1058,1
3140664,981240,268,56,16099,0,16367,56,1
3764177,3412855,1036,1,64563,0,65599,1,1
2260014,2125310,2466,2,98622,0,101088,2,1
1580988,1734263,2821,2,400133,0,402954,2,1
3214323,1950248,147,2,12543,0,12690,2,1
1652056,2432995,326,2,66845,0,67171,2,1
2827436,486899,882,1,271525,0,272407,1,1
3361377,4562582,4841,37,761793,0,766634,37,1
3509903,2404985,1530,1,509445,0,510975,1,1
2897926,2026003,565,3,25983,0,26548,3,1
805360,2574543,1514,18,119306,0,120820,18,1
1063358,4101435,1350,25,63494,0,64844,25,1
611927,3935488,305,2,8695,0,9000,2,1
1796080,753086,316,1,2237,0,2553,1,1
4755188,2835341,75,29,1893,0,1968,29,1
4110535,4662359,395,35,7311,0,7706,35,1
2182964,2959705,214,20,6975,0,7189,20,1
4624595,4206212,722,176,53368,0,54090,176,1
1532833,21286,418,64,546,0,964,64,1
4843360,2144603,355,233,7866,0,8221,233,1
4853234,1541786,1256,128,29554,271,30810,399,1
3907996,1293673,485,2,18964,0,19449,2,1
4289995,337387,525,113,4959,0,5484,113,1
386424,4599914,131,14,7871,0,8002,14,1
3235479,2561905,999,23,66486,0,67485,23,1
1031334,1208862,459,175,16840,0,17299,175,1
2621271,4035382,82,16,350,0,432,16,1
354904,2715390,3193,13,105780,0,108973,13,1
2094626,4541367,194,175,2066,476,2260,651,1
1863920,2854812,54,11,283,0,337,11,1
941212,2751990,184,1,6404,0,6588,1,1
1512714,3654423,253,60,6663,0,6916,60,1
1179906,616665,316,342,14467,0,14783,342,1
3137585,3227331,1196,97,77354,0,78550,97,1
3583982,4344949,32,2,143,0,175,2,1
965719,1267070,139,2,1414,0,1553,2,1
2343253,2535163,1882,1,86401,0,88283,1,1
1276253,547580,407,1,46534,0,46941,1,1
2624998,2151635,52,60,394,0,446,60,1
1195333,1069882,64,87,431,0,495,87,1
1497278,1767687,1869,148,35111,291,36980,439,1
2872979,379377,341,251,28510,0,28851,251,1
4417253,3222709,1130,23,68389,0,69519,23,1
3509903,2439321,1530,1,509445,0,510975,1,1
3509903,4131677,1530,3,509445,0,510975,3,1
3266994,834699,116,244,1655,0,1771,244,1
3280389,1012370,1101,1,411419,0,412520,1,1
2961801,4387809,1483,82,101962,0,103445,82,1
3361377,2510026,4841,2,761793,0,766634,2,1
4451122,118244,985,13,41669,0,42654,13,1
3638272,4381789,2022,7,370904,0,372926,7,1
3638272,2971979,2022,1,370904,0,372926,1,1
1302093,945459,48,2,1219,0,1267,2,1
4107206,748911,36,435,233,687,269,1122,1
3701200,2024492,29,4,98,0,127,4,1
307250,3486216,919,32,35588,0,36507,32,1
1539837,4590180,1127,43,62979,0,64106,43,1
3844858,2681104,1591,80,28974,0,30565,80,1
4191410,4330769,1590,6,96434,0,98024,6,1
1533225,2100767,780,9,268,0,1048,9,1
2428341,4238001,826,869,10151,61161,10977,62030,1
1355516,3547433,315,1,2436,0,2751,1,1
3676295,4094574,374,1,70881,0,71255,1,1
3509903,1095427,1530,1,509445,0,510975,1,1
2206273,4654456,235,3,4892,0,5127,3,1
487744,4377393,138,140,2488,0,2626,140,1
2849738,2557882,61,2,3795,0,3856,2,1
948375,2060270,113,2,4186,0,4299,2,1
4535241,4556847,227,495,587,117,814,612,1
366983,4117661,34,1,1630,0,1664,1,1
3037644,2238521,71,18,2219,0,2290,18,1
842476,1171731,898,4,12479,0,13377,4,1
3651179,4166656,1752,48,2979,0,4731,48,1
3361377,284472,4841,4,761793,0,766634,4,1
3123201,1360529,126,2,5539,0,5665,2,1
3140664,3274345,268,213,16099,0,16367,213,1
4825760,1339201,111,22,1979,0,2090,22,1
3004174,2665883,258,196,5546,0,5804,196,1
1067623,2871268,118,18,273,0,391,18,1
3592993,1793832,85,10,452,0,537,10,1
4762204,4346725,2239,2,4518,0,6757,2,1
4191410,2836243,1590,55,96434,0,98024,55,1
2437380,2320467,36,175,216,0,252,175,1
4705188,1180435,336,157,8658,0,8994,157,1
1652056,3555056,326,1,66845,0,67171,1,1
4738916,4179278,1165,57,34124,0,35289,57,1
4731914,742225,257,9,1886,0,2143,9,1
1580988,867609,2821,1,400133,0,402954,1,1
3879570,1762320,152,11,1376,0,1528,11,1
1370197,4737869,665,26,3306,0,3971,26,1
3242275,3296259,551,7,17400,0,17951,7,1
1494665,1970424,668,5,37638,0,38306,5,1
4467395,624392,2084,12,14574,0,16658,12,1
3639125,3390098,70,37,113,0,183,37,1
1632616,3231083,218,8,1963,0,2181,8,1
4853007,3379680,274,489,200,142,474,631,1
3361377,3215320,4841,2,761793,0,766634,2,1
2375878,3414771,248,3,14925,0,15173,3,1
2781817,1185502,704,197,24613,1739,25317,1936,1
1201711,2810984,357,3,15948,0,16305,3,1
1847461,144031,1211,27,51149,0,52360,27,1
4368381,2345106,3,13,588,0,591,13,1
1476977,1107648,178,127,1993,1336,2171,1463,1
593740,609354,1107,57,62807,0,63914,57,1
1063358,1005761,1350,80,63494,0,64844,80,1
355833,365348,17,82,173,0,190,82,1
1206079,356401,200,85,247,160,447,245,1
2419018,2018881,101,1284,944,451,1045,1735,1
3835618,965178,694,72,25433,0,26127,72,1
1534362,1458609,1531,108,105859,0,107390,108,1
2200397,4033641,8,1,54,0,62,1,1
1201711,4417253,357,1130,15948,68389,16305,69519,1
3167388,2818399,203,3,9760,0,9963,3,1
3911134,2732723,115,556,2693,0,2808,556,1
3280389,2940831,1101,1,411419,0,412520,1,1
1331940,1703476,802,13,32617,0,33419,13,1
1250021,3426794,4637,35,85913,0,90550,35,1
4507127,3657685,47,393,1288,0,1335,393,1
3638272,4155406,2022,1,370904,0,372926,1,1
3361377,2260464,4841,2,761793,0,766634,2,1
2524671,2894941,140,9,7015,0,7155,9,1
3638272,4621985,2022,1,370904,0,372926,1,1
1306885,4084658,172,5,3706,0,3878,5,1
405025,1582661,51,13,852,0,903,13,1
471706,975942,794,4,65616,0,66410,4,1
3137585,2623923,1196,47,77354,0,78550,47,1
690346,3071856,236,122,1994,0,2230,122,1
1196844,4799877,548,4,36289,0,36837,4,1
3561502,1455618,1144,15,68800,0,69944,15,1
3035429,2599843,26,373,265,273,291,646,1
4256261,2217319,177,4,2001,0,2178,4,1
354904,1983798,3193,24,105780,0,108973,24,1
724436,2403618,217,127,2547,0,2764,127,1
4302921,4653216,509,55,13289,0,13798,55,1
3361377,2087236,4841,2,761793,0,766634,2,1
2652639,2657284,360,2605,967,690,1327,3295,1
4122296,4319457,35,3,1071,0,1106,3,1
2861639,4739188,481,48,10848,0,11329,48,1
3104446,1628882,86,3,1588,0,1674,3,1
3175020,1016379,25,45,215,0,240,45,1
4037698,1141372,130,11,1482,0,1612,11,1
3102873,270096,341,440,15098,0,15439,440,1
4524689,1246920,491,89,3821,0,4312,89,1
3235479,596641,999,53,66486,0,67485,53,1
3875080,1844733,285,52,5153,0,5438,52,1
2226235,2962937,38,27,897,0,935,27,1
1771898,1087665,104,313,499,0,603,313,1
4327222,1936447,42,167,187,2268,229,2435,1
837553,4551640,1249,15,61665,0,62914,15,1
4496752,60437,554,240,16258,0,16812,240,1
4624595,2678725,722,8,53368,0,54090,8,1
427805,3593161,483,1,156906,0,157389,1,1
3361377,618717,4841,6,761793,0,766634,6,1
2688678,724276,194,802,1861,0,2055,802,1
439557,689489,2090,1,61744,0,63834,1,1
2981537,242865,1252,7,118718,0,119970,7,1
3509903,3814418,1530,1,509445,0,510975,1,1
2628417,3926071,11,63,689,65,700,128,1
765601,4070098,1485,44,101510,0,102995,44,1
3066330,233722,97,6,2081,0,2178,6,1
1534362,137547,1531,36,105859,0,107390,36,1
185943,2689563,620,328,6573,0,7193,328,1
2307868,60302,1131,2,38777,0,39908,2,1
530200,3419900,2035,12,62809,0,64844,12,1
1232882,2306586,75,4,6386,0,6461,4,1
2981537,2753201,1252,2,118718,0,119970,2,1
4069373,4838393,97,1,3470,0,3567,1,1
3691520,2896176,533,48,9121,0,9654,48,1
1818911,3558423,425,17,2972,0,3397,17,1
530200,3728326,2035,1,62809,0,64844,1,1
3509903,1986465,1530,1,509445,0,510975,1,1
2462210,872718,96,20,1606,0,1702,20,1
1063358,445972,1350,93,63494,0,64844,93,1
504676,28970,921,158,2940,0,3861,158,1
2109919,435165,46,2,5772,0,5818,2,1
3914135,3500776,2152,201,60084,0,62236,201,1
1056518,2623651,659,56,3945,0,4604,56,1
4011264,3399560,1360,23,116777,0,118137,23,1
2259527,4302921,62,509,628,13289,690,13798,1
3235479,2929161,999,19,66486,0,67485,19,1
4604311,2467384,29,1,7472,0,7501,1,1
445996,1939241,1175,261,12828,0,14003,261,1
52770,3420312,58,1,466,0,524,1,1
1486836,2596871,43,7,2752,0,2795,7,1
4106313,2038853,161,289,3004,0,3165,289,1
2230342,1412887,30,2,3940,0,3970,2,1
2209136,911950,620,16,33789,0,34409,16,1
2342664,3701922,1181,147,26502,0,27683,147,1
3396719,1364108,660,46,8141,0,8801,46,1
3206499,2936305,1337,25,32033,0,33370,25,1
3509903,2282596,1530,3,509445,0,510975,3,1
3280389,4290122,1101,2,411419,0,412520,2,1
2779329,728103,217,127,6021,0,6238,127,1
435003,4684883,92,10,1730,0,1822,10,1
3758692,1711385,711,48,34731,0,35442,48,1
4208044,4372007,247,86,3919,0,4166,86,1
3668051,491543,89,11,3044,0,3133,11,1
1769943,3899805,553,10,7901,0,8454,10,1
4209323,2300221,1630,129,89460,0,91090,129,1
4624595,743384,722,35,53368,0,54090,35,1
2981537,1506838,1252,1,118718,0,119970,1,1
2197837,1378415,97,18,1984,0,2081,18,1
954784,149105,567,2,14450,0,15017,2,1
1249227,1633045,621,69,7423,0,8044,69,1
255132,4553033,102,128,1348,1503,1450,1631,1
1710474,1556436,154,1,1649,0,1803,1,1
3414365,1850058,94,99,1102,0,1196,99,1
1927211,3539104,1668,69,113322,0,114990,69,1
241332,3881634,446,641,2086,8471,2532,9112,1
2164338,2302127,292,2,1746,0,2038,2,1
2348093,4308088,335,93,12064,0,12399,93,1
3815269,1493581,213,74,7440,0,7653,74,1
748019,4030547,675,10,18480,0,19155,10,1
4423184,3544892,384,1,29809,0,30193,1,1
3361377,540868,4841,1,761793,0,766634,1,1
3280389,2691870,1101,1,411419,0,412520,1,1
3549674,25927,602,150,38542,0,39144,150,1
3914135,2658727,2152,54,60084,0,62236,54,1
733639,2906370,259,271,3744,4802,4003,5073,1
4313572,2895880,930,1,16971,0,17901,1,1
1487501,2595839,55,23,473,0,528,23,1
196521,3731113,1176,31,11269,0,12445,31,1
4518291,986325,2,18,223,0,225,18,1
932720,1900619,1411,133,111323,0,112734,133,1
4659435,3870810,22,44,245,0,267,44,1
1697778,4370498,125,110,3760,0,3885,110,1
1629019,3230140,351,201,5823,0,6174,201,1
3739473,2294878,448,24,13226,0,13674,24,1
2209136,624872,620,187,33789,0,34409,187,1
3280389,105165,1101,4,411419,0,412520,4,1
1250021,2359143,4637,18,85913,0,90550,18,1
1875,2660928,656,4,61388,0,62044,4,1
866888,736957,391,196,2049,0,2440,196,1
3739473,2148082,448,8,13226,0,13674,8,1
1927974,4294584,107,56,9317,0,9424,56,1
6618,2175001,892,5,68849,0,69741,5,1
1895439,4102404,270,86,613,0,883,86,1
4411870,3708282,948,111,60517,0,61465,111,1
530200,3965761,2035,2,62809,0,64844,2,1
4360960,3652665,1642,132,110084,0,111726,132,1
2632429,280464,108,32,1535,0,1643,32,1
593740,3071754,1107,63,62807,0,63914,63,1
3509903,805588,1530,1,509445,0,510975,1,1
2772113,4189596,792,57,42907,0,43699,57,1
1822719,3391292,285,37,22351,0,22636,37,1
97450,2723295,165,17,1955,0,2120,17,1
4301309,1502781,323,34,4103,0,4426,34,1
427805,3365121,483,1,156906,0,157389,1,1
3235479,3783979,999,49,66486,0,67485,49,1
4411870,4155271,948,67,60517,0,61465,67,1
3549674,1828178,602,162,38542,0,39144,162,1
1659017,2359313,817,67,13055,0,13872,67,1
1276253,3119728,407,1,46534,0,46941,1,1
4191410,1627241,1590,191,96434,0,98024,191,1
3361377,3688351,4841,1,761793,0,766634,1,1
1588330,3477244,694,48,10280,0,10974,48,1
3361377,4517452,4841,2,761793,0,766634,2,1
1033986,2783377,3,1,48,0,51,1,1
3569179,4820017,1064,15,40015,0,41079,15,1
2120963,1639434,136,587,1318,8053,1454,8640,1
2345899,1451822,346,30,1736,0,2082,30,1
3408428,2106907,71,364,449,0,520,364,1
1140134,3051883,311,124,11111,0,11422,124,1
2950311,2688801,807,15,85116,0,85923,15,1
1276253,2974634,407,1,46534,0,46941,1,1
1063358,3077752,1350,803,63494,0,64844,803,1
3590948,4093134,492,34,2943,0,3435,34,1
3765475,4817637,873,3,107914,0,108787,3,1
2147720,795021,1608,74,78786,0,80394,74,1
3361377,1491022,4841,2,761793,0,766634,2,1
3118804,908165,315,182,6025,0,6340,182,1
4731849,442840,455,9,10886,0,11341,9,1
3115867,1987960,1350,17,61232,0,62582,17,1
2897926,532208,565,1,25983,0,26548,1,1
1301815,4237014,752,94,48944,0,49696,94,1
3176788,1016352,95,37,1038,0,1133,37,1
1644171,322877,1071,73,3690,0,4761,73,1
4011264,1524259,1360,33,116777,0,118137,33,1
21944,2108782,317,19,9419,0,9736,19,1
2261139,1336944,2014,84,42851,0,44865,84,1
4361636,59981,186,307,1867,0,2053,307,1
4505464,3118482,99,14,2637,0,2736,14,1
2490914,1025558,570,166,22965,0,23535,166,1
4440160,754533,736,200,20522,0,21258,200,1
3431613,1413650,234,114,1959,0,2193,114,1
1575009,4796058,429,1,37745,0,38174,1,1
504676,50062,921,108,2940,0,3861,108,1
256791,354904,141,3193,198,105780,339,108973,1
1638032,594378,91,7,3942,0,4033,7,1
4149765,4185838,210,1,1961,0,2171,1,1
3361377,3166414,4841,2,761793,0,766634,2,1
2911269,1300721,740,157,20606,0,21346,157,1
2342664,2537482,1181,249,26502,0,27683,249,1
1539837,4503879,1127,21,62979,0,64106,21,1
2355163,1434771,353,11,629,0,982,11,1
1973082,233961,1036,8,18915,0,19951,8,1
2075015,976416,2664,10,85781,0,88445,10,1
4440160,1598859,736,135,20522,0,21258,135,1
4547438,4479507,1291,51,25237,0,26528,51,1
1763249,438860,1,1,268,0,269,1,1
3638272,1271895,2022,18,370904,0,372926,18,1
1191030,3163452,13,84,194,297,207,381,1
2961801,1979699,1483,21,101962,0,103445,21,1
1250021,3167317,4637,12,85913,0,90550,12,1
3561502,3736282,1144,34,68800,0,69944,34,1
4517979,2995529,104,88,2055,0,2159,88,1
2307868,943242,1131,15,38777,0,39908,15,1
2981537,249423,1252,4,118718,0,119970,4,1
3739473,1827009,448,243,13226,0,13674,243,1
3849982,4401420,84,175,494,0,578,175,1
2096270,2507510,970,23,26018,0,26988,23,1
514623,2245782,130,18,1367,0,1497,18,1
4727207,1493076,925,11,84581,0,85506,11,1
1512714,1507861,253,83,6663,0,6916,83,1
4560210,3623614,177,2,6565,0,6742,2,1
2861639,4697425,481,45,10848,0,11329,45,1
3058068,1546725,124,38,12734,0,12858,38,1
1512714,3323476,253,26,6663,0,6916,26,1
462298,2435234,414,363,10933,0,11347,363,1
1966548,3168329,208,1,53149,0,53357,1,1
1534362,3154861,1531,4,105859,0,107390,4,1
610143,3125048,26,19,2000,0,2026,19,1
4365938,3860687,250,29,10362,0,10612,29,1
1441897,3314027,52,231,1657,0,1709,231,1
3361377,4580474,4841,1,761793,0,766634,1,1
4781147,3532300,161,45,2894,0,3055,45,1
56275,4099753,7,29,52,0,59,29,1
2092359,1542987,421,4,26936,0,27357,4,1
2744944,1924911,274,9,375,0,649,9,1
866357,3005456,825,18,18479,0,19304,18,1
2164338,249932,292,93,1746,981,2038,1074,1
2569009,2950661,424,71,13423,0,13847,71,1
3361377,558073,4841,2,761793,0,766634,2,1
3898535,3274480,59,84,9303,0,9362,84,1
2502456,4562718,719,4,50725,0,51444,4,1
3280389,2291788,1101,2,411419,0,412520,2,1
3638272,1688579,2022,3,370904,0,372926,3,1
1580988,2068532,2821,2,400133,0,402954,2,1
932720,181748,1411,64,111323,0,112734,64,1
3539834,508883,15,76,1854,116,1869,192,1
3438576,310708,3424,83,137753,1665,141177,1748,1
1794799,703646,182,28,886,0,1068,28,1
4011264,3555926,1360,25,116777,0,118137,25,1
896198,2783788,150,61,1374,0,1524,61,1
307250,3200757,919,460,35588,0,36507,460,1
1497278,1868109,1869,6,35111,0,36980,6,1
3509903,3900818,1530,2,509445,0,510975,2,1
2260014,3158596,2466,110,98622,279,101088,389,1
3112136,1062967,406,260,41366,15276,41772,15536,1
4552666,2809754,341,125,9279,0,9620,125,1
1534362,4674316,1531,86,105859,0,107390,86,1
4272102,1524159,1608,35,104171,0,105779,35,1
1722916,416281,68,489,850,0,918,489,1
298564,472639,662,69,6261,0,6923,69,1
4381750,2548009,798,251,153,408,951,659,1
2785706,2700528,130,896,1838,0,1968,896,1
3870873,1851844,36,8,1423,0,1459,8,1
2096270,1655426,970,24,26018,0,26988,24,1
2027108,4813006,1172,14,5587,0,6759,14,1
1805743,2110547,316,1,3694,0,4010,1,1
1075792,1993733,181,75,4505,0,4686,75,1
1276253,4322111,407,1,46534,0,46941,1,1
3509903,2687982,1530,1,509445,0,510975,1,1
2851109,3565872,450,8,98552,0,99002,8,1
1580988,186629,2821,2,400133,0,402954,2,1
4560210,20028,177,3,6565,0,6742,3,1
1580988,3063974,2821,2,400133,0,402954,2,1
3638272,1244452,2022,2,370904,0,372926,2,1
2922412,2568656,464,99,3629,0,4093,99,1
3509903,110692,1530,2,509445,0,510975,2,1
1870921,3308724,182,4,8739,0,8921,4,1
3361377,692037,4841,1,761793,0,766634,1,1
1851726,1873042,28,48,228,0,256,48,1
2961801,2909512,1483,40,101962,0,103445,40,1
4636168,4418505,215,50,1967,0,2182,50,1
6618,1907220,892,63,68849,0,69741,63,1
354904,3560314,3193,2,105780,0,108973,2,1
1689502,3129758,63,4,3676,0,3739,4,1
2475404,518954,9,4,137,0,146,4,1
4209323,1374966,1630,6,89460,0,91090,6,1
3438576,560521,3424,9,137753,0,141177,9,1
515290,255196,285,121,34080,0,34365,121,1
4811103,4515473,110,40,1639,0,1749,40,1
703912,3336056,119,4,5153,0,5272,4,1
4653941,3745239,951,1,45883,0,46834,1,1
1533546,2199247,703,61,22095,1954,22798,2015,1
2827436,4834140,882,3,271525,0,272407,3,1
3438576,3057903,3424,36,137753,0,141177,36,1
3872736,4541141,258,1,12660,0,12918,1,1
3757062,36969,107,6,787,0,894,6,1
2827436,2509831,882,1,271525,0,272407,1,1
2872979,3243816,341,8,28510,0,28851,8,1
2887240,2298704,1143,2,118405,0,119548,2,1
544230,3932951,1532,13,60768,0,62300,13,1
2687552,3225479,238,48,25574,0,25812,48,1
1580988,2486036,2821,56,400133,0,402954,56,1
837553,1742962,1249,8,61665,0,62914,8,1
1984622,4085350,145,3,20659,0,20804,3,1
2343253,1515230,1882,14,86401,0,88283,14,1
2007528,1667695,171,1,696,0,867,1,1
3935366,4373469,377,102,3803,0,4180,102,1
4451491,3054589,817,68,8836,1104,9653,1172,1
3024759,175901,96,168,1654,0,1750,168,1
3569179,776707,1064,2,40015,0,41079,2,1
2031305,1861393,396,6,23435,0,23831,6,1
4334842,3261972,85,359,4749,0,4834,359,1
3361377,4644077,4841,41,761793,0,766634,41,1
932720,569319,1411,53,111323,0,112734,53,1
471706,555248,794,46,65616,0,66410,46,1
2885394,4328024,174,92,3481,0,3655,92,1
3638272,4132812,2022,2,370904,0,372926,2,1
1539837,2035884,1127,56,62979,0,64106,56,1
427805,1947725,483,32,156906,0,157389,32,1
1533546,286204,703,115,22095,0,22798,115,1
2981537,716496,1252,56,118718,0,119970,56,1
3361377,1534570,4841,3,761793,0,766634,3,1
3361377,3986585,4841,8,761793,0,766634,8,1
3672963,2659483,130,183,5192,0,5322,183,1
1513092,560222,180,5,1287,0,1467,5,1
805360,4726596,1514,65,119306,0,120820,65,1
4451491,3755943,817,407,8836,0,9653,407,1
262893,316617,161,56,3792,0,3953,56,1
4441473,1803437,103,307,1371,0,1474,307,1
755739,458735,1117,34,58043,0,59160,34,1
3509903,2427547,1530,51,509445,0,510975,51,1
4628096,1242929,219,65,5074,0,5293,65,1
573281,1080781,139,17,1990,0,2129,17,1
159285,2281680,240,101,4650,0,4890,101,1
3242275,2199796,551,168,17400,0,17951,168,1
3517464,1791915,19,7,171,0,190,7,1
3280389,1732666,1101,1,411419,0,412520,1,1
544230,1762499,1532,132,60768,0,62300,132,1
3361377,679756,4841,4,761793,0,766634,4,1
2998026,3127165,919,5,24182,0,25101,5,1
2851109,1229024,450,3,98552,0,99002,3,1
2961801,2825124,1483,8,101962,0,103445,8,1
592541,186484,132,3,6913,0,7045,3,1
3137585,3842123,1196,67,77354,0,78550,67,1
2580348,2653099,164,106,1662,0,1826,106,1
3260961,1255659,288,88,7637,0,7925,88,1
2827436,1265909,882,1,271525,0,272407,1,1
3676295,866194,374,1,70881,0,71255,1,1
3438576,3750771,3424,3,137753,0,141177,3,1
2872979,3002325,341,12,28510,0,28851,12,1
3844858,2315034,1591,134,28974,0,30565,134,1
2827436,3682295,882,1,271525,0,272407,1,1
1580988,3757717,2821,1,400133,0,402954,1,1
3177962,700179,40,13,519,0,559,13,1
354904,1185530,3193,5,105780,0,108973,5,1
4638388,4838121,55,22,426,0,481,22,1
354904,2830198,3193,3,105780,0,108973,3,1
309382,1807770,135,19,4536,0,4671,19,1
3280389,2709893,1101,1,411419,0,412520,1,1
3929270,982261,257,36,2972,0,3229,36,1
1580988,4683714,2821,1,400133,0,402954,1,1
4519026,3755972,58,4,1929,0,1987,4,1
4313572,4829305,930,5,16971,0,17901,5,1
3906136,563203,387,22,41169,0,41556,22,1
2827436,3969549,882,1,271525,0,272407,1,1
4798192,4233456,816,171,20426,0,21242,171,1
1580988,1416200,2821,55,400133,0,402954,55,1
3531730,4744790,334,47,9763,0,10097,47,1
427805,1199142,483,1,156906,0,157389,1,1
782368,537680,586,10,1146,0,1732,10,1
4461896,3526804,120,7,1345,0,1465,7,1
4798192,4563525,816,36,20426,0,21242,36,1
471706,1296574,794,75,65616,0,66410,75,1
755739,3621059,1117,11,58043,0,59160,11,1
284877,4573926,107,175,3215,0,3322,175,1
427805,4582715,483,2,156906,0,157389,2,1
60980,1501951,649,4,20708,0,21357,4,1
3361377,1767374,4841,26,761793,0,766634,26,1
4528103,3359256,268,7,14258,0,14526,7,1
4106142,1624638,306,311,3436,0,3742,311,1
1580988,3430352,2821,1,400133,0,402954,1,1
3280389,4087006,1101,22,411419,0,412520,22,1
4360960,1944889,1642,29,110084,0,111726,29,1
3549674,436618,602,96,38542,0,39144,96,1
3509903,1742826,1530,2,509445,0,510975,2,1
1580988,3134347,2821,2,400133,0,402954,2,1
2670449,1433213,277,1033,3488,0,3765,1033,1
1580988,333631,2821,1,400133,0,402954,1,1
2064376,4649532,139,2,5873,0,6012,2,1
3638272,1710793,2022,1,370904,0,372926,1,1
3014712,4717522,79,913,123,395,202,1308,1
3638272,3780028,2022,5,370904,0,372926,5,1
1460845,1413422,72,1,1322,0,1394,1,1
1534362,1785838,1531,20,105859,0,107390,20,1
751729,3366295,244,19,1055,0,1299,19,1
4654551,3624536,94,51,525,0,619,51,1
4238001,2937124,869,25,61161,0,62030,25,1
1580988,2304358,2821,15,400133,0,402954,15,1
1527599,4196826,176,50,3575,0,3751,50,1
3758019,1327135,189,44,2783,0,2972,44,1
2314038,1048955,456,16,16347,0,16803,16,1
2837948,1358786,83,150,1320,0,1403,150,1
1148474,1463132,214,3,2785,0,2999,3,1
765601,413791,1485,103,101510,0,102995,103,1
1312969,1461009,7,1,90,0,97,1,1
2436781,3610722,689,56,9972,0,10661,56,1
3280389,1493744,1101,1,411419,0,412520,1,1
1486758,362340,337,52,11346,0,11683,52,1
2405789,190870,1010,132,93387,0,94397,132,1
3918618,2743659,299,420,3785,4277,4084,4697,1
2849622,4339945,117,5,2673,0,2790,5,1
253352,2091327,237,197,10413,0,10650,197,1
2950311,3143138,807,56,85116,0,85923,56,1
1927211,3332494,1668,5,113322,0,114990,5,1
2722942,888102,240,21,8655,0,8895,21,1
1303956,1545890,292,109,2659,0,2951,109,1
3214323,775653,147,32,12543,0,12690,32,1
3509903,3286629,1530,1,509445,0,510975,1,1
3361377,4002293,4841,2,761793,0,766634,2,1
4360960,765352,1642,47,110084,0,111726,47,1
427805,514852,483,1,156906,0,157389,1,1
3676295,765408,374,2,70881,0,71255,2,1
4782707,4234723,513,14,31665,0,32178,14,1
3176559,4648844,36,35,156,0,192,35,1
932720,4507521,1411,48,111323,0,112734,48,1
1762768,3676504,451,59,3478,0,3929,59,1
2405789,507121,1010,46,93387,0,94397,46,1
1966548,4429745,208,1,53149,0,53357,1,1
2617350,224611,256,214,6547,0,6803,214,1
3338906,1117,140,1,6745,0,6885,1,1
1580988,3832520,2821,1,400133,0,402954,1,1
3569179,1363705,1064,192,40015,0,41079,192,1
687713,1493080,436,1,47160,0,47596,1,1
2107861,3626658,535,1,25743,0,26278,1,1
3298300,1194208,128,61,4498,0,4626,61,1
1031334,1769414,459,100,16840,0,17299,100,1
1493489,4650530,523,34,17512,0,18035,34,1
4318206,2786817,251,111,13123,0,13374,111,1
3304867,1652052,217,13,1983,0,2200,13,1
2827436,2978416,882,4,271525,0,272407,4,1
3638272,2070760,2022,4,370904,0,372926,4,1
4319972,3482007,640,15,35279,0,35919,15,1
3408985,917975,205,208,6002,0,6207,208,1
378943,1123706,340,10,12563,0,12903,10,1
3835618,1699559,694,41,25433,0,26127,41,1
860473,1686435,751,166,20450,0,21201,166,1
1539837,1006238,1127,30,62979,0,64106,30,1
1601507,3741108,129,2,6006,0,6135,2,1
1723506,313337,733,479,21835,0,22568,479,1
3361377,4251489,4841,5,761793,0,766634,5,1
3586502,3764177,145,1036,1521,64563,1666,65599,1
2772113,2382975,792,116,42907,0,43699,116,1
544230,2380039,1532,167,60768,0,62300,167,1
1057351,4527443,44,1,2235,0,2279,1,1
3561222,897099,236,2,1461,0,1697,2,1
1503116,89810,415,56,37079,0,37494,56,1
1436216,4012928,1068,1,68770,0,69838,1,1
1839283,554920,765,1,36658,0,37423,1,1
3758692,373236,711,17,34731,0,35442,17,1
1192480,3595553,397,84,20737,333,21134,417,1
427805,3317114,483,7,156906,0,157389,7,1
3364515,1270128,109,8,3529,0,3638,8,1
2086091,3794274,142,585,674,2539,816,3124,1
4708537,2615194,119,1,885,0,1004,1,1
3671141,1703725,1444,12,48400,0,49844,12,1
2209136,2553080,620,14,33789,0,34409,14,1
502082,3578616,589,77,16428,0,17017,77,1
253352,4198695,237,9,10413,0,10650,9,1
427805,4059347,483,1,156906,0,157389,1,1
3500846,1285158,210,27,5085,0,5295,27,1
3257465,2992105,541,141,27614,0,28155,141,1
3509903,3154606,1530,1,509445,0,510975,1,1
4440160,2405446,736,161,20522,0,21258,161,1
1654099,338144,1180,41,26347,0,27527,41,1
4589966,3774834,82,7,2845,0,2927,7,1
1580988,1800423,2821,4,400133,0,402954,4,1
1250021,2648497,4637,9,85913,0,90550,9,1
3788003,227032,40,37,340,0,380,37,1
3441731,4167928,57,56,818,0,875,56,1
1654099,676965,1180,169,26347,0,27527,169,1
2827436,3399151,882,1,271525,0,272407,1,1
211698,2336697,138,1,2131,0,2269,1,1
5885,3317290,55,23,304,267,359,290,1
2163640,312927,129,175,5750,0,5879,175,1
3650069,1716626,217,1,4118,0,4335,1,1
3898535,1389855,59,48,9303,0,9362,48,1
4408813,3118695,288,4,10077,0,10365,4,1
3509903,4622386,1530,2,509445,0,510975,2,1
4191410,3887914,1590,47,96434,0,98024,47,1
367147,2039022,319,417,409,342,728,759,1
474172,1711524,471,54,38713,0,39184,54,1
3509903,471730,1530,2,509445,0,510975,2,1
3361377,2151501,4841,4,761793,0,766634,4,1
2219036,176877,192,13,1889,0,2081,13,1
1541866,3827617,542,100,16481,0,17023,100,1
1580474,4218231,67,52,5377,0,5444,52,1
180517,707420,118,100,4246,0,4364,100,1
4001671,4505512,12,1,144,0,156,1,1
2567151,1604379,216,191,887,0,1103,191,1
873006,1445380,375,40,33630,4396,34005,4436,1
2310265,315383,241,4,6278,0,6519,4,1
354904,996862,3193,90,105780,0,108973,90,1
4731849,1803593,455,189,10886,0,11341,189,1
4552666,1059243,341,42,9279,0,9620,42,1
2853969,4379836,1051,761,42591,0,43642,761,1
3206169,3335128,78,127,709,0,787,127,1
2722942,771024,240,17,8655,0,8895,17,1
4295952,2551551,808,53,57369,0,58177,53,1
1022123,2825833,126,45,8212,0,8338,45,1
3549674,604042,602,190,38542,0,39144,190,1
3561502,1053627,1144,6,68800,0,69944,6,1
2209136,692867,620,67,33789,0,34409,67,1
4272102,3598792,1608,79,104171,0,105779,79,1
3242275,1627563,551,195,17400,0,17951,195,1
652714,3021573,64,1,1815,0,1879,1,1
530200,4715218,2035,22,62809,0,64844,22,1
3509903,4128240,1530,3,509445,0,510975,3,1
1580988,3459659,2821,1,400133,0,402954,1,1
4854634,109479,76,2,1396,0,1472,2,1
1966548,2782568,208,2,53149,0,53357,2,1
4238001,4525975,869,121,61161,0,62030,121,1
3742930,4740741,410,200,22242,0,22652,200,1
2733969,2915097,143,14,372,89,515,103,1
4304056,1815047,164,3,12698,0,12862,3,1
2259806,3739153,11,163,126,0,137,163,1
2775684,1862921,21,5,287,0,308,5,1
2516076,1331338,1455,24,77782,0,79237,24,1
4758008,606974,34,4,218,0,252,4,1
471706,4334963,794,5,65616,0,66410,5,1
4266665,4862064,91,35,1894,0,1985,35,1
2443764,2850415,260,39,6836,0,7096,39,1
1807467,2125550,208,32,2442,0,2650,32,1
4334842,3497732,85,11,4749,0,4834,11,1
3458198,47850,60,21,4425,0,4485,21,1
2219036,439061,192,56,1889,0,2081,56,1
429643,3102421,767,134,19668,0,20435,134,1
3280389,531055,1101,1,411419,0,412520,1,1
2276175,1886672,262,53,4860,0,5122,53,1
4295952,4374301,808,65,57369,0,58177,65,1
1534362,1161941,1531,33,105859,0,107390,33,1
644301,3943165,442,13,511,0,953,13,1
1839283,303940,765,1,36658,0,37423,1,1
3449530,2253739,717,58,73648,0,74365,58,1
3419989,502347,350,16,16316,0,16666,16,1
3361377,4864184,4841,57,761793,0,766634,57,1
3280389,1006235,1101,1,411419,0,412520,1,1
4191410,469764,1590,8,96434,0,98024,8,1
3765475,2080107,873,41,107914,0,108787,41,1
3242275,3125520,551,269,17400,0,17951,269,1
3586002,1159692,292,130,1257,0,1549,130,1
354904,2865400,3193,62,105780,0,108973,62,1
3361377,3378945,4841,3,761793,0,766634,3,1
4662364,2331566,66,2,822,0,888,2,1
1043345,2392665,24,19,475,0,499,19,1
2106424,4713208,127,8,357,54,484,62,1
3225310,492068,320,149,10537,0,10857,149,1
3127090,4604558,678,161,10017,0,10695,161,1
3294702,393937,991,16,68888,0,69879,16,1
4116231,3712504,227,57,545,0,772,57,1
2950311,2798524,807,10,85116,0,85923,10,1
3280389,1065342,1101,1,411419,0,412520,1,1
1913445,4132678,564,28,47943,0,48507,28,1
593740,1900636,1107,8,62807,0,63914,8,1
4451122,3992096,985,1,41669,0,42654,1,1
3638272,1499159,2022,4,370904,0,372926,4,1
3129073,4473918,35,22,1847,0,1882,22,1
2516076,2235831,1455,6,77782,0,79237,6,1
842615,4250173,510,443,12316,0,12826,443,1
1364723,271169,6,2,196,0,202,2,1
1652056,865147,326,1,66845,0,67171,1,1
2318737,1973129,260,1,738,0,998,1,1
6618,4559536,892,3,68849,0,69741,3,1
1834369,4705188,76,336,1550,8658,1626,8994,1
1580988,1408219,2821,58,400133,0,402954,58,1
3397281,4393989,743,4,15050,0,15793,4,1
532681,2381484,433,103,35023,0,35456,103,1
4360960,4778605,1642,25,110084,0,111726,25,1
180302,1177914,26,9,1997,0,2023,9,1
4209323,2297476,1630,26,89460,0,91090,26,1
2201642,2122034,76,47,920,0,996,47,1
2209136,1324795,620,88,33789,0,34409,88,1
3910135,3519070,298,245,14348,0,14646,245,1
3140664,1116560,268,52,16099,0,16367,52,1
3280389,2183927,1101,1,411419,0,412520,1,1
3280389,592446,1101,4,411419,0,412520,4,1
4774514,490265,85,16,820,0,905,16,1
544230,1358321,1532,49,60768,0,62300,49,1
427805,633118,483,1,156906,0,157389,1,1
2553405,531830,568,54,12913,0,13481,54,1
1637447,1725738,555,3,8549,0,9104,3,1
2665339,4480308,98,590,673,0,771,590,1
3361377,3447829,4841,6,761793,0,766634,6,1
3509903,1706834,1530,1,509445,0,510975,1,1
4771452,3292038,411,11,8072,0,8483,11,1
3361377,2574122,4841,1,761793,0,766634,1,1
4272102,4831321,1608,17,104171,0,105779,17,1
1847461,2748077,1211,10,51149,0,52360,10,1
382977,1087474,143,60,5934,0,6077,60,1
4582129,2038730,1231,103,10356,0,11587,103,1
2827436,588135,882,1,271525,0,272407,1,1
4183784,1366503,931,20,59894,0,60825,20,1
3235479,2447713,999,40,66486,0,67485,40,1
2161115,2285803,157,16,951,0,1108,16,1
1818911,2087827,425,46,2972,0,3397,46,1
2098669,88486,309,1765,2088,0,2397,1765,1
3361377,50169,4841,1,761793,0,766634,1,1
2260014,68549,2466,4,98622,0,101088,4,1
3065808,3201506,1235,35,82317,0,83552,35,1
4569293,4341585,191,90,5084,0,5275,90,1
537639,2109675,12,273,53,513,65,786,1
3137585,2215664,1196,58,77354,0,78550,58,1
1534362,2506427,1531,34,105859,0,107390,34,1
1659017,3185975,817,111,13055,0,13872,111,1
4423184,4436088,384,3,29809,0,30193,3,1
3914135,1784005,2152,4,60084,0,62236,4,1
582276,3645057,298,3,10990,0,11288,3,1
921529,1698037,48,621,144,272,192,893,1
3361380,3742109,342,5,2750,0,3092,5,1
354904,3923469,3193,53,105780,0,108973,53,1
4791406,3859368,84,186,206,133,290,319,1
1792987,1897064,97,76,3867,0,3964,76,1
4209323,1133907,1630,23,89460,0,91090,23,1
1927211,3584211,1668,10,113322,0,114990,10,1
873006,4253134,375,27,33630,0,34005,27,1
2314038,3329411,456,1,16347,0,16803,1,1
3477164,1456066,80,119,2851,0,2931,119,1
2308819,1501861,141,52,5491,0,5632,52,1
1503116,694867,415,2,37079,0,37494,2,1
3509903,2890858,1530,74,509445,0,510975,74,1
3457077,2842149,201,14,1913,0,2114,14,1
3638037,3876737,8,2951,35,1921,43,4872,1
1506065,2781998,136,211,3968,0,4104,211,1
4209323,2305112,1630,22,89460,0,91090,22,1
1372535,4578315,177,136,3150,0,3327,136,1
4011264,790501,1360,48,116777,0,118137,48,1
1934593,719553,67,1,2336,0,2403,1,1
2441425,1859674,803,140,18561,0,19364,140,1
2827436,949496,882,1,271525,0,272407,1,1
3361377,288659,4841,1,761793,0,766634,1,1
1225580,207711,159,597,2943,0,3102,597,1
2075015,2389212,2664,47,85781,0,88445,47,1
2981537,2601645,1252,33,118718,0,119970,33,1
4272102,108880,1608,29,104171,0,105779,29,1
3509903,1568432,1530,3,509445,0,510975,3,1
339838,3961433,65,334,186,0,251,334,1
2056892,1965343,250,487,4216,0,4466,487,1
3294702,2039772,991,39,68888,0,69879,39,1
1170741,4824499,136,381,1381,0,1517,381,1
544230,1257329,1532,126,60768,0,62300,126,1
1222206,3505164,256,26,1387,0,1643,26,1
3942994,3844813,138,24,2039,0,2177,24,1
1588330,2926105,694,619,10280,0,10974,619,1
3280389,1527892,1101,1,411419,0,412520,1,1
1063358,1546620,1350,44,63494,0,64844,44,1
3671141,2769771,1444,29,48400,0,49844,29,1
416856,196521,50,1176,719,11269,769,12445,1
1446824,2703817,569,258,4958,0,5527,258,1
2169693,4291958,194,20,7674,0,7868,20,1
2516076,4716310,1455,28,77782,0,79237,28,1
1870921,3594873,182,3,8739,0,8921,3,1
2074981,1015853,122,4,839,0,961,4,1
2974898,554693,62,75,324,583,386,658,1
2247657,335771,306,1,7138,0,7444,1,1
427805,1423593,483,1,156906,0,157389,1,1
427805,515247,483,1,156906,0,157389,1,1
3433098,2208112,386,243,218,675,604,918,1
3638272,1496330,2022,2,370904,0,372926,2,1
3844858,4498137,1591,79,28974,0,30565,79,1
892512,4401540,1505,190,11757,800,13262,990,1
2851109,3506883,450,1,98552,0,99002,1,1
3271484,268800,1507,567,34093,0,35600,567,1
3280389,4530550,1101,1,411419,0,412520,1,1
1131765,294895,57,18,660,0,717,18,1
4106501,1091692,224,50,1969,0,2193,50,1
3705070,3731064,740,10,14938,0,15678,10,1
1968010,2970061,786,2,10371,0,11157,2,1
1532003,2092472,124,3,1671,0,1795,3,1
1652056,3989521,326,1,66845,0,67171,1,1
98985,4044800,33,47,258,0,291,47,1
354904,1684921,3193,87,105780,0,108973,87,1
1534362,2600096,1531,34,105859,0,107390,34,1
3361377,4019956,4841,1,761793,0,766634,1,1
530200,2843367,2035,2,62809,0,64844,2,1
2089,98420,77,339,222,56,299,395,1
2962038,4208653,495,1820,14236,21104,14731,22924,1
3761102,4490077,279,67,11592,0,11871,67,1
3361377,4011893,4841,1,761793,0,766634,1,1
4660753,4121055,178,7,2207,0,2385,7,1
4238001,2646643,869,26,61161,0,62030,26,1
1293807,3602456,1837,55,30865,0,32702,55,1
4140279,2256432,337,4,49384,0,49721,4,1
3442706,4760227,138,29,201,0,339,29,1
860473,4402630,751,73,20450,0,21201,73,1
2172854,2463912,239,186,2000,114,2239,300,1
3612446,3209699,32,164,1944,0,1976,164,1
42456,2359019,21,2,299,0,320,2,1
2654633,819640,151,34,2699,0,2850,34,1
2876617,3926328,226,18,713,0,939,18,1
3823546,4545639,61,2,3026,0,3087,2,1
2405789,226270,1010,6,93387,0,94397,6,1
4619326,527499,539,6,22721,0,23260,6,1
3054732,3397289,310,19,4246,192,4556,211,1
4360960,1336445,1642,45,110084,0,111726,45,1
1356925,2933702,248,55,6996,0,7244,55,1
4539039,4447219,35,1,5584,0,5619,1,1
4707650,3971775,257,4,6619,0,6876,4,1
1652056,3880118,326,2,66845,0,67171,2,1
2075015,2220421,2664,15,85781,0,88445,15,1
805360,829502,1514,31,119306,0,120820,31,1
4492248,4274787,237,70,17127,553,17364,623,1
427805,3117923,483,135,156906,0,157389,135,1
4727207,3043583,925,3,84581,0,85506,3,1
3549558,2722013,66,37,1155,0,1221,37,1
932720,2929568,1411,118,111323,0,112734,118,1
3509214,4019719,263,314,14139,0,14402,314,1
3509903,1750552,1530,4,509445,0,510975,4,1
1580988,2624736,2821,1,400133,0,402954,1,1
290670,6342,252,63,3851,0,4103,63,1
1984622,4133826,145,24,20659,0,20804,24,1
429000,4347654,26,1278,136,0,162,1278,1
1552745,506428,151,1267,1316,87,1467,1354,1
4095026,2368559,71,269,1175,0,1246,269,1
1475591,98690,178,41,3828,0,4006,41,1
4067716,507881,622,193,4349,0,4971,193,1
4300092,4200230,21,7,502,0,523,7,1
1057389,4574494,18,73,747,0,765,73,1
1580988,4166208,2821,1,400133,0,402954,1,1
3290431,4441833,65,30,1379,237,1444,267,1
2961552,485084,562,1,16546,0,17108,1,1
1580988,2316756,2821,1,400133,0,402954,1,1
4164420,1228370,123,912,240,133,363,1045,1
3426014,3888634,40,93,167,0,207,93,1
2293122,2241460,57,8,623,0,680,8,1
4397923,2215613,16,217,1228,0,1244,217,1
3073955,3968481,56,41,823,0,879,41,1
1059680,1543656,79,2,3854,0,3933,2,1
2981537,720314,1252,3,118718,0,119970,3,1
256864,742148,74,9,430,0,504,9,1
3361377,1313327,4841,3,761793,0,766634,3,1
1276253,2662175,407,23,46534,0,46941,23,1
4656285,3511668,1446,2,35428,0,36874,2,1
4864827,3026372,101,1215,339,3,440,1218,1
2834992,1379709,69,15,1779,0,1848,15,1
1575009,3333934,429,5,37745,0,38174,5,1
4178055,71888,260,43,8186,0,8446,43,1
1674952,1789926,84,7,723,0,807,7,1
2881425,3854903,102,76,5272,0,5374,76,1
1815739,4837988,248,137,6590,0,6838,137,1
2075015,639164,2664,3,85781,0,88445,3,1
4828666,903162,24,9,101,0,125,9,1
1580988,1302548,2821,1,400133,0,402954,1,1
1895452,1710033,34,14,566,0,600,14,1
4860485,326677,89,250,3655,0,3744,250,1
3941858,3444375,202,13,5760,0,5962,13,1
1609659,427989,523,41,29763,0,30286,41,1
2536096,2862746,26,3,164,0,190,3,1
2981537,2808988,1252,3,118718,0,119970,3,1
22713,4690939,144,239,3915,0,4059,239,1
2898368,1218291,602,74,208,297,810,371,1
3387814,3269614,198,119,1943,0,2141,119,1
3280389,3131840,1101,1,411419,0,412520,1,1
3836080,2461544,1197,39,59457,0,60654,39,1
669455,1639234,52,210,1362,0,1414,210,1
4782707,3883994,513,84,31665,0,32178,84,1
2148937,2402951,672,23,47361,0,48033,23,1
3025154,1562601,183,97,1843,0,2026,97,1
3361377,2714893,4841,2,761793,0,766634,2,1
2457029,3507236,77,2,10427,0,10504,2,1
1331940,4654532,802,3,32617,0,33419,3,1
2425587,3800405,13,154,209,0,222,154,1
2148937,3492634,672,2,47361,0,48033,2,1
2031305,3822641,396,2,23435,0,23831,2,1
1249227,4489063,621,116,7423,0,8044,116,1
2405789,3885489,1010,37,93387,0,94397,37,1
4811747,3297643,72,41,1796,0,1868,41,1
2853969,2044112,1051,1,42591,0,43642,1,1
471706,63787,794,1,65616,0,66410,1,1
3175944,664121,324,3,7415,0,7739,3,1
1580988,576210,2821,1,400133,0,402954,1,1
1494665,3282656,668,2,37638,0,38306,2,1
21944,580982,317,183,9419,0,9736,183,1
3513476,4624167,24,1,1746,0,1770,1,1
427805,3144026,483,1,156906,0,157389,1,1
3294702,928861,991,17,68888,0,69879,17,1
530200,852874,2035,27,62809,0,64844,27,1
4738916,4625601,1165,15,34124,0,35289,15,1
3106700,3711024,157,318,1980,0,2137,318,1
1218579,163905,434,76,1019,0,1453,76,1
3916976,1209473,188,15,6098,0,6286,15,1
2516076,2119661,1455,82,77782,0,79237,82,1
1638032,4177875,91,64,3942,0,4033,64,1
471868,1751730,120,27,1029,0,1149,27,1
2260014,1059002,2466,1,98622,0,101088,1,1
2362241,441221,324,43,7732,0,8056,43,1
3873768,3739256,449,89,35424,0,35873,89,1
4313572,984839,930,3,16971,0,17901,3,1
1291960,1175088,123,69,2351,0,2474,69,1
2887240,2480884,1143,3,118405,0,119548,3,1
3242275,1998636,551,235,17400,0,17951,235,1
4035655,4763936,913,387,5979,0,6892,387,1
4423184,301839,384,2,29809,0,30193,2,1
2866109,2745744,26,1,372,0,398,1,1
4451491,4800591,817,156,8836,0,9653,156,1
773149,1780016,202,2,926,0,1128,2,1
3361377,1968779,4841,2,761793,0,766634,2,1
2818749,1722177,92,56,3797,0,3889,56,1
1633022,1335043,246,1,23530,0,23776,1,1
3914135,1789327,2152,2,60084,0,62236,2,1
4735218,3892715,252,99,5309,0,5561,99,1
441734,2983532,271,1,3594,0,3865,1,1
1719606,2839760,101,207,278,0,379,207,1
1973082,4471243,1036,18,18915,0,19951,18,1
1913445,705312,564,98,47943,0,48507,98,1
2451482,1621055,218,35,1711,0,1929,35,1
3361377,4401245,4841,3,761793,0,766634,3,1
73377,1195322,87,3,717,0,804,3,1
3513476,655275,24,3,1746,0,1770,3,1
2950311,2811115,807,12,85116,0,85923,12,1
682715,3375235,154,562,460,3864,614,4426,1
4074014,1751669,5,860,1110,9825,1115,10685,1
3280389,1250313,1101,1,411419,0,412520,1,1
2439199,715237,631,41,5929,0,6560,41,1
3102873,2335064,341,10,15098,0,15439,10,1
339563,3086597,1999,8,7561,0,9560,8,1
3638272,2926472,2022,3,370904,0,372926,3,1
4220190,2395008,320,711,15994,0,16314,711,1
4805202,4238794,62,51,559,0,621,51,1
2950311,3395881,807,149,85116,0,85923,149,1
818544,3026312,112,31,1261,0,1373,31,1
2884705,3574283,649,12,10233,0,10882,12,1
483251,4710856,154,1,5257,0,5411,1,1
4209323,3927192,1630,17,89460,0,91090,17,1
1022123,2661108,126,1,8212,0,8338,1,1
3509903,928857,1530,2,509445,0,510975,2,1
4236325,719751,372,4,6103,0,6475,4,1
3271484,4836725,1507,24,34093,0,35600,24,1
325060,1082058,173,22,922,0,1095,22,1
135188,968553,51,237,5860,0,5911,237,1
1580988,4640691,2821,50,400133,0,402954,50,1
3438576,3783237,3424,1,137753,0,141177,1,1
3257465,2780817,541,33,27614,0,28155,33,1
1927211,3588243,1668,2,113322,0,114990,2,1
360598,2735577,68,125,1946,0,2014,125,1
1580988,4351065,2821,6,400133,0,402954,6,1
1221958,3273370,51,4,1736,0,1787,4,1
64357,2445403,309,61,6329,0,6638,61,1
2260014,1959450,2466,250,98622,0,101088,250,1
427805,2379867,483,1,156906,0,157389,1,1
307250,2057585,919,3,35588,0,36507,3,1
3501482,841820,522,190,28046,0,28568,190,1
3509903,2479753,1530,1,509445,0,510975,1,1
4218365,284087,58,28,1087,0,1145,28,1
4327096,4140614,234,9,2944,0,3178,9,1
1221281,2979423,133,3,1378,0,1511,3,1
4818741,161038,107,84,989,0,1096,84,1
3638272,4290462,2022,2,370904,0,372926,2,1
2778813,3180143,111,96,4665,0,4776,96,1
1559783,1807156,204,34,1917,0,2121,34,1
3175944,2651147,324,146,7415,0,7739,146,1
2687552,589776,238,10,25574,0,25812,10,1
1063358,882593,1350,6,63494,0,64844,6,1
705742,4401148,8,3,299,0,307,3,1
57574,2727573,289,173,4616,0,4905,173,1
2961801,560472,1483,23,101962,0,103445,23,1
1533314,1701239,361,351,6007,0,6368,351,1
3509903,1511455,1530,3,509445,0,510975,3,1
3549674,1681790,602,28,38542,0,39144,28,1
1898822,2620075,114,227,3885,0,3999,227,1
929305,4361466,9,2,361,0,370,2,1
941212,3615618,184,3,6404,0,6588,3,1
681618,4636791,75,1,8789,0,8864,1,1
2441425,2685765,803,550,18561,0,19364,550,1
2569009,1894040,424,80,13423,0,13847,80,1
1880135,59729,810,26,71924,0,72734,26,1
3361377,915900,4841,4,761793,0,766634,4,1
4011264,185800,1360,116,116777,0,118137,116,1
3118804,1611226,315,261,6025,0,6340,261,1
544230,2030308,1532,17,60768,0,62300,17,1
755739,1770930,1117,248,58043,0,59160,248,1
97450,1575009,165,429,1955,37745,2120,38174,1
3361377,4114631,4841,2,761793,0,766634,2,1
281939,4754713,80,529,2031,0,2111,529,1
4485604,3097085,50,1,73,0,123,1,1
1022123,1045794,126,4,8212,0,8338,4,1
3361377,4802749,4841,2,761793,0,766634,2,1
3683235,1629554,311,7,23110,0,23421,7,1
2190221,3719930,228,22,1659,0,1887,22,1
439557,3206448,2090,34,61744,0,63834,34,1
3795221,3886125,332,487,5749,0,6081,487,1
2827436,2621728,882,1,271525,0,272407,1,1
3906136,2717432,387,46,41169,0,41556,46,1
4297315,1080440,195,265,7446,0,7641,265,1
4011264,48064,1360,22,116777,0,118137,22,1
212242,3461084,103,158,659,0,762,158,1
4296372,863052,33,3,686,0,719,3,1
3361377,1710877,4841,1,761793,0,766634,1,1
521586,688902,782,161,18489,964,19271,1125,1
4011264,1529064,1360,46,116777,0,118137,46,1
1333761,2790714,193,102,5573,0,5766,102,1
2851109,3771607,450,19,98552,0,99002,19,1
2075015,3756692,2664,5,85781,0,88445,5,1
4043216,1376933,24,3,1977,0,2001,3,1
1787075,2594709,894,11,28305,0,29199,11,1
1580988,1520439,2821,3,400133,0,402954,3,1
2075015,724270,2664,32,85781,0,88445,32,1
4140279,4855578,337,1,49384,0,49721,1,1
6618,2210919,892,17,68849,0,69741,17,1
3509903,1343124,1530,1,509445,0,510975,1,1
3632293,2828885,570,1,21294,0,21864,1,1
4272102,3318443,1608,77,104171,0,105779,77,1
1063358,3129597,1350,71,63494,0,64844,71,1
1389617,1317480,482,54,2070,0,2552,54,1
2948092,2066202,412,1,18486,0,18898,1,1
2646792,2122805,86,49,2420,0,2506,49,1
4230144,827009,216,3,4435,0,4651,3,1
2493935,1622156,32,9,305,0,337,9,1
2464401,2350556,577,105,23681,0,24258,105,1
2320672,3403858,26,40,408,0,434,40,1
4212637,1627167,35,1,2517,0,2552,1,1
2985909,748257,706,61,43348,0,44054,61,1
1103332,34554,732,148,59415,0,60147,148,1
4191727,604227,463,234,26315,0,26778,234,1
4238001,4724703,869,12,61161,0,62030,12,1
94649,1334446,21,10,513,0,534,10,1
681618,1422189,75,2,8789,0,8864,2,1
2631627,2017580,183,140,3743,0,3926,140,1
2462210,2511494,96,42,1606,0,1702,42,1
2088912,3146356,64,2,1178,0,1242,2,1
4230144,1696742,216,10,4435,0,4651,10,1
4218365,240017,58,75,1087,0,1145,75,1
1063358,664346,1350,100,63494,0,64844,100,1
1192930,1309404,3,93,75,0,78,93,1
3361377,2015381,4841,2,761793,0,766634,2,1
4238001,1602244,869,45,61161,0,62030,45,1
3361377,1934288,4841,1,761793,0,766634,1,1
3317795,4555339,22,2,1850,0,1872,2,1
1438390,1333818,18,16,173,98,191,114,1
1580988,4197776,2821,2,400133,0,402954,2,1
3361377,4766572,4841,5,761793,0,766634,5,1
2107861,798833,535,2,25743,0,26278,2,1
2147720,2116035,1608,57,78786,0,80394,57,1
2573526,378276,222,16,539,0,761,16,1
354788,1442171,203,154,5964,0,6167,154,1
3361377,3976377,4841,32,761793,0,766634,32,1
2552022,3559115,92,78,479,334,571,412,1
217029,576382,141,7,714,0,855,7,1
2049062,687144,199,679,1030,859,1229,1538,1
3910135,3340871,298,71,14348,0,14646,71,1
2670449,1264366,277,90,3488,0,3765,90,1
958336,40565,7,96,63,14,70,110,1
2851109,4158350,450,2,98552,0,99002,2,1
1580988,4329540,2821,2,400133,0,402954,2,1
4330391,1902256,773,254,32759,0,33532,254,1
2394976,4111932,335,2,10973,0,11308,2,1
4582129,4494796,1231,359,10356,0,11587,359,1
1600857,2094494,324,38,10576,0,10900,38,1
2147720,4591490,1608,84,78786,0,80394,84,1
1913445,676669,564,81,47943,0,48507,81,1
1276253,2803772,407,1,46534,0,46941,1,1
3638272,825602,2022,1,370904,0,372926,1,1
4191727,4372781,463,3,26315,0,26778,3,1
471706,811003,794,85,65616,0,66410,85,1
30224,4716154,120,100,4175,0,4295,100,1
2209136,2919615,620,43,33789,0,34409,43,1
2851109,4367264,450,4,98552,0,99002,4,1
4183784,3557333,931,45,59894,0,60825,45,1
1234540,2108166,1071,87,75251,0,76322,87,1
4080293,3853383,11,896,86,0,97,896,1
3216427,3413851,262,8,6471,0,6733,8,1
1527599,2090728,176,205,3575,0,3751,205,1
805360,2199931,1514,79,119306,0,120820,79,1
3517811,1892611,60,383,11929,0,11989,383,1
3209359,3978911,72,6,898,0,970,6,1
4360960,1116696,1642,14,110084,0,111726,14,1
2375878,964104,248,74,14925,0,15173,74,1
4676536,2379667,269,117,696,0,965,117,1
4642569,2778159,872,99,27586,0,28458,99,1
283907,1676904,401,301,1992,1455,2393,1756,1
4605273,3190051,48,1,332,0,380,1,1
3705965,1802299,190,10,1950,0,2140,10,1
1887823,3844669,63,2,957,0,1020,2,1
800280,2689566,31,191,265,0,296,191,1
2670064,4116296,30,61,745,0,775,61,1
3721550,2174988,188,39,14527,0,14715,39,1
3509903,916148,1530,3,509445,0,510975,3,1
408965,1869222,903,220,38623,0,39526,220,1
837553,3253198,1249,113,61665,0,62914,113,1
2737233,1465894,30,13,1579,0,1609,13,1
2225105,288450,17,1,215,0,232,1,1
3419989,2942454,350,210,16316,0,16666,210,1
1580988,4243601,2821,2,400133,0,402954,2,1
4000906,245242,9,14,122,0,131,14,1
3853609,668300,505,41,6896,0,7401,41,1
3408985,3667893,205,471,6002,2170,6207,2641,1
3137585,3770111,1196,15,77354,0,78550,15,1
3298300,1620416,128,88,4498,0,4626,88,1
4140279,1666957,337,1,49384,0,49721,1,1
2147720,793976,1608,28,78786,0,80394,28,1
748019,48406,675,14,18480,0,19155,14,1
781211,2180616,976,165,51781,0,52757,165,1
3509903,4848195,1530,2,509445,0,510975,2,1
2494800,120573,752,135,5329,351,6081,486,1
3137585,4476376,1196,34,77354,0,78550,34,1
1880135,2049244,810,61,71924,0,72734,61,1
2961801,3661385,1483,26,101962,0,103445,26,1
372345,1967833,92,10,313,0,405,10,1
2343253,3052152,1882,4,86401,0,88283,4,1
3454888,1366196,162,19,7886,0,8048,19,1
3914135,3494186,2152,5,60084,0,62236,5,1
1242199,970852,207,93,6182,0,6389,93,1
3214323,1985479,147,51,12543,0,12690,51,1
1043549,2727507,64,61,2280,0,2344,61,1
3759853,1180774,451,40,16330,0,16781,40,1
530200,2965431,2035,2,62809,0,64844,2,1
3175944,475982,324,4,7415,0,7739,4,1
3469653,1965350,32,1,2818,0,2850,1,1
1353265,3910638,128,37,6709,0,6837,37,1
2887240,3890019,1143,1,118405,0,119548,1,1
3112136,1527133,406,21,41366,0,41772,21,1
2649958,775224,40,13,378,0,418,13,1
1497278,1337492,1869,102,35111,0,36980,102,1
2650412,356074,931,31,29038,0,29969,31,1
1337919,4516604,250,314,10276,13314,10526,13628,1
3361377,2353698,4841,2,761793,0,766634,2,1
466667,800118,442,97,4239,0,4681,97,1
3676295,2234764,374,1,70881,0,71255,1,1
3492258,2184132,200,12,481,0,681,12,1
4460816,749238,87,22,1298,0,1385,22,1
611927,1325434,305,308,8695,0,9000,308,1
3765475,2729839,873,87,107914,0,108787,87,1
2075015,698407,2664,21,85781,0,88445,21,1
3517811,4349894,60,32,11929,0,11989,32,1
2781817,4258076,704,28,24613,0,25317,28,1
1051108,3416535,262,13,7542,0,7804,13,1
1327933,867231,866,318,4229,1675,5095,1993,1
1541866,333921,542,48,16481,0,17023,48,1
2514271,2709363,387,2,19070,0,19457,2,1
2340125,1404686,161,294,2601,0,2762,294,1
3449530,575852,717,42,73648,0,74365,42,1
3765475,2214488,873,51,107914,0,108787,51,1
4013053,821389,33,72,1781,0,1814,72,1
3280389,2125267,1101,1,411419,0,412520,1,1
4463545,2339149,94,97,3842,4258,3936,4355,1
4151915,895827,726,116,3886,0,4612,116,1
2209136,4635804,620,63,33789,0,34409,63,1
932720,4649325,1411,10,111323,0,112734,10,1
1705425,582456,248,102,6280,0,6528,102,1
2341838,1216985,75,1,3932,0,4007,1,1
3567927,2821400,190,2,1980,0,2170,2,1
4479581,632008,601,18,19545,0,20146,18,1
4424178,3105083,41,2,588,0,629,2,1
4197224,3386592,253,339,708,56,961,395,1
3380067,73459,22,17,842,0,864,17,1
3384159,4710107,415,65,6659,748,7074,813,1
2851916,2502463,167,7,728,0,895,7,1
2403192,133087,163,98,5302,0,5465,98,1
3645034,788284,102,1,1041,0,1143,1,1
1609659,265085,523,54,29763,0,30286,54,1
1595696,3099014,44,54,931,0,975,54,1
4649206,1156950,566,42,31367,0,31933,42,1
382977,2186894,143,18,5934,0,6077,18,1
4191410,4814693,1590,31,96434,0,98024,31,1
1630220,4571759,290,5,866,0,1156,5,1
487744,2331936,138,958,2488,0,2626,958,1
4365751,4202576,133,600,549,10697,682,11297,1
561541,3598543,192,277,728,0,920,277,1
2881894,230276,211,60,7468,0,7679,60,1
3179820,716109,65,71,295,0,360,71,1
1927211,3492629,1668,87,113322,0,114990,87,1
3206499,1872444,1337,17,32033,0,33370,17,1
2887240,3382080,1143,2,118405,0,119548,2,1
4653941,3946829,951,10,45883,0,46834,10,1
3058068,3347939,124,7,12734,0,12858,7,1
4712782,947720,171,113,4681,0,4852,113,1
4370551,1654099,31,1180,730,26347,761,27527,1
2793437,1003902,582,239,25447,0,26029,239,1
3824547,521817,1075,19,14337,0,15412,19,1
2662809,2217969,303,3,10704,0,11007,3,1
2441425,217998,803,30,18561,0,19364,30,1
1606469,3126881,96,1,5210,0,5306,1,1
532681,353821,433,39,35023,0,35456,39,1
1927974,2185480,107,13,9317,0,9424,13,1
1124035,1443815,84,15,3736,0,3820,15,1
4705188,4112376,336,140,8658,0,8994,140,1
2260014,728021,2466,8,98622,0,101088,8,1
3959546,4708250,233,122,2002,1075,2235,1197,1
1580988,3533431,2821,96,400133,0,402954,96,1
3235479,4789357,999,30,66486,0,67485,30,1
184734,1640156,68,2,1084,0,1152,2,1
6618,2144014,892,50,68849,0,69741,50,1
1822719,2088512,285,65,22351,0,22636,65,1
502082,750634,589,56,16428,0,17017,56,1
3361377,3606694,4841,1,761793,0,766634,1,1
940526,4449267,475,5,20786,0,21261,5,1
3764177,3838758,1036,12,64563,0,65599,12,1
2685444,4175568,56,184,315,33,371,217,1
4691341,3387814,207,198,2018,1943,2225,2141,1
1135323,2344924,169,7,12240,0,12409,7,1
1639434,4541720,587,72,8053,0,8640,72,1
1516853,3859096,426,3,10168,0,10594,3,1
3361377,620746,4841,1,761793,0,766634,1,1
1709046,1407397,61,161,498,397,559,558,1
2031305,1000680,396,75,23435,0,23831,75,1
2772113,2144080,792,42,42907,0,43699,42,1
2827436,2545954,882,3,271525,0,272407,3,1
4011264,1978601,1360,80,116777,0,118137,80,1
573226,4230430,59,19,4431,0,4490,19,1
268844,671208,422,34,5070,0,5492,34,1
3280389,1517652,1101,1,411419,0,412520,1,1
3361377,106423,4841,3,761793,0,766634,3,1
3509903,4331473,1530,5,509445,0,510975,5,1
2895033,2749951,164,2,2870,0,3034,2,1
4552666,1130280,341,188,9279,0,9620,188,1
1913445,1925780,564,16,47943,0,48507,16,1
3449530,4360212,717,17,73648,0,74365,17,1
2502456,2905623,719,10,50725,0,51444,10,1
907654,2798650,798,28,24575,0,25373,28,1
2650412,3820334,931,28,29038,0,29969,28,1
203626,506428,41,1267,158,87,199,1354,1
2827436,4708756,882,2,271525,0,272407,2,1
1492163,3724526,49,3,837,0,886,3,1
185943,4529705,620,2,6573,0,7193,2,1
3235479,4859257,999,28,66486,0,67485,28,1
675763,2593067,5,6,63,0,68,6,1
2600253,3815837,148,145,652,0,800,145,1
1906776,163735,63,63,1962,0,2025,63,1
607449,4046352,380,2,19369,0,19749,2,1
3115867,657606,1350,3,61232,0,62582,3,1
3396719,510272,660,249,8141,0,8801,249,1
4789203,3821693,355,18,11315,0,11670,18,1
1060884,4074951,65,19,1609,0,1674,19,1
1687690,1893219,5,7,36,17,41,24,1
3610598,4331659,380,19,17343,0,17723,19,1
3344390,2667974,309,18,4274,0,4583,18,1
755739,3288943,1117,53,58043,0,59160,53,1
1333761,4031399,193,51,5573,0,5766,51,1
3235479,2598105,999,59,66486,0,67485,59,1
3065808,2302835,1235,24,82317,0,83552,24,1
1031334,4429442,459,104,16840,0,17299,104,1
4209323,413791,1630,103,89460,0,91090,103,1
2516076,4057899,1455,91,77782,0,79237,91,1
2981537,4226460,1252,76,118718,0,119970,76,1
4103612,1165803,932,82,5655,0,6587,82,1
4319972,2464583,640,145,35279,0,35919,145,1
3438576,4017559,3424,7,137753,0,141177,7,1
2827436,4859634,882,1,271525,0,272407,1,1
2671478,1444273,238,41,220,0,458,41,1
665164,3489667,396,335,12610,0,13006,335,1
4345222,4831208,204,2,887,0,1091,2,1
932720,3453225,1411,66,111323,0,112734,66,1
2311472,310660,91,36,2259,0,2350,36,1
3655915,1157056,176,131,1999,0,2175,131,1
3024682,1095504,7,7,900,0,907,7,1
1580988,878987,2821,2,400133,0,402954,2,1
259575,2207338,260,123,13949,0,14209,123,1
2687552,3354239,238,103,25574,0,25812,103,1
2896906,2019384,1193,43,7172,0,8365,43,1
2516076,102962,1455,5,77782,0,79237,5,1
3075881,4039180,313,343,3346,1714,3659,2057,1
2827436,3963181,882,2,271525,0,272407,2,1
3906136,973393,387,930,41169,0,41556,930,1
2985909,1067137,706,91,43348,0,44054,91,1
3395938,117297,546,42,39878,0,40424,42,1
3280389,3565251,1101,1,411419,0,412520,1,1
4011264,4734123,1360,46,116777,0,118137,46,1
781211,2004157,976,245,51781,0,52757,245,1
3509903,1529990,1530,2,509445,0,510975,2,1
1560049,1685493,1121,11,12468,0,13589,11,1
1609659,1389589,523,130,29763,0,30286,130,1
4547438,995068,1291,51,25237,0,26528,51,1
2851109,724867,450,2,98552,0,99002,2,1
2203596,2344646,208,114,1285,0,1493,114,1
1887709,1047631,217,22,28983,0,29200,22,1
1301815,513413,752,4,48944,0,49696,4,1
653766,3027152,70,37,1567,0,1637,37,1
110652,1582613,1,264,86,128,87,392,1
571147,616983,364,512,5484,0,5848,512,1
2981537,3699859,1252,84,118718,0,119970,84,1
26760,2104953,179,10,2100,0,2279,10,1
1192480,2143664,397,208,20737,0,21134,208,1
3270646,278481,390,42,3571,0,3961,42,1
3836080,4493276,1197,7,59457,0,60654,7,1
1503116,2523527,415,47,37079,0,37494,47,1
1973082,625177,1036,18,18915,0,19951,18,1
3711670,2266927,155,18,1123,0,1278,18,1
833255,3289195,65,341,828,0,893,341,1
3298406,394879,10,4,226,0,236,4,1
3280389,3957437,1101,6,411419,0,412520,6,1
1880135,4102010,810,32,71924,0,72734,32,1
1276253,1701392,407,1,46534,0,46941,1,1
2737233,4658363,30,20,1579,0,1609,20,1
781211,4123686,976,1,51781,0,52757,1,1
4058687,1031655,418,15,3486,0,3904,15,1
3361377,427745,4841,2,761793,0,766634,2,1
1653268,2073896,183,6,5919,0,6102,6,1
2827436,3448211,882,2,271525,0,272407,2,1
1763353,3288096,126,7,10072,0,10198,7,1
990798,2974777,194,176,2812,0,3006,176,1
1516853,817888,426,6,10168,0,10594,6,1
1847461,2176026,1211,44,51149,0,52360,44,1
1805743,1432263,316,282,3694,0,4010,282,1
3071531,4545092,313,71,1334,365,1647,436,1
2960291,2712722,66,9,1664,0,1730,9,1
2281580,2534275,309,68,1051,0,1360,68,1
3127312,1519350,110,64,1528,0,1638,64,1
1927211,4035604,1668,22,113322,0,114990,22,1
4653941,4616343,951,6,45883,0,46834,6,1
2542810,2766335,181,94,375,0,556,94,1
3280389,2586190,1101,1,411419,0,412520,1,1
3361377,2128821,4841,50,761793,0,766634,50,1
1973082,2772191,1036,61,18915,0,19951,61,1
2036104,2501070,31,7,91,0,122,7,1
2514271,1299178,387,35,19070,0,19457,35,1
4451122,395613,985,17,41669,0,42654,17,1
4001671,1510938,12,469,144,395,156,864,1
3721550,3391124,188,20,14527,0,14715,20,1
1086912,490815,907,76,33396,0,34303,76,1
4295952,4675482,808,53,57369,0,58177,53,1
2948092,203937,412,2,18486,0,18898,2,1
2275127,4653004,75,1,865,0,940,1,1
386424,1313747,131,440,7871,0,8002,440,1
3638272,1780436,2022,3,370904,0,372926,3,1
1787075,104019,894,77,28305,0,29199,77,1
1887669,3891530,733,5,23145,0,23878,5,1
522588,3508234,496,99,20091,0,20587,99,1
427805,3434980,483,1,156906,0,157389,1,1
873006,2294330,375,13,33630,0,34005,13,1
1580988,1932966,2821,4,400133,0,402954,4,1
4209323,3020677,1630,45,89460,0,91090,45,1
573226,4135773,59,2,4431,0,4490,2,1
2687552,3981970,238,58,25574,0,25812,58,1
2709652,2504852,335,12,3238,0,3573,12,1
2765419,583055,362,42,3468,0,3830,42,1
355682,3978787,70,1204,115,15,185,1219,1
1541866,1862890,542,150,16481,0,17023,150,1
3321628,553413,90,15,1979,0,2069,15,1
3387987,2834905,268,34,19035,0,19303,34,1
3509903,979748,1530,1,509445,0,510975,1,1
2256895,3437193,13,3,134,0,147,3,1
3280389,1213816,1101,1,411419,0,412520,1,1
1580988,4755771,2821,1,400133,0,402954,1,1
1973082,3729476,1036,9,18915,0,19951,9,1
3582961,75883,12,24,275,0,287,24,1
2031305,1464713,396,4,23435,0,23831,4,1
3954325,2753634,1743,68,16616,0,18359,68,1
532681,79856,433,56,35023,0,35456,56,1
1436174,2165537,105,108,9512,0,9617,108,1
3638272,3893223,2022,2,370904,0,372926,2,1
3638272,3622580,2022,5,370904,0,372926,5,1
1654099,2097957,1180,25,26347,0,27527,25,1
593740,163088,1107,72,62807,0,63914,72,1
593740,1811403,1107,76,62807,0,63914,76,1
1065411,2792875,19,1,480,0,499,1,1
276502,1357027,30,1,2245,0,2275,1,1
3827240,2146964,356,75,7496,0,7852,75,1
443309,4299178,100,2,1783,0,1883,2,1
307250,3870322,919,2,35588,0,36507,2,1
1545237,2396417,381,37,14327,0,14708,37,1
3561502,2275980,1144,32,68800,0,69944,32,1
2464401,514348,577,66,23681,0,24258,66,1
2428341,2414533,826,98,10151,31,10977,129,1
2431738,4337018,169,137,307,144,476,281,1
2851109,2278461,450,3,98552,0,99002,3,1
3638272,968760,2022,2,370904,0,372926,2,1
2502456,3017842,719,6,50725,0,51444,6,1
1028971,300911,130,2,385,0,515,2,1
3074145,2223981,205,3,5623,0,5828,3,1
354904,2121389,3193,7,105780,0,108973,7,1
3361377,4251143,4841,103,761793,0,766634,103,1
299865,4816682,409,69,1612,0,2021,69,1
3071504,885043,80,76,3797,0,3877,76,1
958615,4670934,56,46,2225,0,2281,46,1
1497278,2682041,1869,13,35111,0,36980,13,1
2718650,3277109,39,4,971,0,1010,4,1
2147720,2977440,1608,59,78786,0,80394,59,1
3602958,3684385,34,11,1096,0,1130,11,1
1528204,4268239,75,1117,238,124,313,1241,1
2405789,1585850,1010,106,93387,0,94397,106,1
4842461,3509903,450,1530,3728,509445,4178,510975,1
873006,3583081,375,143,33630,0,34005,143,1
3501482,1658359,522,14,28046,0,28568,14,1
1580988,4623863,2821,6,400133,0,402954,6,1
2952826,358057,92,86,1299,1795,1391,1881,1
3361377,1852714,4841,1,761793,0,766634,1,1
226540,3116471,463,3,10650,0,11113,3,1
805360,2976883,1514,32,119306,0,120820,32,1
3941858,2992860,202,12,5760,0,5962,12,1
3992144,4243476,402,1,23683,0,24085,1,1
957197,3521249,614,1,37109,0,37723,1,1
3873768,3252618,449,5,35424,0,35873,5,1
3853410,3268886,33,111,780,0,813,111,1
3361377,499528,4841,3,761793,0,766634,3,1
1927211,3742618,1668,191,113322,0,114990,191,1
1875,3248410,656,67,61388,0,62044,67,1
3765475,2831110,873,2,107914,0,108787,2,1
2446968,3126604,452,72,20110,0,20562,72,1
2876743,1274435,17,71,36,0,53,71,1
3395938,4654724,546,73,39878,0,40424,73,1
3561896,2034178,68,1,275,0,343,1,1
1984622,4225437,145,2,20659,0,20804,2,1
1580988,4106117,2821,2,400133,0,402954,2,1
3833992,3859910,36,65,174,0,210,65,1
2827436,2066293,882,1,271525,0,272407,1,1
2529079,444195,83,36,1028,0,1111,36,1
932720,3405004,1411,93,111323,0,112734,93,1
2277070,2368559,751,269,4932,0,5683,269,1
3234025,194,127,59,3830,0,3957,59,1
4780185,1282391,42,377,706,0,748,377,1
311243,328101,50,9,602,0,652,9,1
4451122,35949,985,34,41669,0,42654,34,1
3361377,2029299,4841,1,761793,0,766634,1,1
4209323,3390782,1630,377,89460,0,91090,377,1
1053177,768903,293,18,3060,0,3353,18,1
4816740,142349,141,71,7750,0,7891,71,1
1580474,2114255,67,2,5377,0,5444,2,1
3500846,2393443,210,44,5085,0,5295,44,1
765601,1842743,1485,27,101510,0,102995,27,1
1546845,1743092,60,13,278,0,338,13,1
797068,123431,46,37,926,0,972,37,1
745588,4558443,55,7,679,0,734,7,1
326686,3002251,49,6,772,0,821,6,1
4451122,4355494,985,72,41669,0,42654,72,1
3509903,1776049,1530,6,509445,0,510975,6,1
80085,552932,75,6,2925,0,3000,6,1
471706,2841720,794,3,65616,0,66410,3,1
3280389,2253812,1101,1,411419,0,412520,1,1
2374539,2851239,92,204,3805,0,3897,204,1
4853234,3124026,1256,24,29554,0,30810,24,1
4509843,4201,132,128,3138,1989,3270,2117,1
2893334,3516070,889,6,30148,0,31037,6,1
4337137,2064379,99,10,970,0,1069,10,1
3612446,4335848,32,38,1944,0,1976,38,1
2887240,2113632,1143,2,118405,0,119548,2,1
2405789,4852869,1010,56,93387,0,94397,56,1
2624998,2968037,52,131,394,0,446,131,1
1847461,2652953,1211,3,51149,0,52360,3,1
1875,54584,656,67,61388,0,62044,67,1
2343253,1088137,1882,5,86401,0,88283,5,1
4222854,1283988,207,131,1950,0,2157,131,1
567973,1984996,91,222,442,0,533,222,1
1138515,1596858,341,172,12443,0,12784,172,1
3361377,1549726,4841,5,761793,0,766634,5,1
6618,2340046,892,244,68849,0,69741,244,1
2260014,4503934,2466,34,98622,0,101088,34,1
1966548,4614739,208,26,53149,0,53357,26,1
846208,126077,600,77,17288,0,17888,77,1
125780,3567421,16,6,295,0,311,6,1
4238001,456583,869,23,61161,0,62030,23,1
1580508,4539529,720,9,19611,0,20331,9,1
932720,1969427,1411,33,111323,0,112734,33,1
3405059,1615011,261,44,9604,0,9865,44,1
501914,4267416,217,138,5217,0,5434,138,1
643159,1046843,9,194,104,0,113,194,1
667987,4362069,221,54,1349,0,1570,54,1
307250,1699883,919,31,35588,0,36507,31,1
846208,2491268,600,755,17288,0,17888,755,1
4191410,1947919,1590,3,96434,0,98024,3,1
4576296,2689892,19,1,534,0,553,1,1
2343253,1470878,1882,2,86401,0,88283,2,1
2994391,4191410,315,1590,6520,96434,6835,98024,1
1717922,2305813,432,29,6340,0,6772,29,1
3567927,2143968,190,11,1980,0,2170,11,1
4515355,2396162,21,1,8176,0,8197,1,1
1580928,631341,20,17,228,0,248,17,1
4011264,2116035,1360,57,116777,0,118137,57,1
519175,4583833,173,6,7221,0,7394,6,1
379565,1760711,46,31,2516,0,2562,31,1
3836080,923802,1197,2,59457,0,60654,2,1
2760655,2031080,403,211,2250,0,2653,211,1
4272102,3319411,1608,115,104171,0,105779,115,1
471706,2971305,794,13,65616,0,66410,13,1
4198771,4572888,207,133,8543,0,8750,133,1
4738916,3988597,1165,2,34124,0,35289,2,1
1777808,4444822,211,68,3413,0,3624,68,1
3835618,798503,694,159,25433,0,26127,159,1
1973082,3948956,1036,68,18915,0,19951,68,1
2790006,640473,367,58,14747,0,15114,58,1
2307868,1569107,1131,3,38777,0,39908,3,1
1505328,3451152,76,30,795,287,871,317,1
2094626,4648990,194,55,2066,546,2260,601,1
1148261,3143954,140,228,1719,0,1859,228,1
3638272,515676,2022,62,370904,0,372926,62,1
2883731,1232470,213,93,5217,0,5430,93,1
925252,1869500,103,41,4005,0,4108,41,1
3509903,4647576,1530,2,509445,0,510975,2,1
3509903,1370914,1530,1,509445,0,510975,1,1
3271484,3029377,1507,132,34093,0,35600,132,1
4011264,501575,1360,71,116777,0,118137,71,1
1212079,2778399,61,45,1208,0,1269,45,1
3280389,3124632,1101,2,411419,0,412520,2,1
2442158,2293038,213,592,84,286,297,878,1
2827436,884420,882,1,271525,0,272407,1,1
1835536,4854607,28,91,127,93,155,184,1
3438576,2191817,3424,52,137753,0,141177,52,1
3644677,2422215,20,51,224,0,244,51,1
2260014,2846229,2466,46,98622,0,101088,46,1
1539837,4281838,1127,8,62979,0,64106,8,1
4672319,3669988,483,51,9652,0,10135,51,1
1436216,2331942,1068,1,68770,0,69838,1,1
3579525,4442006,127,1,1960,0,2087,1,1
4619326,1322910,539,30,22721,0,23260,30,1
2998026,1155978,919,88,24182,0,25101,88,1
2405789,796819,1010,32,93387,0,94397,32,1
3198742,294336,551,290,5252,368,5803,658,1
4738916,3358158,1165,218,34124,0,35289,218,1
3177382,4473518,63,6,364,0,427,6,1
3509903,2804434,1530,4,509445,0,510975,4,1
3387987,225338,268,77,19035,0,19303,77,1
2827436,559559,882,3,271525,0,272407,3,1
3531730,2802130,334,292,9763,0,10097,292,1
547347,2408340,71,3,627,0,698,3,1
1937293,246202,434,33,16761,0,17195,33,1
932720,638763,1411,136,111323,0,112734,136,1
2147720,829164,1608,34,78786,0,80394,34,1
765601,2323615,1485,26,101510,0,102995,26,1
1024246,737544,52,16,1084,0,1136,16,1
2013943,1622461,135,4,304,0,439,4,1
2041134,2356452,477,5,4284,0,4761,5,1
1777298,3735161,468,42,6381,0,6849,42,1
3361377,420270,4841,65,761793,0,766634,65,1
2343253,631470,1882,5,86401,0,88283,5,1
3561502,90344,1144,22,68800,0,69944,22,1
2687552,397982,238,82,25574,0,25812,82,1
4653941,1180899,951,7,45883,0,46834,7,1
3483238,4864079,170,78,299,218,469,296,1
2405789,3553958,1010,27,93387,0,94397,27,1
2621271,1043627,82,2,350,0,432,2,1
3361377,2733150,4841,1,761793,0,766634,1,1
3140664,4710667,268,9,16099,0,16367,9,1
3458198,4233359,60,31,4425,0,4485,31,1
4451122,2765154,985,44,41669,0,42654,44,1
1723506,2068565,733,15,21835,0,22568,15,1
4191410,1419901,1590,162,96434,0,98024,162,1
554693,441272,75,39,583,0,658,39,1
3873768,263511,449,13,35424,0,35873,13,1
1148474,3096548,214,6,2785,0,2999,6,1
941640,1653213,336,480,677,229,1013,709,1
246244,4157037,156,22,2431,0,2587,22,1
422275,2973884,101,189,4142,0,4243,189,1
3065808,1052548,1235,68,82317,0,83552,68,1
255132,4547484,102,6,1348,0,1450,6,1
3280389,2163822,1101,1,411419,0,412520,1,1
3509903,1102470,1530,1,509445,0,510975,1,1
593740,76687,1107,4,62807,0,63914,4,1
431709,788751,205,6,5602,0,5807,6,1
2853969,1104836,1051,649,42591,0,43642,649,1
920468,1351160,103,1,1609,0,1712,1,1
932720,3503456,1411,7,111323,0,112734,7,1
3914135,1845789,2152,10,60084,0,62236,10,1
1541866,721135,542,60,16481,0,17023,60,1
2237068,1995499,211,36,2206,0,2417,36,1
4653941,6147,951,4,45883,0,46834,4,1
2791393,379867,52,108,964,0,1016,108,1
1847461,1712785,1211,41,51149,0,52360,41,1
1927211,4231496,1668,23,113322,0,114990,23,1
2464401,3651046,577,73,23681,0,24258,73,1
4592021,4699397,299,64,1376,0,1675,64,1
3265726,156525,31,23,447,0,478,23,1
2530129,3168342,40,15,464,0,504,15,1
3361377,3902575,4841,3,761793,0,766634,3,1
3395938,582174,546,2,39878,0,40424,2,1
2209136,4351656,620,15,33789,0,34409,15,1
2853969,435539,1051,1,42591,0,43642,1,1
3764177,293281,1036,74,64563,0,65599,74,1
2972710,2772552,27,135,320,300,347,435,1
3510150,4831669,171,140,1981,0,2152,140,1
3280389,3083369,1101,1,411419,0,412520,1,1
1086912,2414374,907,38,33396,0,34303,38,1
1313589,4359751,31,25,485,0,516,25,1
4233503,4550679,224,3,7867,0,8091,3,1
2694336,2832551,9,17,129,0,138,17,1
2961801,4462332,1483,28,101962,0,103445,28,1
2791231,4247216,183,26,5221,0,5404,26,1
3835618,3300780,694,7,25433,0,26127,7,1
837553,4331772,1249,101,61665,0,62914,101,1
4295952,1844206,808,44,57369,0,58177,44,1
4183784,4062699,931,129,59894,0,60825,129,1
4496449,3273435,174,41,4260,0,4434,41,1
3853410,2082100,33,2,780,0,813,2,1
3995686,4666201,113,1,6154,0,6267,1,1
837553,1634233,1249,18,61665,0,62914,18,1
3922480,2635670,21,1605,154,39,175,1644,1
1539837,148304,1127,68,62979,0,64106,68,1
4013601,3591818,653,56,14886,0,15539,56,1
987626,2595392,238,210,1743,0,1981,210,1
1053923,4678614,490,452,4567,16881,5057,17333,1
4360960,1233255,1642,46,110084,0,111726,46,1
3708922,4146003,42,5,1414,0,1456,5,1
4121239,1860765,64,45,5330,0,5394,45,1
3509903,1495079,1530,1,509445,0,510975,1,1
2893334,3469619,889,17,30148,0,31037,17,1
333786,3960119,18,4,982,0,1000,4,1
1436216,3356775,1068,1,68770,0,69838,1,1
4183784,3346942,931,10,59894,0,60825,10,1
2961801,3507391,1483,323,101962,0,103445,323,1
1249227,730637,621,50,7423,0,8044,50,1
4370819,2781251,403,5,6519,0,6922,5,1
2182964,1406629,214,6,6975,0,7189,6,1
4030633,690655,168,61,912,0,1080,61,1
1847461,3575189,1211,75,51149,0,52360,75,1
3509903,88370,1530,2,509445,0,510975,2,1
4738916,2719263,1165,4,34124,0,35289,4,1
3683235,3689336,311,53,23110,0,23421,53,1
2727581,3494375,757,28,7394,0,8151,28,1
1763353,37376,126,8,10072,0,10198,8,1
3610598,1784567,380,30,17343,0,17723,30,1
2516076,175149,1455,27,77782,0,79237,27,1
2881894,157866,211,274,7468,0,7679,274,1
2827436,4280567,882,2,271525,0,272407,2,1
2375878,882952,248,43,14925,0,15173,43,1
2677230,4732867,90,38,1208,0,1298,38,1
907654,4351908,798,511,24575,0,25373,511,1
3086957,51185,47,350,80,1600,127,1950,1
2778813,3107103,111,93,4665,0,4776,93,1
3638272,1312302,2022,2,370904,0,372926,2,1
3501482,2738398,522,59,28046,0,28568,59,1
1234540,407581,1071,15,75251,0,76322,15,1
2307868,2379154,1131,323,38777,0,39908,323,1
593740,2539326,1107,106,62807,0,63914,106,1
1436216,39140,1068,43,68770,0,69838,43,1
4411870,3297665,948,44,60517,0,61465,44,1
2922412,3657083,464,124,3629,0,4093,124,1
3956913,4511710,197,10,167,0,364,10,1
4749087,1762773,38,46,443,449,481,495,1
4417253,1447452,1130,453,68389,0,69519,453,1
4183784,3116138,931,204,59894,0,60825,204,1
4417253,2874280,1130,27,68389,0,69519,27,1
4191410,1473588,1590,32,96434,0,98024,32,1
1633022,4138446,246,1,23530,0,23776,1,1
4272102,3036594,1608,13,104171,0,105779,13,1
1190310,3874915,9,7,363,0,372,7,1
1539837,1523483,1127,16,62979,0,64106,16,1
4843360,4523905,355,5,7866,0,8221,5,1
2409574,1317315,20,1,211,0,231,1,1
3361377,2615559,4841,2,761793,0,766634,2,1
2374539,4705924,92,126,3805,0,3897,126,1
2513691,618422,244,402,17485,0,17729,402,1
1724324,518497,119,36,870,0,989,36,1
2209136,1118222,620,57,33789,0,34409,57,1
1654099,1477557,1180,282,26347,0,27527,282,1
2662809,164031,303,2,10704,0,11007,2,1
3742930,706248,410,29,22242,0,22652,29,1
4121239,907364,64,7,5330,0,5394,7,1
1446824,746920,569,46,4958,0,5527,46,1
3509903,4340706,1530,2,509445,0,510975,2,1
2774493,4041821,551,17,12712,0,13263,17,1
805360,4762755,1514,58,119306,0,120820,58,1
3280389,2346267,1101,1,411419,0,412520,1,1
781211,1853207,976,74,51781,0,52757,74,1
3206169,1448114,78,178,709,0,787,178,1
4479403,1702981,52,8,2699,0,2751,8,1
3992144,2006436,402,6,23683,0,24085,6,1
3764177,3648647,1036,22,64563,0,65599,22,1
1887669,4745005,733,14,23145,0,23878,14,1
4064346,2411706,195,95,1521,339,1716,434,1
4233503,2723196,224,34,7867,0,8091,34,1
530200,1039236,2035,1,62809,0,64844,1,1
2209136,4152714,620,107,33789,0,34409,107,1
3280389,2510818,1101,2,411419,0,412520,2,1
4547539,4342634,206,89,3195,0,3401,89,1
1580988,4722174,2821,8,400133,0,402954,8,1
3276834,3369869,142,8,1026,0,1168,8,1
3855087,4696238,13,93,210,1714,223,1807,1
3683653,3132939,30,1196,221,481,251,1677,1
3477164,3130092,80,9,2851,0,2931,9,1
4479581,633607,601,164,19545,0,20146,164,1
4519069,3189010,387,20,20799,0,21186,20,1
4363186,1500219,76,27,525,0,601,27,1
4386909,3413134,55,873,301,501,356,1374,1
2755798,4683380,494,18,24862,0,25356,18,1
2790006,4670131,367,45,14747,0,15114,45,1
3395938,3950982,546,8,39878,0,40424,8,1
2469359,1255651,59,56,263,0,322,56,1
1063358,3134814,1350,33,63494,0,64844,33,1
3280389,1576411,1101,8,411419,0,412520,8,1
4330391,3319624,773,89,32759,0,33532,89,1
4314280,1766157,568,15,9552,0,10120,15,1
3361377,4389898,4841,1,761793,0,766634,1,1
2018499,2842698,141,75,1786,0,1927,75,1
2853969,4842728,1051,1,42591,0,43642,1,1
3638272,1632865,2022,5,370904,0,372926,5,1
1063358,4587470,1350,29,63494,0,64844,29,1
16934,664107,22,43,1953,0,1975,43,1
1521855,367563,228,2,7649,0,7877,2,1
3509903,666597,1530,1,509445,0,510975,1,1
466667,400040,442,26,4239,0,4681,26,1
232646,2141304,321,4,1741,0,2062,4,1
3346033,679679,320,3,9541,0,9861,3,1
502082,4647561,589,516,16428,0,17017,516,1
4140279,3610553,337,1,49384,0,49721,1,1
1301815,2363680,752,177,48944,0,49696,177,1
858343,1354621,1103,9,1075,0,2178,9,1
3549674,229030,602,4,38542,0,39144,4,1
913320,699504,60,174,866,0,926,174,1
3438576,4025097,3424,22,137753,0,141177,22,1
2793437,2812558,582,36,25447,0,26029,36,1
3676150,2872480,125,1,7579,0,7704,1,1
427805,2468924,483,3,156906,0,157389,3,1
1580508,71675,720,156,19611,0,20331,156,1
3969321,1137987,108,173,1939,0,2047,173,1
1218807,3654276,75,153,1283,3512,1358,3665,1
1805743,1755885,316,711,3694,0,4010,711,1
593740,707132,1107,90,62807,0,63914,90,1
2721412,1565865,273,36,2733,0,3006,36,1
933859,4753328,206,67,1051,0,1257,67,1
4366991,3918469,253,3,530,0,783,3,1
3844858,1111944,1591,18,28974,0,30565,18,1
4209323,1005072,1630,124,89460,0,91090,124,1
4209323,1295486,1630,16,89460,0,91090,16,1
3672238,913320,518,60,12172,866,12690,926,1
530200,2461036,2035,2,62809,0,64844,2,1
4374509,4607818,770,193,9940,0,10710,193,1
3434766,290568,82,29,894,0,976,29,1
3835618,3729090,694,26,25433,0,26127,26,1
2207944,4004721,165,89,4573,0,4738,89,1
4818741,4131984,107,74,989,0,1096,74,1
3361377,4089786,4841,1,761793,0,766634,1,1
1591435,314052,387,50,31245,0,31632,50,1
2976040,3114432,86,10,441,0,527,10,1
2206273,412776,235,36,4892,0,5127,36,1
3638272,4212118,2022,1,370904,0,372926,1,1
4649206,1324058,566,8,31367,0,31933,8,1
3746611,362265,69,1,1951,0,2020,1,1
3250469,1736717,84,7,606,0,690,7,1
4582129,283907,1231,401,10356,1992,11587,2393,1
3319620,2939399,75,880,1027,0,1102,880,1
958099,740395,63,12,2391,0,2454,12,1
2064376,3309277,139,1,5873,0,6012,1,1
2950311,2110427,807,53,85116,0,85923,53,1
2562439,4263570,139,25,3070,0,3209,25,1
3280389,2279118,1101,1,411419,0,412520,1,1
471706,526344,794,117,65616,0,66410,117,1
3770739,4762204,33,2239,57,4518,90,6757,1
1735365,4072849,149,2,1402,0,1551,2,1
1659274,2389177,132,119,1310,0,1442,119,1
3065808,677388,1235,59,82317,0,83552,59,1
3842148,2764243,719,284,11430,0,12149,284,1
425493,590567,21,32,1128,0,1149,32,1
4397209,3117715,118,3,507,0,625,3,1
3610598,3548711,380,6,17343,0,17723,6,1
3509903,965839,1530,1,509445,0,510975,1,1
4747241,4416207,92,194,1449,0,1541,194,1
3361377,685686,4841,2,761793,0,766634,2,1
781211,4865835,976,5,51781,0,52757,5,1
4656285,4154511,1446,8,35428,0,36874,8,1
3676295,3476117,374,2,70881,0,71255,2,1
3294702,4741122,991,11,68888,0,69879,11,1
1234540,1660960,1071,53,75251,0,76322,53,1
3127090,3983436,678,376,10017,3267,10695,3643,1
1863381,4780507,208,47,1885,0,2093,47,1
3910135,3685465,298,211,14348,0,14646,211,1
2896906,1103865,1193,165,7172,0,8365,165,1
6618,3721820,892,15,68849,0,69741,15,1
260860,754584,137,73,1884,0,2021,73,1
3683235,976755,311,70,23110,0,23421,70,1
4727207,3713467,925,25,84581,0,85506,25,1
1787075,1573641,894,17,28305,0,29199,17,1
873241,2560462,616,446,22633,0,23249,446,1
4219266,3173081,85,204,3252,1344,3337,1548,1
2981537,1098680,1252,3,118718,0,119970,3,1
3375235,1767394,562,23,3864,0,4426,23,1
3280389,1786015,1101,1,411419,0,412520,1,1
1283690,1572287,102,254,1462,0,1564,254,1
3449530,1954448,717,80,73648,0,74365,80,1
1577010,1807485,373,50,2746,0,3119,50,1
4496449,2650412,174,931,4260,29038,4434,29969,1
474172,3211387,471,32,38713,0,39184,32,1
4710065,2138408,41,47,225,0,266,47,1
1927211,626213,1668,17,113322,0,114990,17,1
2230342,1060183,30,1,3940,0,3970,1,1
3361377,2719476,4841,3,761793,0,766634,3,1
3219524,4754247,554,682,1128,628,1682,1310,1
4653941,4244928,951,5,45883,0,46834,5,1
64567,4071041,40,8,462,0,502,8,1
2553467,2303590,13,25,276,0,289,25,1
2026955,4081208,145,274,1608,0,1753,274,1
1580988,4352623,2821,345,400133,1186,402954,1531,1
3911503,2924203,90,435,500,0,590,435,1
4360960,4107649,1642,55,110084,0,111726,55,1
3245012,4504000,8,1,301,0,309,1,1
1697778,1502555,125,35,3760,0,3885,35,1
3522015,4657935,88,144,919,0,1007,144,1
3844858,2424493,1591,71,28974,0,30565,71,1
966267,2317732,39,23,637,0,676,23,1
2281580,3920972,309,108,1051,325,1360,433,1
1580988,1909635,2821,1,400133,0,402954,1,1
3509903,3802163,1530,1,509445,0,510975,1,1
3676295,2136182,374,1,70881,0,71255,1,1
4653941,2915381,951,1,45883,0,46834,1,1
1389617,3020043,482,82,2070,0,2552,82,1
1575009,536212,429,76,37745,0,38174,76,1
2827436,2935227,882,2,271525,0,272407,2,1
3638272,742410,2022,1,370904,0,372926,1,1
3561502,3398289,1144,37,68800,0,69944,37,1
3438576,4207826,3424,4,137753,0,141177,4,1
4360960,3031941,1642,212,110084,0,111726,212,1
3881566,636824,781,18,14176,0,14957,18,1
3742930,3652941,410,38,22242,0,22652,38,1
3380947,65928,526,1045,367,0,893,1045,1
427805,4392768,483,1,156906,0,157389,1,1
3700566,3824916,43,2,645,0,688,2,1
3517811,473075,60,1,11929,0,11989,1,1
1059680,1578257,79,115,3854,0,3933,115,1
3632293,3454101,570,204,21294,0,21864,204,1
4179343,3449693,119,16,9822,0,9941,16,1
837553,2357313,1249,7,61665,0,62914,7,1
3065808,998471,1235,30,82317,0,83552,30,1
1652056,2127988,326,1,66845,0,67171,1,1
963193,1220566,80,118,230,0,310,118,1
4808368,3259635,77,2,1013,0,1090,2,1
3896595,1415700,165,1,2165,0,2330,1,1
2529661,1122036,493,197,27309,0,27802,197,1
3280389,1863959,1101,1,411419,0,412520,1,1
1493489,1310861,523,444,17512,0,18035,444,1
830708,4030529,76,299,442,3324,518,3623,1
1520840,3062970,155,78,2950,0,3105,78,1
3509903,1025198,1530,2,509445,0,510975,2,1
2307868,2813493,1131,3,38777,0,39908,3,1
1103332,757243,732,2,59415,0,60147,2,1
1927211,3408412,1668,3,113322,0,114990,3,1
3065808,4488279,1235,14,82317,0,83552,14,1
4411870,944500,948,9,60517,0,61465,9,1
3871554,919120,947,205,16042,2831,16989,3036,1
4318206,2477496,251,40,13123,0,13374,40,1
3176788,1972208,95,162,1038,0,1133,162,1
2781817,185943,704,620,24613,6573,25317,7193,1
153871,2303695,333,6,3892,0,4225,6,1
4295952,56291,808,104,57369,0,58177,104,1
3290431,2878621,65,194,1379,2011,1444,2205,1
3361377,3390880,4841,1,761793,0,766634,1,1
2052930,2433523,407,60,8479,0,8886,60,1
3405370,1539691,114,3,95,0,209,3,1
3509903,2244807,1530,19,509445,0,510975,19,1
4423184,4360324,384,55,29809,0,30193,55,1
3088808,3943229,227,54,7820,0,8047,54,1
601795,2315729,20,35,313,0,333,35,1
2343253,1548412,1882,13,86401,0,88283,13,1
3210349,3455350,46,1,3372,0,3418,1,1
3137585,1726848,1196,29,77354,0,78550,29,1
1588705,3394571,1000,35,11879,0,12879,35,1
427805,1017517,483,1,156906,0,157389,1,1
1250021,2787883,4637,68,85913,0,90550,68,1
3137585,3667297,1196,255,77354,0,78550,255,1
3361377,3552854,4841,2,761793,0,766634,2,1
4171214,1544833,358,485,4601,0,4959,485,1
4011264,1859467,1360,27,116777,0,118137,27,1
3845119,409086,461,21,28609,0,29070,21,1
3734245,917161,915,19,34965,0,35880,19,1
3375887,497098,119,4,2874,0,2993,4,1
3638272,2012320,2022,1,370904,0,372926,1,1
2948092,821768,412,6,18486,0,18898,6,1
4653941,3430178,951,2,45883,0,46834,2,1
4233503,58049,224,2,7867,0,8091,2,1
3655063,4021293,34,6,274,0,308,6,1
565180,3396717,10,10,134,0,144,10,1
1875,2868962,656,96,61388,0,62044,96,1
3280389,3535732,1101,1,411419,0,412520,1,1
307250,1113463,919,1,35588,0,36507,1,1
2516076,2437080,1455,86,77782,0,79237,86,1
3361377,3949746,4841,7,761793,0,766634,7,1
4853234,3774580,1256,256,29554,3916,30810,4172,1
2915820,3945698,476,33,1811,0,2287,33,1
3361377,826520,4841,1,761793,0,766634,1,1
3914135,3776665,2152,93,60084,0,62236,93,1
2516076,2614711,1455,59,77782,0,79237,59,1
4191410,2319759,1590,43,96434,0,98024,43,1
4653941,1211950,951,1,45883,0,46834,1,1
2950311,4577883,807,73,85116,0,85923,73,1
4192206,3565302,468,35,18229,0,18697,35,1
3752160,2551553,1327,2,4229,0,5556,2,1
4519069,3479678,387,7,20799,0,21186,7,1
837553,1246895,1249,39,61665,0,62914,39,1
354904,567932,3193,21,105780,0,108973,21,1
1580988,997841,2821,1,400133,0,402954,1,1
2107861,4282532,535,2,25743,0,26278,2,1
4705188,1550824,336,165,8658,3841,8994,4006,1
953297,2039220,83,23,349,0,432,23,1
1723506,339577,733,42,21835,0,22568,42,1
2950311,3937920,807,249,85116,0,85923,249,1
3361377,3352577,4841,1,761793,0,766634,1,1
64248,2811763,11,1,252,0,263,1,1
3361377,1872379,4841,47,761793,0,766634,47,1
3169744,4730619,63,237,357,0,420,237,1
1534362,3846789,1531,22,105859,0,107390,22,1
3509903,2105871,1530,1,509445,0,510975,1,1
4078911,2038265,9,79,102,222,111,301,1
4319972,2667316,640,18,35279,0,35919,18,1
4416945,731154,417,77,33228,0,33645,77,1
3930937,428498,225,66,8777,0,9002,66,1
141067,689696,432,66,2002,0,2434,66,1
873006,2451138,375,34,33630,0,34005,34,1
6618,1300721,892,157,68849,0,69741,157,1
1847461,2526478,1211,54,51149,0,52360,54,1
1534362,385738,1531,4,105859,0,107390,4,1
4013601,1427291,653,18,14886,0,15539,18,1
2989110,3734033,1042,281,19283,0,20325,281,1
2075015,2893099,2664,23,85781,0,88445,23,1
1580988,3330279,2821,1,400133,0,402954,1,1
2950311,1380032,807,59,85116,0,85923,59,1
3941858,4845459,202,3,5760,0,5962,3,1
3298300,576913,128,103,4498,0,4626,103,1
3844858,3408616,1591,209,28974,0,30565,209,1
4711909,1632407,440,88,2933,0,3373,88,1
3280389,1794132,1101,1,411419,0,412520,1,1
3572035,4254890,7,6,172,0,179,6,1
1927211,2166396,1668,223,113322,0,114990,223,1
1234540,3848970,1071,260,75251,0,76322,260,1
2513691,2365647,244,9,17485,0,17729,9,1
1534362,1308920,1531,226,105859,0,107390,226,1
360874,2151429,124,60,4585,0,4709,60,1
2067894,4694497,65,24,264,0,329,24,1
4183784,2243426,931,43,59894,0,60825,43,1
1847461,3564864,1211,75,51149,0,52360,75,1
3361377,4713598,4841,4,761793,0,766634,4,1
4423184,748268,384,8,29809,0,30193,8,1
813554,1234781,252,36,17214,0,17466,36,1
3361377,442551,4841,22,761793,0,766634,22,1
4751453,575828,520,19,27570,0,28090,19,1
1103332,4714009,732,1,59415,0,60147,1,1
3610598,1656741,380,255,17343,0,17723,255,1
4417253,867270,1130,4,68389,0,69519,4,1
4021807,2063437,105,76,359,0,464,76,1
471706,2608786,794,3,65616,0,66410,3,1
3509903,4369297,1530,3,509445,0,510975,3,1
4440160,4749834,736,2,20522,0,21258,2,1
653766,408965,70,903,1567,38623,1637,39526,1
1971223,2479627,338,26,5185,0,5523,26,1
2209136,2787224,620,53,33789,0,34409,53,1
3501482,4594992,522,28,28046,0,28568,28,1
408965,1351092,903,9,38623,0,39526,9,1
1234540,1439373,1071,18,75251,0,76322,18,1
933859,1927780,206,420,1051,6230,1257,6650,1
1791515,4768452,167,444,1668,120,1835,564,1
3676295,1646017,374,2,70881,0,71255,2,1
3648316,19499,77,31,202,46,279,77,1
1591435,3504287,387,91,31245,0,31632,91,1
3503678,2608182,113,106,607,0,720,106,1
478492,3160057,28,2358,118,187,146,2545,1
1629019,1996573,351,3,5823,0,6174,3,1
2399823,2989712,43,18,184,0,227,18,1
405955,4663464,109,5,6949,0,7058,5,1
3638272,4279213,2022,39,370904,0,372926,39,1
3280389,2663261,1101,2,411419,0,412520,2,1
2961801,2969539,1483,4,101962,0,103445,4,1
873006,1155089,375,32,33630,0,34005,32,1
3280389,922569,1101,1,411419,0,412520,1,1
2441073,673176,126,86,3161,0,3287,86,1
3632293,3377687,570,135,21294,0,21864,135,1
1697778,2147720,125,1608,3760,78786,3885,80394,1
318646,664848,60,22,1267,0,1327,22,1
2772113,4123758,792,216,42907,4336,43699,4552,1
2853969,4376662,1051,14,42591,0,43642,14,1
3943091,1453163,53,1,10283,0,10336,1,1
3361377,2589024,4841,2,761793,0,766634,2,1
2772113,2769712,792,86,42907,0,43699,86,1
3280389,298016,1101,1,411419,0,412520,1,1
1839283,2406911,765,14,36658,95,37423,109,1
3112136,4125319,406,3,41366,0,41772,3,1
3419989,4482996,350,51,16316,0,16666,51,1
427805,2896190,483,1,156906,0,157389,1,1
3739473,3894601,448,3,13226,0,13674,3,1
4707650,1537743,257,514,6619,0,6876,514,1
3509903,1663546,1530,1,509445,0,510975,1,1
3734245,817428,915,57,34965,0,35880,57,1
1234540,89842,1071,149,75251,0,76322,149,1
307250,4791713,919,1,35588,0,36507,1,1
3862610,3936278,95,118,864,0,959,118,1
1652056,1279942,326,1,66845,0,67171,1,1
1580988,608686,2821,4,400133,0,402954,4,1
2961801,2138621,1483,102,101962,0,103445,102,1
3638272,2349675,2022,4,370904,0,372926,4,1
3361377,161398,4841,9,761793,0,766634,9,1
3113979,713545,60,16,575,0,635,16,1
2752145,1067670,79,89,1888,0,1967,89,1
3361377,3572336,4841,2,761793,0,766634,2,1
1761151,1677613,260,31,4153,0,4413,31,1
2385744,937512,224,12,268,0,492,12,1
2147720,1047815,1608,43,78786,0,80394,43,1
873006,2084082,375,81,33630,0,34005,81,1
354904,1728481,3193,150,105780,0,108973,150,1
3545321,4812923,239,1,4366,0,4605,1,1
2125671,4841345,206,42,1028,0,1234,42,1
1281620,3823717,31,6,232,0,263,6,1
1428477,4801001,255,1,15459,0,15714,1,1
439557,4352947,2090,141,61744,0,63834,141,1
2827436,3823618,882,1,271525,0,272407,1,1
3224682,1078285,46,16,205,0,251,16,1
3235479,2807180,999,51,66486,0,67485,51,1
3873768,21193,449,269,35424,0,35873,269,1
4801471,963002,585,79,17979,0,18564,79,1
792037,3817660,57,1,16445,0,16502,1,1
1250021,4317174,4637,118,85913,0,90550,118,1
2687552,3235359,238,98,25574,0,25812,98,1
2887240,2616317,1143,1,118405,0,119548,1,1
3112136,160374,406,79,41366,0,41772,79,1
1062967,3761078,260,1,15276,0,15536,1,1
3509903,3134655,1530,1,509445,0,510975,1,1
3936039,373692,799,3,23884,0,24683,3,1
4319972,641862,640,218,35279,0,35919,218,1
765601,3415929,1485,88,101510,0,102995,88,1
3509903,2236654,1530,1,509445,0,510975,1,1
4653941,2260072,951,5,45883,0,46834,5,1
2793437,269760,582,6,25447,0,26029,6,1
4479581,2916709,601,33,19545,0,20146,33,1
3397281,3975150,743,211,15050,0,15793,211,1
3638272,2406807,2022,30,370904,0,372926,30,1
4771452,3147765,411,64,8072,0,8483,64,1
3509903,345759,1530,2,509445,0,510975,2,1
1968010,2901076,786,631,10371,726,11157,1357,1
3918313,4116155,146,1,915,0,1061,1,1
3190635,3742646,22,4,149,0,171,4,1
4853234,2081806,1256,38,29554,0,30810,38,1
4701737,1590769,98,2,4855,0,4953,2,1
55855,4277238,245,7,5888,0,6133,7,1
765601,2665262,1485,6,101510,0,102995,6,1
3112136,2610477,406,31,41366,0,41772,31,1
4181344,1865990,95,663,381,0,476,663,1
752618,1096762,169,12,5929,0,6098,12,1
957197,1078293,614,17,37109,0,37723,17,1
4411870,903224,948,133,60517,0,61465,133,1
1063358,3113141,1350,21,63494,0,64844,21,1
2981537,3666185,1252,4,118718,0,119970,4,1
1839283,4133537,765,13,36658,0,37423,13,1
1542757,1888777,283,318,5996,0,6279,318,1
3671141,2542336,1444,273,48400,0,49844,273,1
1815739,697093,248,20,6590,0,6838,20,1
3765475,4799712,873,1,107914,0,108787,1,1
515290,3696757,285,38,34080,0,34365,38,1
3206499,2664190,1337,2,32033,0,33370,2,1
4238001,42823,869,1,61161,0,62030,1,1
4011264,4061254,1360,150,116777,0,118137,150,1
3638272,4032011,2022,1,370904,0,372926,1,1
4314280,2496454,568,320,9552,2769,10120,3089,1
4827056,1642740,226,2,12578,0,12804,2,1
3633019,1990526,746,9,32317,0,33063,9,1
1633100,2874763,163,44,8737,0,8900,44,1
1966548,4784850,208,7,53149,0,53357,7,1
2851109,1412595,450,1,98552,0,99002,1,1
2827436,2498258,882,2,271525,0,272407,2,1
619999,3881948,69,20,95,0,164,20,1
3973900,3339475,193,79,934,287,1127,366,1
3361377,3912397,4841,4,761793,0,766634,4,1
4301309,4424796,323,217,4103,0,4426,217,1
1654099,1591765,1180,109,26347,0,27527,109,1
3438576,2083097,3424,43,137753,0,141177,43,1
4798192,1775823,816,36,20426,0,21242,36,1
4238001,4443577,869,509,61161,11936,62030,12445,1
1937293,4612964,434,5,16761,0,17195,5,1
4485028,1897666,445,47,14565,0,15010,47,1
3638272,4445032,2022,1,370904,0,372926,1,1
4838761,4854610,214,11,384,0,598,11,1
2666134,1461804,291,78,4395,0,4686,78,1
3765475,898724,873,13,107914,0,108787,13,1
2513691,2148351,244,43,17485,0,17729,43,1
1420087,3403884,204,50,1781,0,1985,50,1
2861639,3162144,481,20,10848,0,11329,20,1
4375756,3408662,64,31,284,0,348,31,1
3509903,4831861,1530,1,509445,0,510975,1,1
860473,1011282,751,3,20450,0,21201,3,1
4416945,3184704,417,175,33228,0,33645,175,1
3361377,1562866,4841,3,761793,0,766634,3,1
2260014,4842724,2466,67,98622,0,101088,67,1
2516076,4156082,1455,31,77782,0,79237,31,1
408965,1290065,903,31,38623,0,39526,31,1
4191410,2727185,1590,160,96434,0,98024,160,1
577580,1998353,187,41,3831,340,4018,381,1
3305012,2103465,184,45,273,80,457,125,1
2881894,2208687,211,262,7468,0,7679,262,1
4711909,611923,440,89,2933,0,3373,89,1
1723506,3969289,733,57,21835,0,22568,57,1
1884565,2368809,39,279,416,447,455,726,1
1973082,57574,1036,289,18915,4616,19951,4905,1
3294702,2436222,991,9,68888,0,69879,9,1
2950311,3992865,807,908,85116,0,85923,908,1
4563684,3876939,277,301,1011,0,1288,301,1
3561502,4058741,1144,41,68800,0,69944,41,1
427805,2324327,483,1,156906,0,157389,1,1
2529661,4276079,493,41,27309,0,27802,41,1
3438576,1373372,3424,17,137753,0,141177,17,1
4167572,1500344,81,2,6924,0,7005,2,1
2624998,2069538,52,4,394,0,446,4,1
1534362,4475963,1531,41,105859,0,107390,41,1
4500014,455139,114,124,727,0,841,124,1
671026,1103247,421,7,8079,0,8500,7,1
4738916,2962594,1165,23,34124,0,35289,23,1
1063857,1773273,248,2,15849,0,16097,2,1
805360,91752,1514,19,119306,0,120820,19,1
3280389,2336819,1101,3,411419,0,412520,3,1
4319972,148476,640,41,35279,0,35919,41,1
521586,3621341,782,1,18489,0,19271,1,1
1053923,776018,490,27,4567,0,5057,27,1
412067,2857273,87,82,692,0,779,82,1
3449530,1173025,717,40,73648,0,74365,40,1
3280389,2597643,1101,1,411419,0,412520,1,1
3632293,1041476,570,37,21294,0,21864,37,1
3638272,2476965,2022,1,370904,0,372926,1,1
2985909,4492503,706,78,43348,0,44054,78,1
3329010,3431315,84,161,290,374,374,535,1
1653998,4044496,24,423,1986,544,2010,967,1
870181,3283642,278,39,1377,0,1655,39,1
554693,1086957,75,8,583,0,658,8,1
3361377,1076897,4841,1,761793,0,766634,1,1
3395938,1131301,546,146,39878,0,40424,146,1
3569179,1255660,1064,8,40015,0,41079,8,1
2853969,2848302,1051,8,42591,0,43642,8,1
3509903,1279193,1530,91,509445,0,510975,91,1
1569537,2479080,24,1,350,0,374,1,1
3023881,1647942,1035,16,996,0,2031,16,1
4815919,1754436,367,102,3361,210,3728,312,1
1261156,413250,153,17,1944,0,2097,17,1
3065808,4086113,1235,17,82317,0,83552,17,1
4853234,2395019,1256,75,29554,1352,30810,1427,1
3065808,2186371,1235,27,82317,0,83552,27,1
1179906,3376173,316,119,14467,0,14783,119,1
1063358,4255676,1350,81,63494,0,64844,81,1
4451122,4034473,985,31,41669,0,42654,31,1
4829442,2886626,75,192,1847,6077,1922,6269,1
2884705,334357,649,3,10233,0,10882,3,1
932720,4167447,1411,72,111323,0,112734,72,1
4208044,1780368,247,52,3919,0,4166,52,1
2887240,3459361,1143,1,118405,0,119548,1,1
1875,3382683,656,155,61388,0,62044,155,1
1532003,903959,124,3,1671,0,1795,3,1
2950311,2655311,807,94,85116,0,85923,94,1
4858131,3937659,45,7,1083,0,1128,7,1
3361377,452529,4841,2,761793,0,766634,2,1
3373931,2826186,256,52,191,107,447,159,1
4313572,3509055,930,49,16971,0,17901,49,1
3992144,1920931,402,4,23683,0,24085,4,1
3280389,2684871,1101,1,411419,0,412520,1,1
4624595,4710789,722,2,53368,0,54090,2,1
1580988,893038,2821,21,400133,0,402954,21,1
1533762,4531012,110,87,1567,0,1677,87,1
1875,1211981,656,16,61388,0,62044,16,1
1947066,530930,27,41,481,0,508,41,1
1092045,3544563,242,46,9359,0,9601,46,1
4411704,1427934,69,6,389,0,458,6,1
2950311,1195550,807,93,85116,0,85923,93,1
3318449,454116,21,6,968,0,989,6,1
1541866,2250881,542,33,16481,0,17023,33,1
1914063,742111,119,115,1809,0,1928,115,1
889433,720204,170,240,3898,322,4068,562,1
427805,4842611,483,2,156906,0,157389,2,1
3509903,1409381,1530,1,509445,0,510975,1,1
2853969,569655,1051,1,42591,0,43642,1,1
938472,1480605,124,94,4326,0,4450,94,1
3973293,2753837,325,45,2788,0,3113,45,1
1896836,3103575,7,14,54,0,61,14,1
3280389,1344283,1101,1,411419,0,412520,1,1
4827056,3502432,226,199,12578,0,12804,199,1
1534362,3216684,1531,49,105859,0,107390,49,1
2216254,2400361,70,208,215,0,285,208,1
3954325,2173847,1743,3,16616,0,18359,3,1
97028,3207682,619,466,8923,0,9542,466,1
1580988,1776326,2821,1,400133,0,402954,1,1
2405789,2921830,1010,23,93387,0,94397,23,1
868049,2403744,35,8,2387,0,2422,8,1
3509903,1757378,1530,1,509445,0,510975,1,1
821330,2793437,28,582,288,25447,316,26029,1
2592965,2016771,567,58,1811,0,2378,58,1
2423803,2810307,25,131,90,92,115,223,1
3616842,3232820,317,644,3201,0,3518,644,1
4727207,4801442,925,3,84581,0,85506,3,1
4360960,1578312,1642,56,110084,0,111726,56,1
2950311,1621180,807,28,85116,0,85923,28,1
4140279,3852704,337,3,49384,0,49721,3,1
2877907,3653305,508,308,16021,0,16529,308,1
3849054,4058267,417,55,13259,0,13676,55,1
2342664,3280251,1181,35,26502,0,27683,35,1
2256870,4125019,66,197,1885,0,1951,197,1
957197,688342,614,88,37109,0,37723,88,1
483067,4520863,44,3432,244,908,288,4340,1
2257519,3776116,33,2,833,0,866,2,1
2542968,3799475,444,47,4728,0,5172,47,1
1973082,2031132,1036,100,18915,0,19951,100,1
4863023,832803,5,15,63,0,68,15,1
501863,1908221,19,7,221,0,240,7,1
3509903,387670,1530,1,509445,0,510975,1,1
471706,3762327,794,27,65616,0,66410,27,1
1493489,492768,523,411,17512,0,18035,411,1
291591,2222011,101,8,796,0,897,8,1
530200,4034070,2035,5,62809,0,64844,5,1
781211,3489823,976,148,51781,0,52757,148,1
2755798,1935752,494,2,24862,0,25356,2,1
1906425,194265,273,82,2940,677,3213,759,1
196521,4112677,1176,85,11269,0,12445,85,1
3361377,3398133,4841,2,761793,0,766634,2,1
4451122,3388337,985,7,41669,0,42654,7,1
4680108,1562315,49,95,1965,0,2014,95,1
4707515,3731680,38,18,127,0,165,18,1
4338728,2039572,18,4,182,0,200,4,1
2961552,2317859,562,167,16546,0,17108,167,1
1103332,127060,732,135,59415,0,60147,135,1
2827436,2048681,882,3,271525,0,272407,3,1
4238001,3137060,869,88,61161,0,62030,88,1
3561502,3008100,1144,66,68800,0,69944,66,1
1575009,2012549,429,50,37745,0,38174,50,1
724436,2684808,217,111,2547,0,2764,111,1
3500846,2994722,210,101,5085,0,5295,101,1
1927211,2113657,1668,255,113322,0,114990,255,1
1580988,1255403,2821,37,400133,0,402954,37,1
3765475,1731581,873,2,107914,0,108787,2,1
1367871,44049,104,10,6433,0,6537,10,1
544230,1628788,1532,47,60768,0,62300,47,1
4747661,2091039,436,218,4377,940,4813,1158,1
3835618,1442945,694,2,25433,0,26127,2,1
3638272,4627898,2022,1,370904,0,372926,1,1
3353207,574363,79,3,1465,0,1544,3,1
1735116,2199128,503,3,16146,0,16649,3,1
3099326,799274,176,41,1952,0,2128,41,1
1053923,299865,490,409,4567,1612,5057,2021,1
2289711,1003634,149,67,190,42,339,109,1
3906136,2350657,387,98,41169,0,41556,98,1
1580988,176588,2821,1,400133,0,402954,1,1
1577162,3198258,71,56,1118,0,1189,56,1
3630524,1057323,641,291,1221,1153,1862,1444,1
4119505,117617,344,11,1991,0,2335,11,1
1205168,380862,662,16,7710,0,8372,16,1
3540753,2511748,140,138,1499,0,1639,138,1
665164,4826676,396,99,12610,0,13006,99,1
2405789,1365813,1010,64,93387,0,94397,64,1
530200,2384512,2035,11,62809,0,64844,11,1
4815919,736737,367,25,3361,0,3728,25,1
1125432,2498015,298,27,2434,0,2732,27,1
1580988,443010,2821,1,400133,0,402954,1,1
593740,3438214,1107,136,62807,0,63914,136,1
3907996,526984,485,213,18964,0,19449,213,1
593740,2940810,1107,155,62807,0,63914,155,1
380998,1263848,200,1,8943,0,9143,1,1
3603938,296411,67,41,525,0,592,41,1
1580988,2257209,2821,3,400133,0,402954,3,1
1880135,4290640,810,107,71924,0,72734,107,1
2751572,2647249,481,107,44036,0,44517,107,1
1814268,3454617,59,8,4650,0,4709,8,1
3280389,2473875,1101,1,411419,0,412520,1,1
1875,1056197,656,26,61388,0,62044,26,1
649105,1417255,152,325,1548,72,1700,397,1
2893334,1495143,889,44,30148,0,31037,44,1
873006,1650068,375,101,33630,0,34005,101,1
4140279,1518459,337,7,49384,0,49721,7,1
2405789,787666,1010,9,93387,0,94397,9,1
376404,494774,193,8,1790,0,1983,8,1
660008,4864339,139,137,2004,0,2143,137,1
1633022,4368488,246,1,23530,0,23776,1,1
4295952,3143757,808,385,57369,0,58177,385,1
2297625,3313658,512,83,6498,0,7010,83,1
4598624,1826740,118,2,2264,0,2382,2,1
3691520,782483,533,54,9121,0,9654,54,1
957197,1234682,614,10,37109,0,37723,10,1
3936039,1679868,799,14,23884,0,24683,14,1
3561502,4274090,1144,5,68800,0,69944,5,1
553041,3480147,455,18,5962,0,6417,18,1
388331,4618437,618,372,1648,743,2266,1115,1
3734245,1633223,915,10,34965,0,35880,10,1
2260014,3977007,2466,3,98622,0,101088,3,1
4441473,2994370,103,46,1371,0,1474,46,1
4785101,1530549,150,22,1988,0,2138,22,1
1301815,4660115,752,33,48944,0,49696,33,1
2260014,1354221,2466,10,98622,0,101088,10,1
466667,2015770,442,20,4239,0,4681,20,1
4198771,4775869,207,51,8543,0,8750,51,1
2339440,4342918,87,8,1363,0,1450,8,1
1580988,3883972,2821,2,400133,0,402954,2,1
4181406,4468753,42,1,792,0,834,1,1
4261974,4307109,200,405,1448,0,1648,405,1
3509903,116440,1530,54,509445,0,510975,54,1
3280389,4102914,1101,1,411419,0,412520,1,1
3385289,1176156,648,104,7232,0,7880,104,1
1880135,2113917,810,25,71924,0,72734,25,1
1887669,2471353,733,58,23145,0,23878,58,1
1428477,1127420,255,231,15459,0,15714,231,1
2050190,1579667,153,67,9156,0,9309,67,1
3127090,2614551,678,1,10017,0,10695,1,1
427805,446724,483,2,156906,0,157389,2,1
4680723,4242341,69,14,961,0,1030,14,1
1839283,2154263,765,17,36658,0,37423,17,1
3509903,2623221,1530,2,509445,0,510975,2,1
3361377,4109554,4841,25,761793,0,766634,25,1
427805,4201949,483,2,156906,0,157389,2,1
645930,1007809,37,19,112,11,149,30,1
3361377,164249,4841,3,761793,0,766634,3,1
3361377,1152706,4841,48,761793,0,766634,48,1
4365938,2480433,250,33,10362,0,10612,33,1
3414197,1270713,365,30,1693,0,2058,30,1
919120,308104,205,121,2831,0,3036,121,1
4506423,2070220,101,44,1461,0,1562,44,1
2827436,2359941,882,2,271525,0,272407,2,1
1580988,2045514,2821,18,400133,0,402954,18,1
4330391,3359174,773,124,32759,0,33532,124,1
3676295,1679732,374,1,70881,0,71255,1,1
3449530,3460915,717,115,73648,0,74365,115,1
4249983,3452026,679,2,16076,0,16755,2,1
3414740,2891843,92,30,2484,0,2576,30,1
3280389,2129118,1101,1,411419,0,412520,1,1
1471685,3042377,1681,225,25550,0,27231,225,1
2347608,2939760,138,128,1313,2,1451,130,1
333887,901894,15,1,3610,0,3625,1,1
3721550,1127902,188,232,14527,0,14715,232,1
3280389,1660153,1101,1,411419,0,412520,1,1
4319972,4077629,640,101,35279,0,35919,101,1
3569179,3397023,1064,262,40015,0,41079,262,1
2159244,3095217,102,420,1434,0,1536,420,1
3023130,1865747,778,432,6402,0,7180,432,1
3028424,2134116,83,114,330,646,413,760,1
4451122,2032952,985,13,41669,0,42654,13,1
593740,1025675,1107,30,62807,0,63914,30,1
3611989,3250463,200,17,1156,0,1356,17,1
1494665,2265950,668,19,37638,0,38306,19,1
539720,3104446,189,86,519,1588,708,1674,1
3327021,1436216,71,1068,163,68770,234,69838,1
2827436,3313200,882,1,271525,0,272407,1,1
2687552,2888878,238,24,25574,0,25812,24,1
2751572,3049686,481,1,44036,0,44517,1,1
2256870,3318900,66,24,1885,0,1951,24,1
4191410,4392180,1590,52,96434,0,98024,52,1
3206499,4033976,1337,2,32033,0,33370,2,1
1527599,1901626,176,93,3575,0,3751,93,1
3361377,1309443,4841,2,761793,0,766634,2,1
4209323,4693699,1630,38,89460,0,91090,38,1
3105613,4540064,15,690,139,0,154,690,1
2101710,2033741,152,98,6934,0,7086,98,1
3280389,4472129,1101,1,411419,0,412520,1,1
866357,1234172,825,13,18479,0,19304,13,1
4416945,4767834,417,44,33228,0,33645,44,1
3257653,3800816,100,119,5222,0,5322,119,1
752618,2599162,169,33,5929,0,6098,33,1
3509903,1273664,1530,3,509445,0,510975,3,1
1533546,3169484,703,1,22095,0,22798,1,1
2818749,3623795,92,97,3797,0,3889,97,1
1416419,3616842,401,317,2098,3201,2499,3518,1
4587866,2570656,507,75,2074,0,2581,75,1
4208653,3079808,1820,30,21104,0,22924,30,1
4055608,1903752,126,506,1936,10494,2062,11000,1
3396719,2517999,660,56,8141,0,8801,56,1
3836080,3211537,1197,5,59457,0,60654,5,1
209437,259703,267,1,1876,0,2143,1,1
2148937,4831524,672,7,47361,0,48033,7,1
2536472,1615027,344,6,9725,0,10069,6,1
2998026,4417555,919,1,24182,0,25101,1,1
2148937,3859788,672,7,47361,0,48033,7,1
2985909,1713508,706,1,43348,0,44054,1,1
863643,2912370,517,4,1804,0,2321,4,1
1100354,3050691,163,1,24439,0,24602,1,1
1998083,3211968,123,81,953,0,1076,81,1
2342664,1666376,1181,1,26502,0,27683,1,1
4863752,4098097,162,11,16,0,178,11,1
873241,2401472,616,32,22633,0,23249,32,1
4272102,3997842,1608,136,104171,0,105779,136,1
4624595,2980373,722,199,53368,0,54090,199,1
3361377,1817756,4841,1,761793,0,766634,1,1
474172,543589,471,16,38713,0,39184,16,1
1249967,847228,207,75,11933,0,12140,75,1
1639434,1533546,587,703,8053,22095,8640,22798,1
3916794,2426859,9,159,413,0,422,159,1
3115867,1695520,1350,2,61232,0,62582,2,1
118180,797566,94,1,887,0,981,1,1
2482338,1709423,712,126,24222,0,24934,126,1
2755750,2652619,57,6,794,0,851,6,1
3135652,3614982,9,232,91,0,100,232,1
3280389,2127167,1101,1,411419,0,412520,1,1
1521114,877654,749,1838,1909,1348,2658,3186,1
1031334,4205856,459,86,16840,0,17299,86,1
2151493,2549432,36,413,980,269,1016,682,1
4011264,1745253,1360,48,116777,0,118137,48,1
3638272,1088340,2022,5,370904,0,372926,5,1
3361377,4386712,4841,1,761793,0,766634,1,1
4358855,3821804,36,8,2475,0,2511,8,1
765601,3054287,1485,26,101510,0,102995,26,1
765601,3651501,1485,83,101510,0,102995,83,1
1503116,3477326,415,7,37079,0,37494,7,1
781211,4134515,976,61,51781,0,52757,61,1
3298870,1485339,17,1,204,0,221,1,1
2267633,696578,422,56,13247,0,13669,56,1
3638272,1266022,2022,3,370904,0,372926,3,1
3280389,4679925,1101,2,411419,0,412520,2,1
2514271,806429,387,116,19070,0,19457,116,1
3183734,354867,123,54,1053,0,1176,54,1
1754547,271364,74,1541,139,171,213,1712,1
3361377,1573908,4841,2,761793,0,766634,2,1
2594373,2600407,236,81,2454,400,2690,481,1
2702681,3735277,287,339,2373,0,2660,339,1
3361377,1606380,4841,6,761793,0,766634,6,1
1878904,3451875,37,31,117,0,154,31,1
2793437,1887373,582,18,25447,0,26029,18,1
4168432,2251113,52,9,934,0,986,9,1
3422093,3150173,201,20,2559,0,2760,20,1
2854737,2198452,751,175,637,0,1388,175,1
3449530,1962685,717,41,73648,0,74365,41,1
474172,736474,471,11,38713,0,39184,11,1
408965,3545482,903,415,38623,0,39526,415,1
3630714,1902828,257,107,7929,0,8186,107,1
4330391,1881383,773,69,32759,0,33532,69,1
427805,1334074,483,2,156906,0,157389,2,1
457215,1372706,223,5,1057,0,1280,5,1
2110156,4499514,51,22,415,0,466,22,1
2381218,3022233,298,46,3375,0,3673,46,1
3294702,811750,991,88,68888,0,69879,88,1
3137585,746672,1196,23,77354,0,78550,23,1
4160129,1606927,30,188,453,0,483,188,1
4649206,4593104,566,83,31367,0,31933,83,1
3509903,1089210,1530,1,509445,0,510975,1,1
1051108,2712236,262,171,7542,0,7804,171,1
3509903,4312403,1530,2,509445,0,510975,2,1
3758692,3785923,711,35,34731,0,35442,35,1
873006,855616,375,105,33630,0,34005,105,1
1733957,4583901,554,137,15185,425,15739,562,1
2267633,568062,422,194,13247,0,13669,194,1
1349814,2894496,49,34,1056,0,1105,34,1
3671141,1213993,1444,53,48400,0,49844,53,1
2267131,4800806,205,194,2884,0,3089,194,1
2212117,374673,43,3,6252,0,6295,3,1
978797,3031094,599,12,12421,0,13020,12,1
860473,4458986,751,13,20450,0,21201,13,1
3676295,3091089,374,1,70881,0,71255,1,1
4191410,1530273,1590,27,96434,0,98024,27,1
522588,2633387,496,1,20091,0,20587,1,1
1269032,158420,19,3,166,0,185,3,1
1567043,2226882,40,2,1448,0,1488,2,1
559184,1679998,5,2,49,0,54,2,1
1306885,416770,172,709,3706,137,3878,846,1
1984622,4732607,145,2,20659,0,20804,2,1
781211,4388018,976,164,51781,0,52757,164,1
1103332,3282970,732,4,59415,0,60147,4,1
3112136,4478059,406,2,41366,0,41772,2,1
3638272,3952146,2022,1,370904,0,372926,1,1
3509903,605479,1530,2,509445,0,510975,2,1
3115867,3001431,1350,121,61232,0,62582,121,1
2027108,1887669,1172,733,5587,23145,6759,23878,1
1654099,630805,1180,8,26347,0,27527,8,1
1276253,4380609,407,1,46534,0,46941,1,1
3112136,3179360,406,53,41366,0,41772,53,1
91412,2630708,91,317,193,336,284,653,1
1250021,2664309,4637,17,85913,0,90550,17,1
4693243,1425896,223,3,202,0,425,3,1
431086,1603238,619,28,14910,0,15529,28,1
3872736,1572202,258,428,12660,0,12918,428,1
4378608,3807017,18,2,258,0,276,2,1
948128,301447,142,1,2383,0,2525,1,1
3235479,115830,999,46,66486,0,67485,46,1
259575,1735082,260,221,13949,0,14209,221,1
2150273,1511213,649,317,6442,0,7091,317,1
1503116,1860177,415,11,37079,0,37494,11,1
2209136,2502095,620,61,33789,0,34409,61,1
2476549,3754706,266,5,3070,0,3336,5,1
2444589,4601710,10,66,93,0,103,66,1
3907996,1105907,485,99,18964,0,19449,99,1
581535,4239696,1283,4,8414,0,9697,4,1
4744679,4658519,247,11,3462,0,3709,11,1
283997,3871554,81,947,281,16042,362,16989,1
1910777,3539877,477,10,1910,0,2387,10,1
3509903,1248657,1530,5,509445,0,510975,5,1
1125432,1281645,298,55,2434,0,2732,55,1
3841840,4726084,195,80,2931,0,3126,80,1
2516076,2496493,1455,45,77782,0,79237,45,1
500188,4669453,92,46,343,0,435,46,1
593740,2169776,1107,83,62807,0,63914,83,1
4011264,2844138,1360,57,116777,0,118137,57,1
2031305,1577725,396,53,23435,0,23831,53,1
3405059,4086676,261,437,9604,0,9865,437,1
3039218,1703512,17,1,779,0,796,1,1
1163180,4708250,606,122,5885,1075,6491,1197,1
2101844,4533523,279,224,1081,213,1360,437,1
3906136,3601998,387,12,41169,0,41556,12,1
1148474,807369,214,16,2785,0,2999,16,1
2424662,2134413,146,6,1110,0,1256,6,1
3871251,2210630,72,1119,203,16,275,1135,1
1069846,3876737,183,2951,702,1921,885,4872,1
846208,4553157,600,104,17288,0,17888,104,1
3396719,4226939,660,456,8141,2735,8801,3191,1
2617350,4077311,256,116,6547,0,6803,116,1
4564202,3007933,97,66,1554,0,1651,66,1
4438290,967058,185,68,871,0,1056,68,1
2516076,4704682,1455,45,77782,0,79237,45,1
2565218,50614,285,253,1750,2444,2035,2697,1
4624595,1917661,722,49,53368,0,54090,49,1
3361377,2875383,4841,2,761793,0,766634,2,1
1526503,1601507,29,129,999,6006,1028,6135,1
2644133,1049296,53,608,1100,0,1153,608,1
2851109,1049351,450,19,98552,0,99002,19,1
1709869,4799011,180,38,325,6,505,44,1
4360960,1314143,1642,20,110084,0,111726,20,1
1001390,677027,13,3,196,0,209,3,1
4272102,4713381,1608,5,104171,0,105779,5,1
3819396,4703405,29,4,250,0,279,4,1
2261139,120083,2014,20,42851,0,44865,20,1
2502456,1737509,719,149,50725,0,51444,149,1
502082,22756,589,1,16428,0,17017,1,1
3449530,1469315,717,2,73648,0,74365,2,1
748019,79295,675,19,18480,0,19155,19,1
907654,2425174,798,92,24575,0,25373,92,1
3280389,1013839,1101,5,411419,0,412520,5,1
792037,2486131,57,1,16445,0,16502,1,1
1580474,4545382,67,43,5377,0,5444,43,1
805360,4834417,1514,50,119306,0,120820,50,1
4853234,451627,1256,2,29554,0,30810,2,1
904957,93538,242,427,369,803,611,1230,1
821089,3683436,394,106,4820,0,5214,106,1
3638272,4622419,2022,1,370904,0,372926,1,1
2428341,3146039,826,1,10151,0,10977,1,1
3638272,2069008,2022,10,370904,0,372926,10,1
4729002,2155494,15,23,523,0,538,23,1
4372559,1742147,81,14,1096,0,1177,14,1
1497278,3296134,1869,516,35111,0,36980,516,1
3647860,1533546,168,703,242,22095,410,22798,1
3279091,489393,200,12,681,0,881,12,1
2260014,2347241,2466,5,98622,0,101088,5,1
1927211,4543951,1668,3,113322,0,114990,3,1
3916976,4470633,188,3,6098,0,6286,3,1
2513691,3513370,244,35,17485,0,17729,35,1
1739031,178333,85,6,453,0,538,6,1
3518048,1181383,66,50,1817,0,1883,50,1
64357,4373857,309,78,6329,0,6638,78,1
4618481,4510196,64,65,2014,0,2078,65,1
3361377,2011651,4841,1,761793,0,766634,1,1
1441897,3992926,52,26,1657,0,1709,26,1
4416945,4083790,417,204,33228,0,33645,204,1
4171214,3289282,358,74,4601,0,4959,74,1
3280389,1183751,1101,1,411419,0,412520,1,1
3137585,4241660,1196,34,77354,0,78550,34,1
3395938,3729984,546,289,39878,0,40424,289,1
2282519,2027770,68,188,223,0,291,188,1
873241,2452877,616,35,22633,0,23249,35,1
2096270,1698988,970,46,26018,0,26988,46,1
4417253,1658477,1130,15,68389,0,69519,15,1
4272102,4058313,1608,74,104171,0,105779,74,1
4411870,1157185,948,28,60517,0,61465,28,1
920553,2669834,349,109,8968,0,9317,109,1
354904,4302995,3193,7,105780,0,108973,7,1
4638702,3630356,37,8,1225,0,1262,8,1
4013542,3551313,76,452,781,470,857,922,1
4183784,4847212,931,17,59894,0,60825,17,1
4621952,346635,922,7,5245,0,6167,7,1
2529661,2311687,493,34,27309,0,27802,34,1
781211,281326,976,411,51781,0,52757,411,1
513426,4763985,57,27,713,0,770,27,1
2347608,364844,138,170,1313,0,1451,170,1
3509903,1291106,1530,1,509445,0,510975,1,1
3361377,2292602,4841,5,761793,0,766634,5,1
3742684,4712577,299,1,2003,0,2302,1,1
2291145,2773629,221,33,3037,0,3258,33,1
3509903,1490479,1530,2,509445,0,510975,2,1
2620077,1004506,136,72,491,248,627,320,1
2781817,2362804,704,140,24613,0,25317,140,1
2283004,2844837,143,72,2253,0,2396,72,1
1541866,4702825,542,182,16481,0,17023,182,1
2111696,4520306,170,502,121,675,291,1177,1
1541866,3753334,542,115,16481,0,17023,115,1
1337914,924621,225,92,1526,0,1751,92,1
2307868,3371390,1131,4,38777,0,39908,4,1
4011264,261897,1360,3,116777,0,118137,3,1
4676599,3031240,109,22,532,200,641,222,1
1103332,3950982,732,8,59415,0,60147,8,1
3280389,2862131,1101,2,411419,0,412520,2,1
1580988,3353998,2821,1,400133,0,402954,1,1
2336530,2343253,250,1882,1103,86401,1353,88283,1
3438483,1393909,155,112,284,215,439,327,1
1436216,4305303,1068,2,68770,0,69838,2,1
1880135,2330650,810,81,71924,0,72734,81,1
4487095,242578,125,57,533,0,658,57,1
4158925,2501144,72,8,438,0,510,8,1
3280389,301310,1101,1,411419,0,412520,1,1
781211,2838823,976,325,51781,0,52757,325,1
1641404,1171914,119,2431,866,795,985,3226,1
940526,1876559,475,53,20786,0,21261,53,1
1923198,4337708,531,116,3973,0,4504,116,1
3872736,419185,258,31,12660,0,12918,31,1
1852553,3863965,68,141,1324,0,1392,141,1
4496752,3621049,554,49,16258,0,16812,49,1
4435816,1762438,262,77,8391,460,8653,537,1
957197,314998,614,5,37109,0,37723,5,1
3906136,2248408,387,60,41169,0,41556,60,1
4327096,2324707,234,13,2944,0,3178,13,1
3759853,3552199,451,147,16330,0,16781,147,1
446533,4029113,243,65,2507,0,2750,65,1
2341838,2875611,75,44,3932,0,4007,44,1
474172,2693645,471,35,38713,0,39184,35,1
4451122,3471222,985,126,41669,0,42654,126,1
1534362,116832,1531,38,105859,0,107390,38,1
1580988,4290823,2821,2,400133,0,402954,2,1
837553,4700051,1249,55,61665,0,62914,55,1
1575009,1792361,429,92,37745,0,38174,92,1
3280389,1161440,1101,2,411419,0,412520,2,1
765601,2960004,1485,100,101510,0,102995,100,1
2650412,3538441,931,153,29038,0,29969,153,1
2147720,2929658,1608,35,78786,0,80394,35,1
4319972,2442292,640,24,35279,0,35919,24,1
3633019,3393389,746,74,32317,0,33063,74,1
1436216,3670897,1068,5,68770,0,69838,5,1
2052930,900257,407,1,8479,0,8886,1,1
1234540,558057,1071,98,75251,0,76322,98,1
1609659,2958105,523,12,29763,0,30286,12,1
1092700,3211413,44,19,382,0,426,19,1
4576296,305098,19,1,534,0,553,1,1
474172,3358135,471,39,38713,0,39184,39,1
4777191,3946230,86,25,3938,0,4024,25,1
4360799,3641600,910,751,10476,9269,11386,10020,1
2779329,1613428,217,141,6021,0,6238,141,1
744633,401770,24,6,282,0,306,6,1
4322182,3658844,83,1,3535,0,3618,1,1
2319861,729538,315,8,1517,0,1832,8,1
1218807,4603059,75,27,1283,0,1358,27,1
4011264,4468713,1360,90,116777,0,118137,90,1
2851109,4209072,450,2,98552,0,99002,2,1
2957859,3758673,190,151,4518,0,4708,151,1
2260121,2971006,262,135,521,0,783,135,1
3758692,2101703,711,115,34731,0,35442,115,1
1580988,2444097,2821,3,400133,0,402954,3,1
522588,265341,496,12,20091,0,20587,12,1
885928,979316,146,867,547,3442,693,4309,1
544230,2654714,1532,8,60768,0,62300,8,1
3058068,424133,124,2,12734,0,12858,2,1
2411474,638526,63,14,1921,0,1984,14,1
3914135,1485755,2152,248,60084,0,62236,248,1
1580988,2098634,2821,1,400133,0,402954,1,1
1615854,4295040,286,144,2590,0,2876,144,1
3120890,4760377,141,49,1294,0,1435,49,1
2881425,2289105,102,76,5272,0,5374,76,1
1103332,752132,732,30,59415,0,60147,30,1
2604348,998554,222,177,416,654,638,831,1
4727207,2335381,925,13,84581,0,85506,13,1
3361377,1115201,4841,1,761793,0,766634,1,1
1503116,2862550,415,24,37079,0,37494,24,1
3509903,1149205,1530,8,509445,0,510975,8,1
4853234,4164522,1256,27,29554,0,30810,27,1
256934,3653563,287,345,11635,0,11922,345,1
1545237,1926991,381,224,14327,0,14708,224,1
3912594,1183414,178,378,2010,0,2188,378,1
1591435,1653813,387,78,31245,0,31632,78,1
3119726,1929168,299,33,11573,0,11872,33,1
1213040,3414128,39,1,716,0,755,1,1
3335643,2751572,191,481,1944,44036,2135,44517,1
4708835,4803251,190,1,7539,0,7729,1,1
3638272,2316854,2022,29,370904,0,372926,29,1
3214893,1225627,1087,15,6553,0,7640,15,1
3531730,4002452,334,36,9763,0,10097,36,1
4534401,1696117,103,2,4125,0,4228,2,1
3112136,4687361,406,45,41366,0,41772,45,1
2064376,852451,139,5,5873,0,6012,5,1
1527599,115562,176,170,3575,0,3751,170,1
3449530,1415164,717,5,73648,0,74365,5,1
3140859,4219949,56,22,661,0,717,22,1
3361377,4574598,4841,3,761793,0,766634,3,1
1250021,1402590,4637,20,85913,0,90550,20,1
1653998,4568264,24,5,1986,0,2010,5,1
3638272,3371961,2022,1,370904,0,372926,1,1
4727207,2786482,925,3,84581,0,85506,3,1
2404691,4702756,46,327,494,2851,540,3178,1
2981537,594643,1252,3,118718,0,119970,3,1
3137263,2023929,48,3,275,0,323,3,1
4653941,266848,951,11,45883,0,46834,11,1
2681811,1431248,284,3,6285,0,6569,3,1
4191410,729410,1590,73,96434,0,98024,73,1
2428341,1445196,826,66,10151,0,10977,66,1
2095968,3978787,63,1204,326,15,389,1219,1
3501270,3542727,214,21,2145,341,2359,362,1
1580988,717569,2821,2,400133,0,402954,2,1
4547438,3644524,1291,12,25237,0,26528,12,1
3509903,4044404,1530,6,509445,0,510975,6,1
3914135,2451908,2152,44,60084,0,62236,44,1
2981537,164538,1252,7,118718,0,119970,7,1
3509903,4579476,1530,1,509445,0,510975,1,1
2281149,1068854,282,35,28082,0,28364,35,1
3509903,3157112,1530,1,509445,0,510975,1,1
98985,2260014,33,2466,258,98622,291,101088,1
3280389,3506825,1101,1,411419,0,412520,1,1
2197375,4090491,441,51,1498,0,1939,51,1
1580988,4238226,2821,1,400133,0,402954,1,1
1293807,3904135,1837,17,30865,0,32702,17,1
2443764,4557350,260,284,6836,0,7096,284,1
4220533,980119,329,9,3527,0,3856,9,1
4727207,1901313,925,4,84581,0,85506,4,1
1528542,158068,76,35,2395,0,2471,35,1
4727207,3490295,925,2,84581,0,85506,2,1
593740,1151907,1107,25,62807,0,63914,25,1
2597909,2052744,251,116,1527,249,1778,365,1
4011264,3293342,1360,20,116777,0,118137,20,1
4708541,3832717,981,62,15678,0,16659,62,1
1580988,2694764,2821,2,400133,0,402954,2,1
842476,2368549,898,97,12479,0,13377,97,1
1580508,1977837,720,52,19611,0,20331,52,1
3174202,4148023,379,30,1132,0,1511,30,1
2851109,646280,450,4,98552,0,99002,4,1
3918618,1976509,299,83,3785,0,4084,83,1
1279417,4097198,166,1045,776,0,942,1045,1
3973316,69735,97,233,1670,0,1767,233,1
2779329,1824609,217,73,6021,0,6238,73,1
1250021,2591057,4637,54,85913,0,90550,54,1
4496752,4865655,554,10,16258,0,16812,10,1
544230,3508097,1532,50,60768,0,62300,50,1
4330386,2411117,278,236,1246,0,1524,236,1
3277610,3702604,82,1,387,0,469,1,1
4750855,4210554,355,210,18880,0,19235,210,1
1580988,2303165,2821,9,400133,0,402954,9,1
2529661,4004228,493,231,27309,0,27802,231,1
4463545,4590284,94,61,3842,0,3936,61,1
1503116,4425744,415,39,37079,0,37494,39,1
2772113,3987027,792,4,42907,0,43699,4,1
4183784,3858919,931,16,59894,0,60825,16,1
848275,2843308,76,82,1423,0,1499,82,1
3405059,2316746,261,124,9604,0,9865,124,1
4078144,4785909,22,2,998,0,1020,2,1
1539837,3524073,1127,157,62979,3319,64106,3476,1
2709991,3199912,37,32,926,0,963,32,1
4479954,667783,70,11,2167,0,2237,11,1
3844858,997093,1591,79,28974,0,30565,79,1
3206499,3459429,1337,7,32033,0,33370,7,1
4165959,1629019,40,351,188,5823,228,6174,1
1439091,1025213,95,17,568,0,663,17,1
427805,2668360,483,6,156906,0,157389,6,1
4320056,1308368,56,2,1873,0,1929,2,1
3280389,4707228,1101,1,411419,0,412520,1,1
3361377,4438446,4841,2,761793,0,766634,2,1
1241907,2967747,176,59,1602,0,1778,59,1
3585791,544230,28,1532,67,60768,95,62300,1
2827436,4376376,882,2,271525,0,272407,2,1
837553,1984886,1249,44,61665,0,62914,44,1
2569009,3868583,424,12,13423,0,13847,12,1
4451122,1562354,985,81,41669,0,42654,81,1
2099723,2031080,97,211,1446,0,1543,211,1
3280389,4113869,1101,1,411419,0,412520,1,1
4233503,4053574,224,18,7867,0,8091,18,1
805360,4626911,1514,20,119306,0,120820,20,1
3906136,3040065,387,67,41169,0,41556,67,1
2893334,584054,889,102,30148,0,31037,102,1
3094886,2397149,675,340,6621,3873,7296,4213,1
3280389,3092147,1101,3,411419,0,412520,3,1
517644,1083298,2203,27,576,0,2779,27,1
2887240,2296895,1143,2,118405,0,119548,2,1
3638272,4095873,2022,1,370904,0,372926,1,1
1577162,4552298,71,35,1118,0,1189,35,1
1575009,1715289,429,38,37745,0,38174,38,1
4649206,3597159,566,79,31367,0,31933,79,1
1805743,5234,316,94,3694,0,4010,94,1
354904,2272591,3193,223,105780,0,108973,223,1
3137585,4536377,1196,25,77354,0,78550,25,1
2870711,1635215,87,209,2239,8253,2326,8462,1
4463545,1758736,94,97,3842,0,3936,97,1
2674718,2656382,136,114,5233,0,5369,114,1
4789203,334561,355,5,11315,0,11670,5,1
3561502,4019713,1144,47,68800,0,69944,47,1
530200,3200781,2035,63,62809,0,64844,63,1
1580988,117168,2821,3,400133,0,402954,3,1
957197,432955,614,4,37109,0,37723,4,1
1580988,588085,2821,3,400133,0,402954,3,1
932720,2430076,1411,45,111323,0,112734,45,1
4244384,2916950,45,1,1114,0,1159,1,1
2163640,1697514,129,4,5750,0,5879,4,1
3242275,3978997,551,20,17400,0,17951,20,1
2502456,2857744,719,79,50725,0,51444,79,1
1515079,1521207,55,10,569,0,624,10,1
2827436,4073116,882,1,271525,0,272407,1,1
2887240,3161191,1143,1,118405,0,119548,1,1
4518123,2931461,300,38,6419,0,6719,38,1
1580988,1129894,2821,2,400133,0,402954,2,1
3280389,1642289,1101,2,411419,0,412520,2,1
2772113,205128,792,17,42907,0,43699,17,1
3509903,2398621,1530,2,509445,0,510975,2,1
941535,3509903,15,1530,150,509445,165,510975,1
2897926,4638373,565,2,25983,0,26548,2,1
1652056,789939,326,1,66845,0,67171,1,1
3438576,4865743,3424,11,137753,0,141177,11,1
1053923,912770,490,27,4567,0,5057,27,1
3691520,4292883,533,99,9121,0,9654,99,1
2260014,594871,2466,6,98622,0,101088,6,1
2757156,1656003,237,153,8153,0,8390,153,1
4272102,259287,1608,41,104171,0,105779,41,1
1100354,2458000,163,1,24439,0,24602,1,1
915390,2114012,1345,1,5262,0,6607,1,1
3765475,1261373,873,25,107914,0,108787,25,1
4788253,3729883,364,114,3550,0,3914,114,1
4408813,1245729,288,1,10077,0,10365,1,1
2872979,2406249,341,10,28510,0,28851,10,1
1580988,1700452,2821,2,400133,0,402954,2,1
427805,4797365,483,2,156906,0,157389,2,1
235772,3562385,16,28,44,14,60,42,1
1580988,223527,2821,4,400133,0,402954,4,1
941936,1887669,63,733,623,23145,686,23878,1
2961801,2643468,1483,48,101962,0,103445,48,1
765601,4353205,1485,76,101510,0,102995,76,1
805360,1277108,1514,48,119306,0,120820,48,1
1580988,4255307,2821,8,400133,0,402954,8,1
3509903,2071440,1530,1,509445,0,510975,1,1
3361377,2207266,4841,4,761793,0,766634,4,1
379662,1549768,19,129,430,9,449,138,1
3668051,2725073,89,23,3044,0,3133,23,1
4508636,2915820,287,476,1174,1811,1461,2287,1
1539837,4148323,1127,12,62979,0,64106,12,1
28346,1803933,142,9,1997,0,2139,9,1
4238001,1155540,869,80,61161,0,62030,80,1
3954325,4487401,1743,2,16616,0,18359,2,1
3509903,3953627,1530,2,509445,0,510975,2,1
1249967,169137,207,174,11933,0,12140,174,1
4582129,1579729,1231,176,10356,1152,11587,1328,1
269982,4688743,351,101,9019,0,9370,101,1
3280389,2209927,1101,1,411419,0,412520,1,1
3412172,2793249,227,4,2700,0,2927,4,1
680015,3501482,485,522,9502,28046,9987,28568,1
60980,2689229,649,1,20708,0,21357,1,1
3509903,2823854,1530,1,509445,0,510975,1,1
4751453,47925,520,46,27570,0,28090,46,1
805360,2968997,1514,44,119306,0,120820,44,1
3638272,996301,2022,1,370904,0,372926,1,1
1163500,2767786,398,10,9540,0,9938,10,1
3065808,4701153,1235,95,82317,0,83552,95,1
2433535,3809223,1,1,40,0,41,1,1
1764733,4642864,23,295,249,0,272,295,1
2827436,10597,882,1,271525,0,272407,1,1
2981537,4018622,1252,2,118718,0,119970,2,1
3458198,1880112,60,40,4425,0,4485,40,1
3918618,2058861,299,23,3785,0,4084,23,1
530200,4757564,2035,15,62809,0,64844,15,1
2075015,1692131,2664,23,85781,0,88445,23,1
462477,86093,240,116,2418,0,2658,116,1
3395853,1486646,252,725,3685,0,3937,725,1
4861923,2615523,161,68,1311,352,1472,420,1
3509903,2475854,1530,1,509445,0,510975,1,1
1633022,2291590,246,1,23530,0,23776,1,1
1852553,1174045,68,16,1324,0,1392,16,1
3480840,2141100,74,220,305,0,379,220,1
2989110,4084371,1042,149,19283,0,20325,149,1
1534362,977430,1531,60,105859,0,107390,60,1
1968010,445996,786,1175,10371,12828,11157,14003,1
3198742,684669,551,4,5252,0,5803,4,1
2260014,3824274,2466,61,98622,0,101088,61,1
2738160,2584094,229,116,414,388,643,504,1
135360,566685,333,10,2006,0,2339,10,1
4302921,1526409,509,22,13289,0,13798,22,1
3708922,1385530,42,72,1414,0,1456,72,1
4109624,3929324,118,1,437,0,555,1,1
4540813,2210735,72,1,285,0,357,1,1
1580988,475153,2821,1,400133,0,402954,1,1
4727207,1619556,925,1,84581,0,85506,1,1
2516076,3273624,1455,67,77782,0,79237,67,1
3361377,210415,4841,1,761793,0,766634,1,1
4785101,4334937,150,300,1988,0,2138,300,1
2405789,1530598,1010,93,93387,0,94397,93,1
3935366,1719466,377,67,3803,0,4180,67,1
1250021,1922974,4637,10,85913,0,90550,10,1
3687762,3894763,627,53,3168,0,3795,53,1
499414,1924872,316,361,3543,5715,3859,6076,1
1684694,1586521,46,20,548,0,594,20,1
3395938,1724228,546,3,39878,0,40424,3,1
1446824,4572032,569,62,4958,0,5527,62,1
329881,4255021,36,3,610,0,646,3,1
3610598,1604955,380,77,17343,0,17723,77,1
858760,3458992,33,305,923,0,956,305,1
4642569,1264429,872,9,27586,0,28458,9,1
1290789,3686774,41,83,4048,506,4089,589,1
2502456,3305816,719,37,50725,0,51444,37,1
3117712,1698155,20,273,138,96,158,369,1
1894807,2278935,128,1769,1819,0,1947,1769,1
4735272,4136108,10,2,181,0,191,2,1
2597909,1239849,251,1,1527,0,1778,1,1
2981537,3663962,1252,6,118718,0,119970,6,1
1436216,3012978,1068,1,68770,0,69838,1,1
1992385,3538375,186,36,399,0,585,36,1
4625755,800617,130,18,1609,0,1739,18,1
3481139,843285,168,622,829,0,997,622,1
2861639,2613256,481,2,10848,0,11329,2,1
151693,4384984,436,27,12181,0,12617,27,1
3094886,2573526,675,222,6621,539,7296,761,1
3764177,3592982,1036,32,64563,0,65599,32,1
670587,4043805,651,403,9779,0,10430,403,1
4750855,2573992,355,2,18880,0,19235,2,1
4208653,2815368,1820,19,21104,0,22924,19,1
2405789,1219387,1010,47,93387,0,94397,47,1
988087,321744,322,136,3765,0,4087,136,1
860473,70560,751,68,20450,0,21201,68,1
2910246,3121115,26,83,524,0,550,83,1
4678614,2453609,452,146,16881,0,17333,146,1
2950311,4379296,807,62,85116,0,85923,62,1
3764177,1702876,1036,97,64563,0,65599,97,1
4417253,1776605,1130,69,68389,0,69519,69,1
1185502,1761258,197,25,1739,0,1936,25,1
2285283,1568436,279,2,6799,0,7078,2,1
2650412,2868168,931,7,29038,0,29969,7,1
3112136,2889899,406,62,41366,0,41772,62,1
4678614,1458944,452,3,16881,0,17333,3,1
1400162,1582726,29,1,428,0,457,1,1
3462300,38602,342,12,2917,0,3259,12,1
4191410,433488,1590,23,96434,0,98024,23,1
3164098,1119239,87,21,404,0,491,21,1
4191410,1356830,1590,74,96434,0,98024,74,1
1591435,477606,387,7,31245,0,31632,7,1
2893334,4455271,889,167,30148,0,31037,167,1
4798192,3057003,816,6,20426,0,21242,6,1
3361377,585498,4841,2,761793,0,766634,2,1
2827436,109239,882,1,271525,0,272407,1,1
3137585,472157,1196,51,77354,0,78550,51,1
203830,4813130,33,9,877,0,910,9,1
4078300,2476526,50,96,388,0,438,96,1
4423184,1858398,384,6,29809,0,30193,6,1
3082104,3706350,47,1,4343,0,4390,1,1
4860485,423224,89,98,3655,0,3744,98,1
4105499,2227189,9,27,80,0,89,27,1
2174130,2999854,86,19,1368,0,1454,19,1
1580508,1099584,720,25,19611,0,20331,25,1
584906,3530104,253,29,6639,0,6892,29,1
3278135,4525494,358,5,7252,0,7610,5,1
309382,247642,135,14,4536,0,4671,14,1
1436216,2672914,1068,1,68770,0,69838,1,1
4547438,2822537,1291,90,25237,0,26528,90,1
1545237,1502707,381,2,14327,0,14708,2,1
1580988,4264054,2821,106,400133,0,402954,106,1
1370197,1680255,665,38,3306,67,3971,105,1
4479581,3535665,601,575,19545,0,20146,575,1
649773,4527666,269,107,339,0,608,107,1
3759853,1593039,451,8,16330,0,16781,8,1
4186494,3329439,57,99,599,0,656,99,1
2075015,3763270,2664,4,85781,0,88445,4,1
4018742,3103937,115,1,3140,0,3255,1,1
4624595,598490,722,82,53368,0,54090,82,1
1580988,2604555,2821,62,400133,0,402954,62,1
3912065,4311097,67,7,1262,0,1329,7,1
8722,3062319,210,97,1258,0,1468,97,1
2439199,3198666,631,15,5929,0,6560,15,1
1139873,277960,670,24,10236,0,10906,24,1
3676295,2659495,374,3,70881,0,71255,3,1
405955,425305,109,7,6949,0,7058,7,1
1889981,3770439,20,18,1019,0,1039,18,1
2827436,2429865,882,2,271525,0,272407,2,1
4011264,1753337,1360,16,116777,0,118137,16,1
2853969,3684222,1051,1,42591,0,43642,1,1
514292,3002746,138,286,707,3847,845,4133,1
1927211,350902,1668,48,113322,0,114990,48,1
3346033,3656128,320,48,9541,0,9861,48,1
431709,2026854,205,1,5602,0,5807,1,1
1428477,1375915,255,7,15459,0,15714,7,1
3280389,1914611,1101,1,411419,0,412520,1,1
2981537,4678258,1252,1,118718,0,119970,1,1
3234597,115767,34,106,760,0,794,106,1
2498087,3888011,1630,126,32582,0,34212,126,1
2853969,2977875,1051,6,42591,0,43642,6,1
2569009,4012608,424,25,13423,0,13847,25,1
941212,747967,184,43,6404,0,6588,43,1
448517,2162552,625,153,12450,0,13075,153,1
1817799,3952033,402,103,15932,0,16334,103,1
2498087,4656945,1630,192,32582,0,34212,192,1
3449530,4813520,717,18,73648,0,74365,18,1
2709991,46573,37,6,926,0,963,6,1
2772113,1837981,792,179,42907,0,43699,179,1
4717932,4622457,40,52,627,0,667,52,1
805360,755509,1514,20,119306,0,120820,20,1
4011264,4559657,1360,105,116777,0,118137,105,1
3280389,1243485,1101,2,411419,0,412520,2,1
3794146,1888029,16,4,281,0,297,4,1
2357347,1169691,49,291,602,0,651,291,1
846208,2723967,600,114,17288,0,17888,114,1
665164,2106454,396,51,12610,0,13006,51,1
4329730,780562,395,1315,3730,1558,4125,2873,1
3278135,3720702,358,7,7252,0,7610,7,1
805360,2266235,1514,38,119306,0,120820,38,1
3742930,2114274,410,2,22242,0,22652,2,1
4035655,4398275,913,197,5979,844,6892,1041,1
4642569,4267114,872,106,27586,0,28458,106,1
428243,1639000,5,45,179,0,184,45,1
3361377,2179273,4841,2,761793,0,766634,2,1
2441425,3111775,803,379,18561,0,19364,379,1
393185,4510168,591,78,7719,0,8310,78,1
4062175,2860038,248,5,8522,0,8770,5,1
3638272,4661215,2022,2,370904,0,372926,2,1
2191846,4265654,51,692,1499,0,1550,692,1
2075015,40872,2664,16,85781,0,88445,16,1
4330391,2190913,773,23,32759,0,33532,23,1
354904,217563,3193,48,105780,0,108973,48,1
1063358,4855140,1350,196,63494,0,64844,196,1
998622,1494587,66,18,792,0,858,18,1
1879936,4218374,281,89,6786,0,7067,89,1
3280389,2994790,1101,2,411419,0,412520,2,1
2266398,2511334,209,102,1473,0,1682,102,1
1100354,2676469,163,3,24439,0,24602,3,1
3509903,1979146,1530,1,509445,0,510975,1,1
2751572,278813,481,27,44036,0,44517,27,1
91116,4397964,239,43,2466,0,2705,43,1
97028,3623554,619,69,8923,0,9542,69,1
3058068,2534373,124,4,12734,0,12858,4,1
2107861,3827952,535,2,25743,0,26278,2,1
3280389,2840485,1101,1,411419,0,412520,1,1
1206697,1490138,685,124,5595,0,6280,124,1
1023574,1038552,54,25,591,0,645,25,1
4102361,3182686,56,8,457,0,513,8,1
4624595,1476979,722,3,53368,0,54090,3,1
3235479,3817178,999,23,66486,0,67485,23,1
1927211,2659644,1668,57,113322,0,114990,57,1
4451122,3805905,985,61,41669,0,42654,61,1
1927211,501914,1668,217,113322,5217,114990,5434,1
3280389,3370088,1101,2,411419,0,412520,2,1
3361377,4747222,4841,3,761793,0,766634,3,1
787416,4344914,115,3,9954,0,10069,3,1
515290,4463282,285,15,34080,0,34365,15,1
3764177,3409072,1036,128,64563,0,65599,128,1
3119726,3036059,299,8,11573,0,11872,8,1
3509214,3854403,263,55,14139,0,14402,55,1
4030529,1475490,299,39,3324,0,3623,39,1
2755798,2622094,494,2,24862,0,25356,2,1
3638272,3430442,2022,1,370904,0,372926,1,1
3361377,4005425,4841,1,761793,0,766634,1,1
196521,1646004,1176,621,11269,487,12445,1108,1
544230,2892104,1532,2,60768,0,62300,2,1
1055530,933462,415,8,14969,0,15384,8,1
474172,350538,471,67,38713,0,39184,67,1
2502456,1631659,719,89,50725,0,51444,89,1
1055530,2331056,415,48,14969,0,15384,48,1
3361377,2094950,4841,70,761793,0,766634,70,1
4202576,4382571,600,6,10697,0,11297,6,1
2851923,1740803,242,141,1496,0,1738,141,1
3128197,3651645,122,61,6176,0,6298,61,1
1887669,4634846,733,34,23145,0,23878,34,1
2092359,794859,421,39,26936,0,27357,39,1
2650412,4049968,931,30,29038,0,29969,30,1
3284020,2829071,111,45,2181,0,2292,45,1
703541,3218504,58,11,138,0,196,11,1
3765475,400734,873,25,107914,0,108787,25,1
600551,1954916,60,2,293,0,353,2,1
2090342,4176323,155,113,2211,0,2366,113,1
2772113,4623861,792,20,42907,0,43699,20,1
2052930,354194,407,3,8479,0,8886,3,1
892512,2678275,1505,71,11757,0,13262,71,1
1628356,3407339,49,36,1715,0,1764,36,1
1887669,2743659,733,420,23145,4277,23878,4697,1
3509903,4238799,1530,5,509445,0,510975,5,1
3853609,1757594,505,145,6896,0,7401,145,1
172652,1946499,108,362,119,0,227,362,1
550699,322673,19,2,229,0,248,2,1
2851109,3937373,450,2,98552,0,99002,2,1
4390232,2785762,113,131,1949,0,2062,131,1
4762830,2935737,1043,2,2352,0,3395,2,1
2022081,185931,143,2,1466,0,1609,2,1
1196844,1435719,548,180,36289,0,36837,180,1
1595696,3259328,44,20,931,0,975,20,1
4519298,1225569,577,35,14443,0,15020,35,1
1685063,310957,23,96,80,349,103,445,1
1575009,1173029,429,13,37745,0,38174,13,1
837553,4396162,1249,48,61665,0,62914,48,1
1638027,4592122,60,1748,422,8,482,1756,1
1880135,2021896,810,52,71924,0,72734,52,1
1887669,869037,733,15,23145,0,23878,15,1
4220190,2227812,320,16,15994,0,16314,16,1
3765475,681169,873,4,107914,0,108787,4,1
1723506,4124664,733,225,21835,0,22568,225,1
1170741,1799593,136,33,1381,0,1517,33,1
4621952,681064,922,16,5245,0,6167,16,1
1063358,2337678,1350,44,63494,352,64844,396,1
3280389,275877,1101,2,411419,0,412520,2,1
4191727,3910709,463,42,26315,0,26778,42,1
1580474,4712807,67,2,5377,0,5444,2,1
3214492,4725778,32,199,150,0,182,199,1
3115867,2631924,1350,1,61232,0,62582,1,1
2405789,4823514,1010,58,93387,0,94397,58,1
1309175,854848,97,167,917,0,1014,167,1
4577905,1741911,57,3,400,0,457,3,1
521586,191895,782,33,18489,0,19271,33,1
2851109,2985645,450,2,98552,0,99002,2,1
1652056,3226559,326,1,66845,0,67171,1,1
3638272,756863,2022,1,370904,0,372926,1,1
2148937,1544440,672,1,47361,0,48033,1,1
3824547,316762,1075,2,14337,0,15412,2,1
3588630,1136083,351,193,7803,0,8154,193,1
1103332,3403025,732,8,59415,0,60147,8,1
2209969,2669256,175,37,1921,0,2096,37,1
4209323,40692,1630,3,89460,0,91090,3,1
1321779,3521656,320,635,2517,0,2837,635,1
3361377,1481403,4841,1,761793,0,766634,1,1
2016554,3468753,18,2,1603,0,1621,2,1
1633100,1156432,163,26,8737,0,8900,26,1
1580988,1352821,2821,49,400133,0,402954,49,1
3072769,1879793,187,3,3430,0,3617,3,1
4209323,3478733,1630,5,89460,0,91090,5,1
2887240,1346482,1143,2,118405,0,119548,2,1
3147347,4501260,172,4,1534,0,1706,4,1
4710755,2503592,21,1,339,0,360,1,1
3535172,901971,21,8,167,0,188,8,1
3361377,3199656,4841,1,761793,0,766634,1,1
2961801,3914193,1483,21,101962,0,103445,21,1
1224283,3978787,5,1204,67,15,72,1219,1
474172,4732295,471,193,38713,0,39184,193,1
3902393,3897799,56,19,257,0,313,19,1
471706,436117,794,61,65616,0,66410,61,1
2460525,2539518,10,16,51,0,61,16,1
3567246,611188,192,71,3712,0,3904,71,1
2687552,4711576,238,16,25574,0,25812,16,1
1609659,2523383,523,68,29763,0,30286,68,1
2755798,1957865,494,21,24862,0,25356,21,1
687713,4605576,436,1,47160,0,47596,1,1
904566,3987684,14,286,1300,17372,1314,17658,1
256934,3280183,287,3,11635,0,11922,3,1
2306134,950039,337,2,5153,0,5490,2,1
2887240,716646,1143,1,118405,0,119548,1,1
1847461,2095143,1211,77,51149,0,52360,77,1
3638272,1431052,2022,2,370904,0,372926,2,1
2189067,432549,356,34,6408,0,6764,34,1
3025220,4414074,27,3,60,0,87,3,1
4319972,3992121,640,259,35279,1314,35919,1573,1
2897926,3443824,565,95,25983,0,26548,95,1
1092203,1274046,174,613,1996,2455,2170,3068,1
3235479,3511589,999,37,66486,0,67485,37,1
382977,1117824,143,265,5934,0,6077,265,1
4451122,1256808,985,222,41669,0,42654,222,1
1784246,4118332,45,12,91,0,136,12,1
1875,3861335,656,83,61388,0,62044,83,1
4750855,4798910,355,64,18880,0,19235,64,1
2439199,1475357,631,21,5929,0,6560,21,1
427805,669651,483,14,156906,0,157389,14,1
521586,504365,782,59,18489,0,19271,59,1
1913445,2966154,564,185,47943,0,48507,185,1
2464401,1442406,577,501,23681,0,24258,501,1
1331940,29477,802,155,32617,0,33419,155,1
4183828,2780968,83,5,444,0,527,5,1
1230288,4565084,37,15,1909,0,1946,15,1
1580988,3634141,2821,2,400133,0,402954,2,1
3522049,4230577,301,11,12347,0,12648,11,1
3140664,1198575,268,3,16099,0,16367,3,1
1534362,1627139,1531,56,105859,0,107390,56,1
1639434,2732723,587,556,8053,0,8640,556,1
4011264,381610,1360,1,116777,0,118137,1,1
3361377,3973203,4841,5,761793,0,766634,5,1
4238001,3701546,869,38,61161,0,62030,38,1
3453056,3853387,45,214,1175,0,1220,214,1
4828134,3795200,221,19,115,0,336,19,1
1616819,4147957,20,2,116,0,136,2,1
1580988,4733985,2821,1,400133,0,402954,1,1
522588,771277,496,132,20091,0,20587,132,1
2467847,1147878,204,6,267,0,471,6,1
3842148,2528054,719,92,11430,0,12149,92,1
805360,1657814,1514,225,119306,0,120820,225,1
3929270,1067488,257,91,2972,346,3229,437,1
3280389,3784809,1101,2,411419,0,412520,2,1
3873768,1892549,449,334,35424,0,35873,334,1
3396719,2608604,660,172,8141,0,8801,172,1
2887240,1624710,1143,5,118405,0,119548,5,1
3671141,3286310,1444,34,48400,0,49844,34,1
4238001,1900154,869,43,61161,0,62030,43,1
2827436,3420619,882,1,271525,0,272407,1,1
4191410,4675847,1590,32,96434,0,98024,32,1
3638272,599289,2022,1,370904,0,372926,1,1
805360,1496413,1514,28,119306,0,120820,28,1
932720,2410500,1411,33,111323,0,112734,33,1
2851109,1838985,450,6,98552,0,99002,6,1
1503116,4426893,415,32,37079,0,37494,32,1
307250,4338741,919,284,35588,0,36507,284,1
370461,3071530,103,52,1991,0,2094,52,1
3361377,3548235,4841,1,761793,0,766634,1,1
4624595,1178766,722,108,53368,0,54090,108,1
3361377,2370098,4841,2,761793,0,766634,2,1
408965,1835344,903,72,38623,0,39526,72,1
3758692,2922739,711,107,34731,0,35442,107,1
3271484,336954,1507,6,34093,0,35600,6,1
4799966,1894263,557,4,4819,0,5376,4,1
3280389,1063325,1101,3,411419,0,412520,3,1
1015986,458735,604,34,14201,0,14805,34,1
386424,548487,131,43,7871,0,8002,43,1
1580988,3710797,2821,1,400133,0,402954,1,1
4708541,2452064,981,40,15678,0,16659,40,1
3509903,711051,1530,6,509445,0,510975,6,1
502082,1819519,589,22,16428,0,17017,22,1
3524073,3218487,157,131,3319,0,3476,131,1
2260014,1241168,2466,132,98622,0,101088,132,1
2263130,1588987,712,22,14043,0,14755,22,1
4207792,2330880,365,4,2689,0,3054,4,1
4313884,2362854,68,56,864,0,932,56,1
2793423,2304268,122,1,1527,0,1649,1,1
4717932,2249342,40,117,627,0,667,117,1
4656285,1512543,1446,2,35428,0,36874,2,1
3683235,1981101,311,85,23110,0,23421,85,1
2961552,143320,562,47,16546,0,17108,47,1
2075015,4173022,2664,39,85781,0,88445,39,1
3354607,685385,812,37,704,0,1516,37,1
2209891,349043,204,160,4060,0,4264,160,1
1906776,3160057,63,2358,1962,187,2025,2545,1
1580988,621342,2821,1,400133,0,402954,1,1
1250021,958112,4637,6,85913,0,90550,6,1
768957,2488845,202,25,7986,0,8188,25,1
3638272,2791827,2022,2,370904,0,372926,2,1
2611624,4757712,105,36,4088,0,4193,36,1
3638272,4009100,2022,2,370904,0,372926,2,1
4219659,1677469,28,20,463,0,491,20,1
1431189,3987633,167,425,3075,0,3242,425,1
417999,1823441,173,82,2109,0,2282,82,1
487744,111385,138,33,2488,0,2626,33,1
3361377,2368728,4841,2,761793,0,766634,2,1
2267633,2279762,422,125,13247,0,13669,125,1
2576364,873320,108,90,1654,0,1762,90,1
345047,3761094,111,34,2534,0,2645,34,1
3361377,3203614,4841,13,761793,0,766634,13,1
166004,3454055,27,2914,888,54,915,2968,1
765601,1680868,1485,19,101510,0,102995,19,1
2823755,4576651,13,6,104,0,117,6,1
1839283,2912352,765,4,36658,0,37423,4,1
3509903,624671,1530,35,509445,0,510975,35,1
4798192,1776479,816,94,20426,0,21242,94,1
2998026,3889641,919,2,24182,0,25101,2,1
1638032,1762087,91,72,3942,0,4033,72,1
267602,2511945,28,79,318,0,346,79,1
2342664,3872772,1181,63,26502,0,27683,63,1
3175944,2347608,324,138,7415,1313,7739,1451,1
3137585,3864796,1196,12,77354,0,78550,12,1
2950311,1344229,807,81,85116,0,85923,81,1
1302472,2500623,164,609,3470,0,3634,609,1
2207944,3525302,165,71,4573,0,4738,71,1
3262907,3496228,142,48,2245,0,2387,48,1
309382,2485780,135,11,4536,0,4671,11,1
2502456,4183432,719,9,50725,0,51444,9,1
474172,4468548,471,85,38713,0,39184,85,1
3210349,1350306,46,943,3372,0,3418,943,1
427805,1390384,483,1,156906,0,157389,1,1
3509903,2252459,1530,1,509445,0,510975,1,1
2821086,3950903,152,29,4157,0,4309,29,1
4727207,1176820,925,24,84581,0,85506,24,1
530200,102755,2035,134,62809,0,64844,134,1
3575260,3141539,242,244,5576,0,5818,244,1
499414,1319751,316,119,3543,0,3859,119,1
2723171,796652,99,95,3999,0,4098,95,1
2513691,4602801,244,195,17485,0,17729,195,1
1629019,2957752,351,2,5823,0,6174,2,1
1580988,3630271,2821,1,400133,0,402954,1,1
3322702,3402731,161,3654,731,18,892,3672,1
4628096,550028,219,18,5074,0,5293,18,1
65840,954956,268,1,3377,0,3645,1,1
663087,140537,551,54,3410,0,3961,54,1
3906136,775558,387,12,41169,0,41556,12,1
4479581,4133497,601,60,19545,0,20146,60,1
2793423,1430554,122,8,1527,0,1649,8,1
3278135,2202737,358,2,7252,0,7610,2,1
2308819,3187644,141,28,5491,0,5632,28,1
378943,66115,340,77,12563,0,12903,77,1
1575009,1500841,429,70,37745,0,38174,70,1
932720,3267896,1411,5,111323,0,112734,5,1
1580988,1362827,2821,3,400133,0,402954,3,1
3540105,2588164,83,2,4179,0,4262,2,1
3280389,186158,1101,2,411419,0,412520,2,1
2261139,3657421,2014,2,42851,0,44865,2,1
2950311,4269440,807,51,85116,0,85923,51,1
1103332,2308950,732,52,59415,0,60147,52,1
2261139,2226137,2014,1,42851,0,44865,1,1
1618616,3441058,931,20,5417,0,6348,20,1
3734245,1970044,915,1,34965,0,35880,1,1
4416945,3447155,417,30,33228,0,33645,30,1
2897926,708357,565,47,25983,0,26548,47,1
1968010,2391711,786,11,10371,0,11157,11,1
4538456,3295802,94,21,2432,0,2526,21,1
2042442,3728704,90,33,267,0,357,33,1
2096696,399248,153,59,1322,0,1475,59,1
2339149,1910515,97,88,4258,0,4355,88,1
835933,490825,4,138,115,0,119,138,1
1988347,515290,205,285,3660,34080,3865,34365,1
1225988,1397554,157,277,8881,0,9038,277,1
2260014,787617,2466,2,98622,0,101088,2,1
4416945,1040296,417,2,33228,0,33645,2,1
3280389,106773,1101,1,411419,0,412520,1,1
3395938,3323433,546,1,39878,0,40424,1,1
4492248,8315,237,30,17127,0,17364,30,1
3734245,362618,915,2,34965,0,35880,2,1
2161375,3043647,52,4,2492,0,2544,4,1
2145181,1443078,114,235,1746,0,1860,235,1
3088808,707791,227,5,7820,0,8047,5,1
3509903,4721707,1530,1,509445,0,510975,1,1
1015986,3756779,604,426,14201,0,14805,426,1
3460849,43937,216,410,2518,0,2734,410,1
1015986,3117116,604,450,14201,0,14805,450,1
2057864,1343833,307,621,3995,0,4302,621,1
1103332,3531882,732,100,59415,0,60147,100,1
1355114,1028954,47,4,2747,0,2794,4,1
2887240,1669862,1143,181,118405,0,119548,181,1
2498087,1340168,1630,39,32582,0,34212,39,1
2514271,508447,387,74,19070,0,19457,74,1
709709,2883375,166,107,1358,0,1524,107,1
3611989,2505555,200,249,1156,0,1356,249,1
2041134,521497,477,4,4284,0,4761,4,1
2343253,3615117,1882,4,86401,0,88283,4,1
2961552,849352,562,20,16546,0,17108,20,1
2778813,125690,111,84,4665,0,4776,84,1
813554,1394937,252,2,17214,0,17466,2,1
3104095,266167,16,8,742,0,758,8,1
1503116,4005940,415,74,37079,0,37494,74,1
2887240,4164038,1143,2,118405,0,119548,2,1
2062595,2666671,147,80,176,0,323,80,1
1927211,1744599,1668,59,113322,0,114990,59,1
3638272,4122292,2022,81,370904,0,372926,81,1
1831911,920153,116,32,217,276,333,308,1
4656285,1593093,1446,1,35428,0,36874,1,1
4816740,1483645,141,335,7750,0,7891,335,1
3836080,2607858,1197,30,59457,0,60654,30,1
2147720,4858582,1608,5,78786,0,80394,5,1
4648695,4148339,145,69,625,0,770,69,1
2492402,3031503,336,180,1778,284,2114,464,1
4801471,547513,585,7,17979,0,18564,7,1
3561502,277842,1144,38,68800,0,69944,38,1
2263130,3814616,712,77,14043,0,14755,77,1
4381750,4627371,798,142,153,59,951,201,1
4560313,2785512,284,35,4566,0,4850,35,1
4738916,624671,1165,35,34124,0,35289,35,1
1331940,584640,802,33,32617,0,33419,33,1
1580988,2413874,2821,1,400133,0,402954,1,1
1053923,4345245,490,3,4567,0,5057,3,1
3891414,4715327,175,28,1655,0,1830,28,1
3361377,4683591,4841,1,761793,0,766634,1,1
53878,3010205,284,40,2344,0,2628,40,1
2986491,4406669,109,101,53,0,162,101,1
3769160,1920729,156,86,1054,0,1210,86,1
2457029,2202783,77,2,10427,0,10504,2,1
3396719,777547,660,5,8141,0,8801,5,1
1539837,2695548,1127,47,62979,0,64106,47,1
4843360,3422060,355,11,7866,0,8221,11,1
370119,1446974,42,18,1057,0,1099,18,1
1580988,1380096,2821,2,400133,0,402954,2,1
1276425,3175555,102,2,8318,0,8420,2,1
3638272,3537525,2022,1,370904,0,372926,1,1
1913445,1749510,564,174,47943,0,48507,174,1
427805,1672866,483,1,156906,0,157389,1,1
1431189,3719171,167,56,3075,0,3242,56,1
4642569,3292847,872,49,27586,0,28458,49,1
3886121,4208653,220,1820,175,21104,395,22924,1
1633022,1733652,246,1,23530,0,23776,1,1
1445445,2268352,62,7,32,0,94,7,1
474172,855372,471,95,38713,0,39184,95,1
3206499,2555055,1337,19,32033,0,33370,19,1
4479581,2637172,601,166,19545,0,20146,166,1
2307868,1622092,1131,46,38777,0,39908,46,1
3673348,3753588,26,2,562,0,588,2,1
4517347,3092647,205,167,1430,0,1635,167,1
4295952,3041339,808,50,57369,0,58177,50,1
3684505,2242860,358,691,1344,0,1702,691,1
3671141,3025959,1444,8,48400,0,49844,8,1
1603899,1614841,497,207,5551,0,6048,207,1
1880135,547241,810,52,71924,0,72734,52,1
2569009,4502842,424,201,13423,0,13847,201,1
1386493,1189433,111,44,1396,0,1507,44,1
439557,3250733,2090,4,61744,0,63834,4,1
1588330,766264,694,46,10280,0,10974,46,1
873241,4355015,616,2,22633,0,23249,2,1
151693,2892595,436,135,12181,0,12617,135,1
1880135,3507550,810,119,71924,0,72734,119,1
309382,2243858,135,3,4536,0,4671,3,1
427805,3753093,483,1,156906,0,157389,1,1
4360960,4310452,1642,4,110084,0,111726,4,1
474172,2498181,471,41,38713,0,39184,41,1
24397,361290,4,1,31,0,35,1,1
37351,2498087,84,1630,1376,32582,1460,34212,1
3361377,1307107,4841,26,761793,0,766634,26,1
1325245,939714,144,3,5103,0,5247,3,1
151693,3287895,436,83,12181,0,12617,83,1
1539837,3293806,1127,33,62979,0,64106,33,1
4417253,2858234,1130,78,68389,0,69519,78,1
3842148,3406644,719,14,11430,0,12149,14,1
2727964,3240247,17,62,220,0,237,62,1
1618616,2206273,931,235,5417,4892,6348,5127,1
3509903,379711,1530,3,509445,0,510975,3,1
3361377,1024525,4841,5,761793,0,766634,5,1
3140664,3362191,268,212,16099,0,16367,212,1
3742930,512317,410,36,22242,0,22652,36,1
3361377,3989744,4841,3,761793,0,766634,3,1
354904,572746,3193,448,105780,0,108973,448,1
4680700,47019,53,1,232,0,285,1,1
2772113,3321244,792,183,42907,0,43699,183,1
842398,1279597,115,96,2280,0,2395,96,1
3402545,2265212,253,41,2083,0,2336,41,1
1428477,4160370,255,21,15459,0,15714,21,1
917130,2802662,325,24,7017,765,7342,789,1
4504242,3698126,274,30,746,0,1020,30,1
4727207,1003981,925,5,84581,0,85506,5,1
259575,1178382,260,27,13949,0,14209,27,1
1348342,625614,241,215,1456,0,1697,215,1
4423184,2519696,384,1,29809,0,30193,1,1
3561502,2396011,1144,66,68800,0,69944,66,1
4011264,1224268,1360,1,116777,0,118137,1,1
978341,4103612,604,932,10065,5655,10669,6587,1
129567,608047,65,53,932,0,997,53,1
1878924,237076,85,2,2012,0,2097,2,1
2477256,2809725,1124,68,7025,0,8149,68,1
862958,4694030,87,250,4203,0,4290,250,1
4140279,183949,337,2,49384,0,49721,2,1
3137585,4372669,1196,39,77354,0,78550,39,1
765601,1645263,1485,84,101510,0,102995,84,1
3527581,2320866,13,51,385,0,398,51,1
2650412,245543,931,2,29038,0,29969,2,1
4110535,4157628,395,66,7311,0,7706,66,1
4411870,982265,948,115,60517,0,61465,115,1
2480357,2654333,8,1381,22,0,30,1381,1
4649206,4602506,566,119,31367,0,31933,119,1
2887240,54258,1143,6,118405,0,119548,6,1
3144238,4224722,326,11,28455,0,28781,11,1
635909,2431902,179,34,6949,0,7128,34,1
820476,133392,113,413,822,19,935,432,1
996752,1735410,173,55,3538,0,3711,55,1
4853234,152496,1256,2,29554,0,30810,2,1
4219479,1709688,158,15,4945,0,5103,15,1
3214323,2254479,147,26,12543,0,12690,26,1
3683235,302301,311,173,23110,0,23421,173,1
4417253,3727596,1130,22,68389,0,69519,22,1
1961226,4399994,33,36,2215,0,2248,36,1
3638272,460607,2022,1,370904,0,372926,1,1
861181,1603093,45,10,166,0,211,10,1
561807,1436216,144,1068,646,68770,790,69838,1
1880135,3776935,810,4,71924,0,72734,4,1
490652,2143402,20,7,91,0,111,7,1
1937293,3753801,434,6,16761,0,17195,6,1
1653268,833433,183,25,5919,0,6102,25,1
3509903,442235,1530,9,509445,0,510975,9,1
3361377,2993010,4841,1,761793,0,766634,1,1
441667,1587548,198,1,14727,0,14925,1,1
1903691,473688,112,120,1593,0,1705,120,1
3435785,2506899,220,79,1519,0,1739,79,1
1392958,3309062,91,19,241,155,332,174,1
24443,3820494,7,16,288,0,295,16,1
4689808,4647648,280,50,14220,0,14500,50,1
4653941,43834,951,132,45883,731,46834,863,1
3992144,3100425,402,5,23683,0,24085,5,1
2101710,3207080,152,92,6934,0,7086,92,1
4827056,3383423,226,4,12578,0,12804,4,1
1100354,4486130,163,231,24439,0,24602,231,1
1658293,4317112,151,29,1188,0,1339,29,1
3764283,3440503,254,55,2011,292,2265,347,1
2763282,385416,321,16,10936,0,11257,16,1
3765475,4428750,873,1,107914,0,108787,1,1
2043564,414280,48,83,1491,0,1539,83,1
2763282,844625,321,121,10936,248,11257,369,1
2893334,2121356,889,24,30148,0,31037,24,1
427805,4033941,483,2,156906,0,157389,2,1
3549674,1823629,602,103,38542,0,39144,103,1
837553,2504597,1249,3,61665,0,62914,3,1
1526503,2098542,29,118,999,0,1028,118,1
262893,3616908,161,58,3792,0,3953,58,1
688902,2662409,161,14,964,0,1125,14,1
544230,3673239,1532,45,60768,0,62300,45,1
4055608,581535,126,1283,1936,8414,2062,9697,1
735870,4467395,120,2084,342,14574,462,16658,1
2627841,3738666,418,21,12342,0,12760,21,1
3454057,1779486,216,211,2404,1444,2620,1655,1
3708922,1527848,42,12,1414,0,1456,12,1
1310800,2133521,200,6,6100,0,6300,6,1
655339,1739031,93,85,1136,453,1229,538,1
4219266,3652313,85,6,3252,0,3337,6,1
1100354,1153397,163,2,24439,0,24602,2,1
1503116,1491147,415,19,37079,0,37494,19,1
2348093,1407714,335,112,12064,0,12399,112,1
687713,350563,436,1,47160,0,47596,1,1
1601507,960638,129,1,6006,0,6135,1,1
2307868,1612003,1131,11,38777,0,39908,11,1
4011264,1702633,1360,91,116777,0,118137,91,1
3593666,2633796,451,86,530,149,981,235,1
3676295,744589,374,1,70881,0,71255,1,1
1063358,2534682,1350,38,63494,0,64844,38,1
817090,3918257,188,43,4245,0,4433,43,1
2962038,3229567,495,22,14236,0,14731,22,1
4592021,3228098,299,70,1376,0,1675,70,1
1234540,1638624,1071,45,75251,0,76322,45,1
3438576,2793654,3424,4,137753,0,141177,4,1
1580988,1664941,2821,1,400133,0,402954,1,1
2886330,2465660,415,270,10154,0,10569,270,1
2147720,4400839,1608,366,78786,0,80394,366,1
4417253,675212,1130,48,68389,0,69519,48,1
2281149,1512686,282,73,28082,0,28364,73,1
4705188,2384724,336,172,8658,0,8994,172,1
3638272,2954147,2022,1,370904,0,372926,1,1
2694878,1846534,29,4,84,0,113,4,1
3438576,3098056,3424,1,137753,0,141177,1,1
4587866,727768,507,94,2074,0,2581,94,1
2069566,1308081,29,39,266,0,295,39,1
3758692,1132440,711,65,34731,0,35442,65,1
3567246,1358253,192,90,3712,0,3904,90,1
2827436,4482348,882,2,271525,0,272407,2,1
4619326,4716185,539,214,22721,0,23260,214,1
1234540,736152,1071,28,75251,0,76322,28,1
3509903,2575553,1530,3,509445,0,510975,3,1
3438576,2918306,3424,19,137753,0,141177,19,1
1325245,2396996,144,110,5103,0,5247,110,1
4494198,142653,217,8,176,0,393,8,1
4678614,3033473,452,29,16881,0,17333,29,1
3021639,788913,81,56,1475,0,1556,56,1
2957859,214733,190,76,4518,0,4708,76,1
4782707,4381875,513,1,31665,0,32178,1,1
948768,2918459,587,36,14768,0,15355,36,1
4228716,2734392,43,5,193,0,236,5,1
3650069,2270624,217,36,4118,0,4335,36,1
2075015,4181843,2664,14,85781,0,88445,14,1
4062175,2151732,248,106,8522,0,8770,106,1
3361377,3140434,4841,2,761793,0,766634,2,1
1763353,4545732,126,3,10072,0,10198,3,1
4485028,1522476,445,53,14565,0,15010,53,1
3280389,2215539,1101,1,411419,0,412520,1,1
4238001,270589,869,6,61161,0,62030,6,1
4220190,4470226,320,5,15994,0,16314,5,1
3361377,3546115,4841,5,761793,0,766634,5,1
2350095,2444304,146,259,3040,0,3186,259,1
3387987,540410,268,22,19035,0,19303,22,1
2524671,805360,140,1514,7015,119306,7155,120820,1
873241,3401710,616,245,22633,0,23249,245,1
3638272,4756159,2022,3,370904,0,372926,3,1
3394238,17924,103,68,293,0,396,68,1
257573,3442202,217,13,1011,0,1228,13,1
3235479,3574944,999,45,66486,0,67485,45,1
690346,4500930,236,2,1994,0,2230,2,1
724436,4713391,217,387,2547,0,2764,387,1
2147720,3411198,1608,61,78786,0,80394,61,1
1875,3315337,656,15,61388,0,62044,15,1
4604311,648893,29,2,7472,0,7501,2,1
3383252,1822026,281,237,3966,0,4247,237,1
1789430,3066710,224,46,3666,0,3890,46,1
1041449,1761245,329,205,3645,0,3974,205,1
4525011,4614673,172,12,6076,0,6248,12,1
3721550,650829,188,3,14527,0,14715,3,1
3941858,4090097,202,2,5760,0,5962,2,1
679692,1436562,111,694,240,124,351,818,1
1148590,3575493,37,4,163,0,200,4,1
2529661,803409,493,110,27309,0,27802,110,1
2718230,4430503,417,25,2462,0,2879,25,1
3671141,1715114,1444,6,48400,0,49844,6,1
521586,447471,782,3,18489,0,19271,3,1
1794526,420221,169,163,1730,0,1899,163,1
3753643,198120,247,21,2001,0,2248,21,1
4365938,2282306,250,36,10362,0,10612,36,1
4030529,1920737,299,15,3324,0,3623,15,1
3214893,2533528,1087,60,6553,0,7640,60,1
2568449,3679850,113,49,1349,0,1462,49,1
4111167,1886970,22,76,46,81,68,157,1
4461720,4592122,45,1748,129,8,174,1756,1
3361377,531274,4841,1,761793,0,766634,1,1
1927211,1272594,1668,13,113322,0,114990,13,1
4547438,1090756,1291,241,25237,0,26528,241,1
4191727,402627,463,39,26315,0,26778,39,1
1436216,1008577,1068,1,68770,0,69838,1,1
805360,219999,1514,36,119306,0,120820,36,1
1020925,3956360,204,51,3339,0,3543,51,1
4304056,2553307,164,4,12698,0,12862,4,1
2950311,973916,807,348,85116,0,85923,348,1
572390,1000512,91,30,3173,0,3264,30,1
2368306,4372543,124,75,1441,0,1565,75,1
1360946,2178827,224,140,2556,0,2780,140,1
4656679,3929964,98,48,1326,0,1424,48,1
3206499,1919296,1337,3,32033,0,33370,3,1
3638272,4218740,2022,2,370904,0,372926,2,1
2637259,1688471,151,37,3592,0,3743,37,1
1339376,1590888,154,420,1586,0,1740,420,1
3683235,544340,311,47,23110,0,23421,47,1
599880,1279417,305,166,567,776,872,942,1
2120140,3942751,453,138,6305,0,6758,138,1
3638272,4852639,2022,1,370904,0,372926,1,1
1236887,3539185,73,1145,705,69,778,1214,1
832820,2600118,73,39,773,0,846,39,1
1628302,2296819,11,3,4819,0,4830,3,1
2591791,3729585,8,16,171,0,179,16,1
4226583,3554339,56,342,300,559,356,901,1
3419989,2228219,350,14,16316,0,16666,14,1
3802719,2461202,91,242,3170,0,3261,242,1
4191410,1585655,1590,87,96434,0,98024,87,1
3488762,1469558,145,83,4916,0,5061,83,1
4302921,4273352,509,14,13289,0,13798,14,1
3509903,2941152,1530,1,509445,0,510975,1,1
2516076,352992,1455,49,77782,0,79237,49,1
3911706,2150442,11,571,221,0,232,571,1
755739,1415515,1117,69,58043,0,59160,69,1
1243368,4250573,319,3,5045,0,5364,3,1
441734,235707,271,12,3594,0,3865,12,1
6618,1396237,892,12,68849,0,69741,12,1
917130,247958,325,868,7017,0,7342,868,1
1875,97979,656,1,61388,0,62044,1,1
2159244,1204025,102,63,1434,0,1536,63,1
3361377,3562144,4841,1,761793,0,766634,1,1
3638272,4774934,2022,6,370904,0,372926,6,1
3280389,514105,1101,1,411419,0,412520,1,1
2514271,2954186,387,9,19070,0,19457,9,1
3638272,3796245,2022,1,370904,0,372926,1,1
2662654,2901315,224,299,1542,0,1766,299,1
3959546,4195052,233,145,2002,0,2235,145,1
3676295,927073,374,1,70881,0,71255,1,1
1527543,1641503,22,1,170,0,192,1,1
2611384,677947,168,4,550,0,718,4,1
3872736,446519,258,191,12660,0,12918,191,1
2985909,835444,706,48,43348,0,44054,48,1
4060234,1593390,69,4,1200,0,1269,4,1
4458957,3963176,58,56,424,687,482,743,1
2778168,2392694,65,47,1464,0,1529,47,1
1847461,3072218,1211,102,51149,0,52360,102,1
4519069,785180,387,17,20799,0,21186,17,1
817110,925653,138,14,1927,0,2065,14,1
1633100,1584658,163,90,8737,0,8900,90,1
1234540,3059803,1071,62,75251,0,76322,62,1
2021745,4378785,72,7,2948,0,3020,7,1
2891499,2193688,56,4,62,0,118,4,1
957197,3949028,614,6,37109,0,37723,6,1
1875,3929471,656,49,61388,0,62044,49,1
2482338,4718982,712,21,24222,0,24934,21,1
2981537,1235032,1252,4,118718,0,119970,4,1
2347608,781608,138,49,1313,0,1451,49,1
3673348,913812,26,41,562,0,588,41,1
21944,3288600,317,36,9419,0,9736,36,1
4642569,3172503,872,197,27586,0,28458,197,1
3419989,1061972,350,58,16316,0,16666,58,1
4555638,2404911,181,20,397,0,578,20,1
3280389,817310,1101,1,411419,0,412520,1,1
2985909,4310782,706,17,43348,0,44054,17,1
1580988,4653366,2821,13,400133,0,402954,13,1
3671141,3212600,1444,29,48400,0,49844,29,1
3443229,4047607,152,46,1959,0,2111,46,1
1146349,3813515,44,39,854,0,898,39,1
2261139,4257790,2014,24,42851,0,44865,24,1
3672238,4483879,518,119,12172,0,12690,119,1
3296364,1670450,51,33,466,0,517,33,1
3361377,3717816,4841,1,761793,0,766634,1,1
3846489,4584508,16,1,283,0,299,1,1
6618,90531,892,56,68849,0,69741,56,1
3361377,2573926,4841,9,761793,0,766634,9,1
3650366,2549432,263,413,578,269,841,682,1
670587,1148578,651,246,9779,2567,10430,2813,1
1436216,2058827,1068,5,68770,0,69838,5,1
3509903,1353983,1530,1,509445,0,510975,1,1
490279,4836669,73,137,639,0,712,137,1
2199247,3612612,61,1,1954,0,2015,1,1
2870700,1497278,25,1869,108,35111,133,36980,1
2886330,2624387,415,101,10154,0,10569,101,1
3361377,3142033,4841,1,761793,0,766634,1,1
593740,266350,1107,65,62807,0,63914,65,1
3844106,825543,25,6,843,0,868,6,1
1301815,2384418,752,53,48944,0,49696,53,1
3758692,190584,711,187,34731,0,35442,187,1
3638272,3800619,2022,8,370904,0,372926,8,1
4582129,3267063,1231,416,10356,0,11587,416,1
1250021,3393479,4637,6,85913,0,90550,6,1
4198771,655725,207,731,8543,0,8750,731,1
4838376,3603391,606,344,26838,0,27444,344,1
1153522,625824,78,54,911,0,989,54,1
2405789,3894726,1010,39,93387,0,94397,39,1
3774580,114810,256,5,3916,0,4172,5,1
2821864,2012684,3,1,87,0,90,1,1
1092203,3790218,174,9,1996,0,2170,9,1
4408813,327790,288,7,10077,0,10365,7,1
1234540,3912491,1071,14,75251,0,76322,14,1
1633100,226325,163,4,8737,0,8900,4,1
1559887,754867,49,20,664,0,713,20,1
3235479,4853779,999,125,66486,0,67485,125,1
2961801,3123193,1483,15,101962,0,103445,15,1
593740,3316576,1107,669,62807,7971,63914,8640,1
563421,2839022,95,293,588,237,683,530,1
1331940,4595528,802,50,32617,0,33419,50,1
4503643,2424118,8,128,715,0,723,128,1
1936447,2527176,167,171,2268,0,2435,171,1
3873117,2936702,51,90,377,0,428,90,1
2613814,2519290,242,200,1818,0,2060,200,1
3948751,4783432,53,111,380,0,433,111,1
3873768,3082288,449,20,35424,0,35873,20,1
4823937,285343,97,4,238,0,335,4,1
1870921,3443970,182,13,8739,0,8921,13,1
4815919,3602582,367,15,3361,0,3728,15,1
932720,1815250,1411,22,111323,0,112734,22,1
2097258,1500679,34,12,247,0,281,12,1
1317294,3834192,89,2,7800,0,7889,2,1
2473458,3936935,52,13,281,0,333,13,1
2355092,3144238,30,326,2544,28455,2574,28781,1
354904,3353815,3193,151,105780,0,108973,151,1
4360960,2238542,1642,14,110084,0,111726,14,1
2077019,644286,38,4,1764,0,1802,4,1
1161189,3296392,112,64,3964,0,4076,64,1
4642569,3767159,872,122,27586,0,28458,122,1
3910135,4098989,298,58,14348,0,14646,58,1
4423184,1493587,384,68,29809,0,30193,68,1
4521434,2822865,101,316,1016,1330,1117,1646,1
1250021,2065892,4637,110,85913,0,90550,110,1
1241907,4799966,176,557,1602,4819,1778,5376,1
4374509,1883744,770,81,9940,0,10710,81,1
151693,654037,436,30,12181,0,12617,30,1
4319972,4778272,640,1,35279,0,35919,1,1
1195811,3612220,89,230,1995,0,2084,230,1
2881894,3999004,211,163,7468,0,7679,163,1
3649398,3529985,6,1,1493,0,1499,1,1
3361377,3766362,4841,1,761793,0,766634,1,1
3361377,837875,4841,3,761793,0,766634,3,1
3235479,28293,999,39,66486,0,67485,39,1
752618,4737889,169,2,5929,0,6098,2,1
2307868,3374332,1131,27,38777,0,39908,27,1
2617350,2466055,256,79,6547,0,6803,79,1
1162971,611426,18,236,41,197,59,433,1
2343253,2312140,1882,5,86401,0,88283,5,1
948128,2728624,142,77,2383,0,2525,77,1
932720,3588000,1411,29,111323,0,112734,29,1
4727207,4499365,925,7,84581,0,85506,7,1
3844858,519519,1591,179,28974,0,30565,179,1
2755798,4792638,494,3,24862,0,25356,3,1
4447911,2782495,38,17,474,0,512,17,1
2362241,3799162,324,46,7732,0,8056,46,1
4191410,1449819,1590,39,96434,0,98024,39,1
4301309,19840,323,270,4103,0,4426,270,1
781211,3737652,976,54,51781,0,52757,54,1
1599578,4363253,142,48,1074,0,1216,48,1
427805,2626896,483,1,156906,0,157389,1,1
2516076,664218,1455,220,77782,0,79237,220,1
408965,4381368,903,68,38623,0,39526,68,1
427805,4116256,483,1,156906,0,157389,1,1
3280389,2126245,1101,1,411419,0,412520,1,1
3361377,2134334,4841,2,761793,0,766634,2,1
453639,2641502,51,1,305,0,356,1,1
4760625,2960401,77,11,284,0,361,11,1
2677334,819524,377,5,6774,0,7151,5,1
3509903,1252754,1530,1,509445,0,510975,1,1
2261139,2604700,2014,111,42851,0,44865,111,1
3491692,4326763,76,3,1361,0,1437,3,1
4801471,3414524,585,3,17979,0,18564,3,1
1580988,1790855,2821,45,400133,0,402954,45,1
781211,2045972,976,65,51781,0,52757,65,1
161276,2274863,146,4,6548,0,6694,4,1
370123,2113516,110,119,7231,0,7341,119,1
3361377,2499260,4841,1,761793,0,766634,1,1
2751572,1854055,481,81,44036,0,44517,81,1
4330391,4163350,773,11,32759,0,33532,11,1
4528103,924047,268,70,14258,0,14526,70,1
3638272,3118613,2022,2,370904,0,372926,2,1
3423256,736329,289,9,2138,0,2427,9,1
3587014,4501740,215,15,1983,0,2198,15,1
2342664,1251534,1181,33,26502,0,27683,33,1
2572875,4572980,20,2,447,0,467,2,1
983843,3903781,225,36,779,100,1004,136,1
1839283,3484307,765,18,36658,0,37423,18,1
3960049,358512,140,11,2418,0,2558,11,1
813554,2231322,252,114,17214,0,17466,114,1
3361377,2550720,4841,1,761793,0,766634,1,1
3638272,4765820,2022,1,370904,0,372926,1,1
3638272,2117121,2022,6,370904,0,372926,6,1
681618,3758978,75,84,8789,0,8864,84,1
3936039,1005072,799,124,23884,0,24683,124,1
3610598,1861070,380,52,17343,0,17723,52,1
2989110,4004596,1042,137,19283,0,20325,137,1
3545951,68407,64,31,203,0,267,31,1
3280389,2939778,1101,1,411419,0,412520,1,1
933662,3151177,29,2,506,0,535,2,1
3235479,1089710,999,35,66486,0,67485,35,1
1350290,2633279,49,39,1273,35,1322,74,1
1483094,2918691,146,73,3104,0,3250,73,1
380817,294965,32,2,1035,0,1067,2,1
3509903,753838,1530,4,509445,0,510975,4,1
3280389,3326160,1101,3,411419,0,412520,3,1
4230790,1665787,15,4,135,0,150,4,1
3232793,3525020,13,106,335,0,348,106,1
3910135,3861294,298,48,14348,0,14646,48,1
680015,146139,485,88,9502,0,9987,88,1
4451122,4003072,985,31,41669,0,42654,31,1
2021745,3017047,72,331,2948,0,3020,331,1
657387,4314189,47,18,2455,0,2502,18,1
3284020,652291,111,282,2181,0,2292,282,1
1999600,600502,27,183,343,0,370,183,1
1326965,3437795,158,82,567,0,725,82,1
3758692,1534242,711,64,34731,0,35442,64,1
1887709,4424717,217,39,28983,0,29200,39,1
976723,977262,173,133,564,57,737,190,1
1847461,216862,1211,35,51149,0,52360,35,1
3361377,3373426,4841,10,761793,0,766634,10,1
4689808,3164186,280,4,14220,0,14500,4,1
259575,981634,260,43,13949,0,14209,43,1
2654633,2721457,151,5,2699,0,2850,5,1
4272102,129121,1608,52,104171,0,105779,52,1
2109216,3239954,386,241,4712,0,5098,241,1
4496752,141139,554,121,16258,0,16812,121,1
1213040,4088842,39,9,716,0,755,9,1
370041,2936883,254,38,2962,0,3216,38,1
2713411,325893,384,27,4637,0,5021,27,1
3672238,3696854,518,191,12172,0,12690,191,1
2755798,3834603,494,2,24862,0,25356,2,1
3137585,534410,1196,31,77354,0,78550,31,1
439557,3237205,2090,1,61744,0,63834,1,1
4011264,1588137,1360,59,116777,0,118137,59,1
2147720,2199816,1608,86,78786,0,80394,86,1
1103194,1197936,18,1,193,0,211,1,1
3140664,874592,268,199,16099,0,16367,199,1
3765475,1643650,873,1,107914,0,108787,1,1
2981537,3541568,1252,2,118718,0,119970,2,1
3531730,1498917,334,86,9763,0,10097,86,1
2897926,317447,565,13,25983,0,26548,13,1
4411870,3019003,948,26,60517,0,61465,26,1
3765475,897637,873,6,107914,0,108787,6,1
652054,2962391,102,2532,351,241,453,2773,1
805360,2700764,1514,78,119306,0,120820,78,1
4651182,246812,208,32,982,0,1190,32,1
2887785,4295097,197,2,1039,0,1236,2,1
2751572,1543664,481,107,44036,0,44517,107,1
3914135,1825140,2152,36,60084,0,62236,36,1
2102496,4785112,64,84,1022,79,1086,163,1
4219479,3971642,158,167,4945,0,5103,167,1
1633022,1225364,246,1,23530,0,23776,1,1
878715,4295875,100,14,1976,0,2076,14,1
6618,505583,892,8,68849,0,69741,8,1
627727,1816517,56,36,2488,0,2544,36,1
3481139,2492065,168,5,829,0,997,5,1
2961552,3651261,562,72,16546,0,17108,72,1
2050190,553668,153,31,9156,0,9309,31,1
370130,1780668,30,14,1621,0,1651,14,1
4642569,4252281,872,13,27586,0,28458,13,1
572112,744214,15,22,142,0,157,22,1
4798192,206327,816,7,20426,0,21242,7,1
3361377,2045103,4841,1,761793,0,766634,1,1
1600857,1190277,324,1,10576,0,10900,1,1
4187354,2260170,61,3,2628,0,2689,3,1
792037,749730,57,2,16445,0,16502,2,1
3509903,2154197,1530,4,509445,0,510975,4,1
3773737,701221,108,23,2435,0,2543,23,1
1100354,4461992,163,4,24439,0,24602,4,1
2818749,1354054,92,65,3797,0,3889,65,1
1455058,748710,129,3,3856,0,3985,3,1
4416945,1457073,417,55,33228,0,33645,55,1
4712782,689068,171,262,4681,0,4852,262,1
2147720,3880593,1608,129,78786,0,80394,129,1
1250021,2424118,4637,128,85913,0,90550,128,1
1654099,806862,1180,60,26347,0,27527,60,1
2343253,4324388,1882,2,86401,0,88283,2,1
262893,2657284,161,2605,3792,690,3953,3295,1
445996,2319856,1175,14,12828,0,14003,14,1
3638272,3642337,2022,2,370904,0,372926,2,1
110570,3250147,68,97,891,0,959,97,1
2827436,628289,882,1,271525,0,272407,1,1
3575260,1447415,242,19,5576,0,5818,19,1
2465641,3676100,383,197,2507,1207,2890,1404,1
1787075,849682,894,70,28305,0,29199,70,1
1966548,2858830,208,1,53149,0,53357,1,1
593740,1491830,1107,52,62807,0,63914,52,1
1580988,3107647,2821,9,400133,0,402954,9,1
1521114,2411047,749,2,1909,0,2658,2,1
427805,2276132,483,1,156906,0,157389,1,1
2950311,354788,807,203,85116,5964,85923,6167,1
1684694,1575166,46,23,548,0,594,23,1
1855827,1249122,23,1,665,0,688,1,1
3410500,2285604,131,99,2172,0,2303,99,1
762144,1933390,8,2,99,0,107,2,1
3361377,3813968,4841,1,761793,0,766634,1,1
1493034,2785571,218,1,1187,0,1405,1,1
3509903,4244234,1530,1,509445,0,510975,1,1
3294702,1000243,991,113,68888,0,69879,113,1
935972,4682303,59,23,862,0,921,23,1
3875080,4481016,285,5,5153,0,5438,5,1
2445500,55928,68,2,3239,0,3307,2,1
1336304,2069314,44,325,1996,0,2040,325,1
360163,1980404,37,402,518,0,555,402,1
3835618,4152283,694,39,25433,0,26127,39,1
3935366,3743197,377,163,3803,0,4180,163,1
3294702,3933938,991,43,68888,0,69879,43,1
1950255,2829490,8,1,654,0,662,1,1
2723940,2206250,38,153,1986,4857,2024,5010,1
805360,2346859,1514,40,119306,0,120820,40,1
932720,4103118,1411,43,111323,0,112734,43,1
3361377,2220992,4841,2,761793,0,766634,2,1
3037644,4013841,71,11,2219,0,2290,11,1
2291145,1089341,221,119,3037,0,3258,119,1
3505066,4327914,131,34,3630,0,3761,34,1
4598255,737553,791,21,583,0,1374,21,1
3125762,1288227,254,68,8285,0,8539,68,1
4334842,1953951,85,11,4749,0,4834,11,1
2906370,2619393,271,7,4802,0,5073,7,1
3438576,2009095,3424,9,137753,0,141177,9,1
1615261,3128831,955,4,12715,0,13670,4,1
3501482,2811908,522,354,28046,0,28568,354,1
1270944,2391602,70,8,561,0,631,8,1
4731849,3680619,455,379,10886,0,11341,379,1
3509903,3576186,1530,1,509445,0,510975,1,1
3176559,2790582,36,1,156,0,192,1,1
1356925,2077381,248,2,6996,0,7244,2,1
1880135,3424945,810,29,71924,0,72734,29,1
3764177,879762,1036,73,64563,0,65599,73,1
4183784,1327933,931,866,59894,4229,60825,5095,1
2888974,3632538,197,146,1181,0,1378,146,1
439557,68745,2090,313,61744,0,63834,313,1
307250,1625033,919,1,35588,0,36507,1,1
1580508,2844854,720,45,19611,0,20331,45,1
196521,1258597,1176,41,11269,0,12445,41,1
3946789,675853,261,10,5606,0,5867,10,1
1211290,1917213,33,10,993,0,1026,10,1
3509903,1365781,1530,1,509445,0,510975,1,1
4183784,4413802,931,63,59894,0,60825,63,1
4423184,3355567,384,24,29809,0,30193,24,1
3638272,1042269,2022,2,370904,0,372926,2,1
1927211,4257457,1668,45,113322,0,114990,45,1
3280389,2547648,1101,6,411419,0,412520,6,1
1609659,4605198,523,101,29763,0,30286,101,1
573641,3185694,253,51,5074,0,5327,51,1
3361377,4263050,4841,1,761793,0,766634,1,1
4424178,462355,41,15,588,0,629,15,1
4411870,4728754,948,21,60517,0,61465,21,1
451191,4161224,132,54,1659,0,1791,54,1
4195490,723336,47,8,1105,0,1152,8,1
689077,1748462,263,33,1181,0,1444,33,1
4312439,529264,42,4,371,0,413,4,1
3503357,101166,3,6,211,0,214,6,1
2629053,3235636,79,2,376,0,455,2,1
4604311,2390115,29,3,7472,0,7501,3,1
3866441,484191,261,85,3655,0,3916,85,1
817090,3266818,188,154,4245,0,4433,154,1
2024753,2593077,172,298,1901,0,2073,298,1
2122741,4086113,190,17,6085,0,6275,17,1
1086912,3269027,907,7,33396,0,34303,7,1
1937293,1559626,434,11,16761,0,17195,11,1
3638272,2612793,2022,1,370904,0,372926,1,1
197541,1911785,134,493,1912,0,2046,493,1
1966548,4123709,208,2,53149,0,53357,2,1
1196844,2397459,548,36,36289,0,36837,36,1
2851109,359927,450,2,98552,0,99002,2,1
2405789,1302045,1010,42,93387,0,94397,42,1
3836080,3725735,1197,14,59457,0,60654,14,1
1880135,2449495,810,115,71924,0,72734,115,1
593740,1097989,1107,28,62807,0,63914,28,1
1580988,3382336,2821,1,400133,0,402954,1,1
3137585,2433805,1196,20,77354,0,78550,20,1
410490,4001359,70,35,300,0,370,35,1
4624595,309846,722,19,53368,0,54090,19,1
1201711,3190631,357,51,15948,0,16305,51,1
2261139,4595487,2014,64,42851,0,44865,64,1
4701417,2985680,305,2,3855,0,4160,2,1
4301252,1466607,118,192,2905,0,3023,192,1
3610598,4706988,380,2,17343,0,17723,2,1
1545035,4653941,121,951,430,45883,551,46834,1
2075015,4195326,2664,96,85781,0,88445,96,1
4440160,1340293,736,69,20522,0,21258,69,1
1015986,2197905,604,117,14201,0,14805,117,1
2535669,1739441,7,100,168,0,175,100,1
1196403,2710011,363,380,2062,997,2425,1377,1
439557,4312872,2090,140,61744,0,63834,140,1
3112136,2843715,406,82,41366,0,41772,82,1
3157597,3627227,183,27,10247,0,10430,27,1
4731849,1164842,455,80,10886,0,11341,80,1
4801471,2893017,585,77,17979,0,18564,77,1
4470637,4738916,112,1165,1224,34124,1336,35289,1
3361377,866842,4841,15,761793,0,766634,15,1
4360960,905166,1642,36,110084,0,111726,36,1
1847461,3566877,1211,624,51149,0,52360,624,1
2266398,3318939,209,10,1473,0,1682,10,1
2497238,2499003,251,16,2806,0,3057,16,1
2893334,4861516,889,60,30148,0,31037,60,1
4208653,4446071,1820,5,21104,0,22924,5,1
3638272,642760,2022,1,370904,0,372926,1,1
4209323,3946592,1630,46,89460,0,91090,46,1
4479581,4285292,601,104,19545,0,20146,104,1
4564202,2219874,97,386,1554,0,1651,386,1
3765475,3052884,873,730,107914,0,108787,730,1
2260014,1460944,2466,2,98622,0,101088,2,1
3361377,1190755,4841,3,761793,0,766634,3,1
2827436,4225849,882,21,271525,0,272407,21,1
1847461,447525,1211,3,51149,0,52360,3,1
472438,4434849,42,568,227,0,269,568,1
307250,2057527,919,3,35588,0,36507,3,1
3633019,2516768,746,1,32317,0,33063,1,1
4209323,1620067,1630,46,89460,0,91090,46,1
3361377,3803826,4841,3,761793,0,766634,3,1
873241,4314698,616,8,22633,0,23249,8,1
3638272,4342231,2022,3,370904,0,372926,3,1
1354403,1769196,43,143,131,249,174,392,1
4319972,74290,640,64,35279,0,35919,64,1
1428477,4717426,255,6,15459,0,15714,6,1
3053752,980972,4,1,52,0,56,1,1
774221,3936215,335,124,1862,0,2197,124,1
3509903,382516,1530,1,509445,0,510975,1,1
1618916,2343253,156,1882,391,86401,547,88283,1
886546,4002582,904,21,1080,0,1984,21,1
1994281,1317189,139,58,2492,0,2631,58,1
4710933,4618437,126,372,1331,743,1457,1115,1
3765475,2903942,873,70,107914,0,108787,70,1
1428477,4003799,255,38,15459,0,15714,38,1
3280389,3608180,1101,1,411419,0,412520,1,1
3280389,4541161,1101,2,411419,0,412520,2,1
3638272,2621014,2022,2,370904,0,372926,2,1
3734245,3008182,915,103,34965,0,35880,103,1
2989110,2016636,1042,50,19283,0,20325,50,1
1534362,2308676,1531,14,105859,0,107390,14,1
3361377,3277413,4841,2,761793,0,766634,2,1
4738916,3708751,1165,30,34124,0,35289,30,1
3462300,2652639,342,360,2917,967,3259,1327,1
2851109,364625,450,187,98552,0,99002,187,1
354904,3179275,3193,41,105780,0,108973,41,1
4485028,4789097,445,62,14565,0,15010,62,1
3271898,487772,227,86,2028,335,2255,421,1
3137585,4481426,1196,33,77354,0,78550,33,1
2950311,1689939,807,659,85116,0,85923,659,1
3395938,4703535,546,1,39878,0,40424,1,1
1139873,1006128,670,10,10236,0,10906,10,1
1103332,1038715,732,59,59415,0,60147,59,1
408965,1542958,903,8,38623,0,39526,8,1
3134846,1380523,69,4,5634,0,5703,4,1
4272102,2069257,1608,38,104171,0,105779,38,1
4183784,681544,931,71,59894,0,60825,71,1
4375442,4542065,95,25,1382,0,1477,25,1
1234540,1651196,1071,14,75251,0,76322,14,1
21944,4737479,317,26,9419,0,9736,26,1
2514271,651846,387,30,19070,0,19457,30,1
3134846,231231,69,1,5634,0,5703,1,1
2002256,4243233,86,14,618,0,704,14,1
3561502,2615263,1144,20,68800,0,69944,20,1
1626873,4649116,177,2,2149,0,2326,2,1
4272102,4862333,1608,79,104171,0,105779,79,1
1903752,1640316,506,38,10494,0,11000,38,1
1927211,1661416,1668,1,113322,0,114990,1,1
1497278,3387681,1869,7,35111,0,36980,7,1
4030529,356422,299,3,3324,0,3623,3,1
1086912,2460477,907,5,33396,0,34303,5,1
3003950,1950484,127,67,2904,0,3031,67,1
2147720,4128255,1608,33,78786,0,80394,33,1
805360,1777386,1514,42,119306,0,120820,42,1
868021,4071506,130,34,1045,0,1175,34,1
3361377,2865746,4841,1,761793,0,766634,1,1
1601507,4392869,129,2,6006,0,6135,2,1
276216,2414479,312,238,12600,0,12912,238,1
3605127,2866846,9,1,262,0,271,1,1
408965,189883,903,3,38623,0,39526,3,1
4599198,3097315,44,3,2081,0,2125,3,1
1652056,1886622,326,1,66845,0,67171,1,1
2827436,2567583,882,1,271525,0,272407,1,1
1641753,25593,152,1914,29,502,181,2416,1
2255478,2780038,190,4,2000,0,2190,4,1
4593330,1575850,203,60,8083,0,8286,60,1
1015986,1753217,604,296,14201,0,14805,296,1
846208,4018996,600,46,17288,0,17888,46,1
525734,372659,110,54,1011,0,1121,54,1
646587,2288658,122,69,5819,0,5941,69,1
3361377,1544969,4841,1,761793,0,766634,1,1
2148937,2207826,672,25,47361,0,48033,25,1
1580988,4145765,2821,1,400133,0,402954,1,1
4208653,4446721,1820,47,21104,0,22924,47,1
3112136,98244,406,12,41366,0,41772,12,1
576373,2645152,54,33,751,0,805,33,1
276216,1617564,312,18,12600,0,12912,18,1
4711909,2184018,440,2,2933,0,3373,2,1
4582129,103828,1231,24,10356,0,11587,24,1
3260961,3929045,288,19,7637,0,7925,19,1
62950,1298061,137,73,1590,0,1727,73,1
2650412,3596548,931,225,29038,0,29969,225,1
1601507,4225968,129,9,6006,0,6135,9,1
2593461,2459897,27,29,1262,0,1289,29,1
4496752,3421710,554,56,16258,0,16812,56,1
3910135,2518722,298,47,14348,0,14646,47,1
1839283,1646212,765,135,36658,0,37423,135,1
4043448,3614230,3,79,41,0,44,79,1
3059686,3259771,460,2,4530,0,4990,2,1
4272102,2930148,1608,207,104171,0,105779,207,1
1875,2287104,656,257,61388,0,62044,257,1
1635215,4268574,209,73,8253,0,8462,73,1
1973082,2397594,1036,72,18915,0,19951,72,1
4656285,1901451,1446,9,35428,0,36874,9,1
3280389,4073326,1101,12,411419,0,412520,12,1
3873768,2951527,449,27,35424,0,35873,27,1
1071044,1436572,180,122,5128,0,5308,122,1
4398275,3151255,197,66,844,0,1041,66,1
2985597,4789584,159,122,836,0,995,122,1
3986468,4573418,111,299,3703,0,3814,299,1
805360,737320,1514,2,119306,0,120820,2,1
957197,1538051,614,4,37109,0,37723,4,1
984091,4624271,285,2,2024,0,2309,2,1
4209323,3799972,1630,15,89460,0,91090,15,1
3361377,2791680,4841,5,761793,0,766634,5,1
2318737,3334117,260,83,738,0,998,83,1
2218124,2588924,31,34,137,0,168,34,1
2950311,586233,807,3,85116,0,85923,3,1
3497650,1726918,71,162,893,0,964,162,1
3645392,4169303,92,93,759,1967,851,2060,1
1785514,1778293,37,52,329,0,366,52,1
3742930,3627381,410,5,22242,0,22652,5,1
1436216,534712,1068,1,68770,0,69838,1,1
4319972,3357895,640,76,35279,0,35919,76,1
907654,4209826,798,168,24575,0,25373,168,1
3758735,4753953,42,49,811,0,853,49,1
3906136,1451319,387,11,41169,0,41556,11,1
687713,1775862,436,1,47160,0,47596,1,1
2147720,2624450,1608,97,78786,836,80394,933,1
2209136,3076981,620,55,33789,0,34409,55,1
2884562,2256556,10,5,1446,0,1456,5,1
2172290,2001775,41,51,217,0,258,51,1
3235479,734061,999,22,66486,0,67485,22,1
2521358,4554837,9,1,87,0,96,1,1
1000106,3456573,972,27,2608,0,3580,27,1
946157,2080022,100,1,1132,0,1232,1,1
4209323,4766109,1630,46,89460,0,91090,46,1
3051212,2928031,957,114,8349,0,9306,114,1
4437944,1747327,262,272,3324,0,3586,272,1
1926532,1722601,336,120,9127,0,9463,120,1
4011264,2520832,1360,18,116777,0,118137,18,1
838059,4435533,9,66,277,0,286,66,1
1539837,3724341,1127,46,62979,0,64106,46,1
4318206,3719809,251,82,13123,0,13374,82,1
2793437,3045227,582,36,25447,0,26029,36,1
4550900,723574,90,1515,707,0,797,1515,1
3280389,3153600,1101,2,411419,0,412520,2,1
439557,644870,2090,2,61744,0,63834,2,1
3280389,2564109,1101,1,411419,0,412520,1,1
755739,2961148,1117,133,58043,0,59160,133,1
4864079,516411,78,85,218,42,296,127,1
877158,2664919,34,44,986,0,1020,44,1
2536245,755115,104,6,1334,0,1438,6,1
1494665,2704748,668,6,37638,0,38306,6,1
1040877,4274557,51,4,478,0,529,4,1
2021745,3037016,72,61,2948,0,3020,61,1
4583901,3731287,137,10,425,0,562,10,1
3088808,3421899,227,143,7820,0,8047,143,1
932720,4362544,1411,35,111323,0,112734,35,1
1580988,1121342,2821,1,400133,0,402954,1,1
3361377,685125,4841,19,761793,0,766634,19,1
1206697,3471655,685,34,5595,0,6280,34,1
3509903,624023,1530,5,509445,0,510975,5,1
792037,3496875,57,2,16445,0,16502,2,1
1436216,589614,1068,2,68770,0,69838,2,1
3438576,1032573,3424,33,137753,0,141177,33,1
1580988,4011006,2821,45,400133,0,402954,45,1
2542968,2632551,444,12,4728,0,5172,12,1
1580988,22580,2821,3,400133,0,402954,3,1
2950311,4769528,807,469,85116,0,85923,469,1
1787075,1944295,894,39,28305,0,29199,39,1
532681,3169355,433,1,35023,0,35456,1,1
4272102,1079534,1608,1,104171,0,105779,1,1
765601,1631356,1485,90,101510,0,102995,90,1
584906,4058590,253,140,6639,0,6892,140,1
3280389,3366552,1101,1,411419,0,412520,1,1
4423184,1215258,384,1,29809,0,30193,1,1
3280389,1052867,1101,1,411419,0,412520,1,1
4547438,3251202,1291,169,25237,0,26528,169,1
3561502,941835,1144,25,68800,0,69944,25,1
1163180,1974208,606,21,5885,0,6491,21,1
1580988,3663409,2821,4,400133,0,402954,4,1
3871554,2478946,947,3,16042,0,16989,3,1
2950311,4485832,807,105,85116,0,85923,105,1
1966548,2576526,208,2,53149,0,53357,2,1
859585,2074571,33,10,881,0,914,10,1
4411870,435110,948,58,60517,0,61465,58,1
4110535,1214870,395,128,7311,0,7706,128,1
3638272,1868204,2022,1,370904,0,372926,1,1
4011264,559400,1360,61,116777,0,118137,61,1
1505328,332651,76,4,795,0,871,4,1
4528103,241454,268,313,14258,0,14526,313,1
932720,309881,1411,83,111323,0,112734,83,1
3361377,3988493,4841,1,761793,0,766634,1,1
2375269,2886403,384,61,2509,0,2893,61,1
6618,1049767,892,1,68849,0,69741,1,1
3225310,2751572,320,481,10537,44036,10857,44517,1
4624595,2929369,722,2,53368,0,54090,2,1
2827436,701544,882,1,271525,0,272407,1,1
3088807,4850742,283,210,1824,0,2107,210,1
4319972,1906972,640,51,35279,0,35919,51,1
1341140,4431131,77,2,532,0,609,2,1
1548012,1804123,73,2,1957,0,2030,2,1
2732741,2433051,200,192,632,17,832,209,1
1533314,1008046,361,75,6007,0,6368,75,1
805360,2664009,1514,63,119306,0,120820,63,1
3438576,2671514,3424,112,137753,0,141177,112,1
60980,3803724,649,1,20708,0,21357,1,1
1580988,2775875,2821,2,400133,0,402954,2,1
1847461,4488629,1211,285,51149,0,52360,285,1
1536341,1921843,53,1,1995,0,2048,1,1
326686,4383778,49,31,772,963,821,994,1
4013601,1043410,653,72,14886,0,15539,72,1
3873128,843178,96,15,3581,0,3677,15,1
3280389,471737,1101,1,411419,0,412520,1,1
3950811,3206198,13,24,173,0,186,24,1
4301309,3568711,323,6,4103,0,4426,6,1
1445377,4233625,95,1,2001,0,2096,1,1
2793437,3076662,582,25,25447,0,26029,25,1
1887669,165647,733,227,23145,0,23878,227,1
354904,4564828,3193,2,105780,0,108973,2,1
1512714,193377,253,36,6663,0,6916,36,1
4755384,2713118,27,60,83,71,110,131,1
595757,2966025,340,11,26738,0,27078,11,1
709509,1203859,359,17,2719,0,3078,17,1
4418909,2815089,266,5,2172,0,2438,5,1
3765475,3181042,873,3,107914,0,108787,3,1
4451122,929046,985,85,41669,0,42654,85,1
4751453,764653,520,109,27570,0,28090,109,1
3070454,515520,54,38,440,0,494,38,1
2498087,3774580,1630,256,32582,3916,34212,4172,1
1898822,427028,114,47,3885,0,3999,47,1
3946789,3622048,261,1,5606,0,5867,1,1
1234540,3704437,1071,2,75251,0,76322,2,1
4727207,2159744,925,4,84581,0,85506,4,1
4360960,1429630,1642,80,110084,0,111726,80,1
2057864,2960368,307,79,3995,0,4302,79,1
1635215,3108794,209,13,8253,0,8462,13,1
3588497,1535773,50,86,792,135,842,221,1
4013601,3730405,653,251,14886,0,15539,251,1
1580988,434518,2821,2,400133,0,402954,2,1
1080728,4190114,118,58,2001,0,2119,58,1
1644171,421264,1071,6,3690,0,4761,6,1
3280389,4200045,1101,2,411419,0,412520,2,1
2446968,1491667,452,207,20110,0,20562,207,1
3361377,1863700,4841,25,761793,0,766634,25,1
3361377,135185,4841,2,761793,0,766634,2,1
2441425,3854657,803,20,18561,0,19364,20,1
3065808,2785762,1235,131,82317,0,83552,131,1
1473609,3276833,26,151,154,0,180,151,1
3361377,1486989,4841,1,761793,0,766634,1,1
3280389,2811568,1101,1,411419,0,412520,1,1
3280389,646424,1101,3,411419,0,412520,3,1
1580988,3265162,2821,23,400133,0,402954,23,1
1032721,4012567,20,2,1005,0,1025,2,1
3676295,4631855,374,1,70881,0,71255,1,1
2446968,3995292,452,71,20110,0,20562,71,1
990798,949681,194,1,2812,0,3006,1,1
3509903,2707,1530,1,509445,0,510975,1,1
800218,1996342,169,114,1728,0,1897,114,1
3280389,2753710,1101,3,411419,0,412520,3,1
3361377,3901919,4841,21,761793,0,766634,21,1
2261139,2139107,2014,47,42851,0,44865,47,1
3509903,1874177,1530,2,509445,0,510975,2,1
2851109,2909046,450,1,98552,0,99002,1,1
2887240,13834,1143,6,118405,0,119548,6,1
3986120,4650956,8,121,136,3,144,124,1
474172,2343343,471,53,38713,0,39184,53,1
4723328,4238451,249,1643,2273,54,2522,1697,1
64357,4223406,309,56,6329,0,6638,56,1
4272102,1966496,1608,15,104171,0,105779,15,1
1436216,434143,1068,10,68770,0,69838,10,1
3645034,1563565,102,1,1041,0,1143,1,1
3280389,2804525,1101,1,411419,0,412520,1,1
755739,1987017,1117,63,58043,0,59160,63,1
3638272,4405292,2022,2,370904,0,372926,2,1
1817799,3183926,402,118,15932,0,16334,118,1
2023979,2931088,192,26,3227,0,3419,26,1
607449,633141,380,4,19369,0,19749,4,1
4238946,934136,42,25,656,0,698,25,1
3449530,2937602,717,22,73648,0,74365,22,1
4429751,2064700,150,22,6616,0,6766,22,1
1312847,4137384,418,264,1699,0,2117,264,1
2405789,1589409,1010,54,93387,0,94397,54,1
1735365,878344,149,21,1402,0,1551,21,1
3658711,1892430,66,4,865,0,931,4,1
2826379,2172854,26,239,212,2000,238,2239,1
2324324,109184,376,298,1092,0,1468,298,1
2209136,1609877,620,41,33789,0,34409,41,1
4272102,3635672,1608,129,104171,0,105779,129,1
2625403,2088143,117,234,682,0,799,234,1
2985909,368185,706,30,43348,0,44054,30,1
2853969,4431093,1051,1,42591,0,43642,1,1
1341178,3819875,899,60,16829,0,17728,60,1
2403192,1701061,163,147,5302,0,5465,147,1
3906136,1554847,387,12,41169,0,41556,12,1
573385,3177358,5,2,645,0,650,2,1
3992144,3898289,402,1,23683,0,24085,1,1
4411870,2500944,948,150,60517,0,61465,150,1
2446968,2312941,452,231,20110,0,20562,231,1
2960322,4617468,193,61,2647,0,2840,61,1
1580988,3736212,2821,2,400133,0,402954,2,1
1585197,2590972,72,3,812,0,884,3,1
2906370,892594,271,30,4802,0,5073,30,1
1927211,4177374,1668,101,113322,0,114990,101,1
3905504,3929171,15,24,2116,0,2131,24,1
3294702,4488629,991,285,68888,0,69879,285,1
4664320,2554747,109,8,1966,0,2075,8,1
3069749,4518860,33,5,471,0,504,5,1
987769,599273,15,1,197,0,212,1,1
1063358,3690337,1350,26,63494,0,64844,26,1
3361377,1307134,4841,2,761793,0,766634,2,1
320344,2382924,351,19,3831,0,4182,19,1
3984303,422161,133,16,4489,0,4622,16,1
2031305,2681905,396,81,23435,0,23831,81,1
3668051,4480768,89,12,3044,0,3133,12,1
1927211,140708,1668,65,113322,0,114990,65,1
1234540,329528,1071,29,75251,0,76322,29,1
3184760,703704,92,30,339,0,431,30,1
1471685,4860693,1681,82,25550,0,27231,82,1
3705070,3783518,740,9,14938,0,15678,9,1
3824547,15735,1075,3,14337,0,15412,3,1
2998026,3084964,919,4,24182,0,25101,4,1
1539837,1527560,1127,38,62979,0,64106,38,1
2311472,1813846,91,109,2259,0,2350,109,1
3361377,675895,4841,2,761793,0,766634,2,1
354904,841964,3193,284,105780,0,108973,284,1
4198771,2025347,207,2,8543,0,8750,2,1
3914135,4692774,2152,3,60084,0,62236,3,1
4676944,4400717,35,5,1314,0,1349,5,1
3872736,4661482,258,7,12660,0,12918,7,1
2529661,1185706,493,192,27309,0,27802,192,1
844100,4205408,65,67,168,251,233,318,1
2041204,3329145,151,75,371,0,522,75,1
2203506,4319646,134,1,2432,0,2566,1,1
3911304,4248660,87,144,982,0,1069,144,1
4258870,3524859,336,21,4963,0,5299,21,1
4191410,1886772,1590,44,96434,0,98024,44,1
4365938,1217416,250,19,10362,0,10612,19,1
1880135,380203,810,9,71924,0,72734,9,1
4132817,3940365,187,16,771,0,958,16,1
3457745,3025154,219,183,1864,1843,2083,2026,1
1847461,3290452,1211,54,51149,0,52360,54,1
4314280,3419523,568,43,9552,0,10120,43,1
3765475,4745295,873,59,107914,0,108787,59,1
3509903,311238,1530,6,509445,0,510975,6,1
4541993,3727220,347,4,3610,0,3957,4,1
2476185,637392,133,93,523,0,656,93,1
4337603,2343958,333,2,9909,0,10242,2,1
4689808,163182,280,10,14220,0,14500,10,1
765601,182989,1485,4,101510,0,102995,4,1
2887240,4438679,1143,2,118405,0,119548,2,1
4416945,1787066,417,59,33228,0,33645,59,1
3395938,4478996,546,33,39878,0,40424,33,1
3051623,3973971,80,1,368,0,448,1,1
1341178,3452706,899,245,16829,2116,17728,2361,1
2755798,4701439,494,10,24862,0,25356,10,1
3361377,3755873,4841,2,761793,0,766634,2,1
60980,1474154,649,48,20708,0,21357,48,1
4416945,2636363,417,210,33228,0,33645,210,1
1580988,2154295,2821,1,400133,0,402954,1,1
1927211,2892009,1668,597,113322,0,114990,597,1
272660,3382702,28,201,308,0,336,201,1
954784,4007603,567,1,14450,0,15017,1,1
4710107,2481008,65,7,748,0,813,7,1
1580988,3266200,2821,2,400133,0,402954,2,1
3338906,3654642,140,203,6745,0,6885,203,1
4803701,1001145,333,190,6414,0,6747,190,1
213185,2122008,22,16,70,0,92,16,1
3765475,3429957,873,2,107914,0,108787,2,1
4167572,1936447,81,167,6924,2268,7005,2435,1
1250021,3279402,4637,81,85913,0,90550,81,1
3509903,6873,1530,4,509445,0,510975,4,1
1063857,671986,248,18,15849,0,16097,18,1
3871554,1868981,947,314,16042,0,16989,314,1
1803007,593740,90,1107,1999,62807,2089,63914,1
2502456,935326,719,46,50725,0,51444,46,1
1244713,540988,37,172,1262,0,1299,172,1
3711670,2089328,155,134,1123,0,1278,134,1
3641600,601053,751,76,9269,0,10020,76,1
2981537,1693018,1252,26,118718,0,119970,26,1
3081778,511391,211,30,1969,0,2180,30,1
687713,1952506,436,25,47160,0,47596,25,1
1580988,4168004,2821,18,400133,0,402954,18,1
2897926,1190435,565,432,25983,3922,26548,4354,1
2915611,3864041,109,130,972,0,1081,130,1
4854634,4086957,76,2,1396,0,1472,2,1
3671141,1989561,1444,60,48400,0,49844,60,1
1503116,4265622,415,26,37079,0,37494,26,1
1158516,3975080,141,94,1280,0,1421,94,1
3671141,2100874,1444,55,48400,0,49844,55,1
1735116,431717,503,22,16146,0,16649,22,1
3235479,2550017,999,130,66486,0,67485,130,1
1733957,1708085,554,23,15185,0,15739,23,1
4423184,2784370,384,1,29809,0,30193,1,1
2445500,3455657,68,289,3239,0,3307,289,1
2032442,1150444,109,1,10458,0,10567,1,1
4342519,3507461,138,3,11317,0,11455,3,1
2436781,4308612,689,22,9972,183,10661,205,1
3873768,976684,449,44,35424,0,35873,44,1
755739,3044036,1117,70,58043,0,59160,70,1
3271898,4028408,227,645,2028,0,2255,645,1
1276253,3294553,407,1,46534,0,46941,1,1
1580988,2789273,2821,5,400133,0,402954,5,1
3509903,732352,1530,1,509445,0,510975,1,1
4342519,4176143,138,27,11317,0,11455,27,1
2120733,4492123,819,79,20803,0,21622,79,1
3361377,2372939,4841,1,761793,0,766634,1,1
1179906,4016430,316,158,14467,0,14783,158,1
3387814,3180121,198,120,1943,0,2141,120,1
4692762,3074901,26,3,391,0,417,3,1
1652056,1060310,326,1,66845,0,67171,1,1
2949409,2415776,175,9,2185,0,2360,9,1
3941858,3701216,202,1,5760,0,5962,1,1
3846758,2956553,192,610,791,314,983,924,1
2092359,1442811,421,2,26936,0,27357,2,1
2851109,2936367,450,43,98552,0,99002,43,1
3509903,741151,1530,4,509445,0,510975,4,1
1471685,4395121,1681,37,25550,551,27231,588,1
1196844,7554,548,34,36289,0,36837,34,1
2625403,793173,117,1,682,0,799,1,1
1604785,3061435,139,4,1999,0,2138,4,1
2397149,3239070,340,70,3873,0,4213,70,1
3764475,2628830,301,37,9092,0,9393,37,1
3550361,2199406,205,25,1293,209,1498,234,1
427805,198260,483,1,156906,0,157389,1,1
3638272,2228718,2022,2,370904,0,372926,2,1
26760,1910777,179,477,2100,1910,2279,2387,1
837553,1357285,1249,3,61665,0,62914,3,1
4853234,3150052,1256,2,29554,0,30810,2,1
1221325,2859912,153,95,1819,0,1972,95,1
614645,3831027,16,116,812,251,828,367,1
4298480,1514964,40,110,112,0,152,110,1
1913445,1117123,564,86,47943,0,48507,86,1
755739,3498761,1117,68,58043,0,59160,68,1
4842461,195920,450,3,3728,0,4178,3,1
2488965,4057184,153,4,922,0,1075,4,1
1880135,2635509,810,2,71924,0,72734,2,1
1234540,4680504,1071,137,75251,0,76322,137,1
1323294,3249046,4,1,12,0,16,1,1
2616927,2284492,184,21,2688,0,2872,21,1
3112136,3174550,406,1,41366,0,41772,1,1
4272102,2841142,1608,40,104171,0,105779,40,1
3310260,2201781,113,15,202,0,315,15,1
197541,3049201,134,196,1912,0,2046,196,1
805360,2580492,1514,219,119306,0,120820,219,1
3249188,3000269,42,292,342,0,384,292,1
1637447,3112136,555,406,8549,41366,9104,41772,1
1539837,4443461,1127,112,62979,0,64106,112,1
3509903,2202555,1530,5,509445,0,510975,5,1
1580988,2120349,2821,13,400133,0,402954,13,1
1140134,2684478,311,6,11111,0,11422,6,1
3033166,3508139,312,115,4444,0,4756,115,1
4236325,921654,372,44,6103,0,6475,44,1
4695400,1160476,108,8,364,54,472,62,1
89979,3603495,65,112,658,0,723,112,1
3509903,982459,1530,1,509445,0,510975,1,1
670309,4778752,304,64,7567,0,7871,64,1
808127,1083025,273,86,4215,0,4488,86,1
4642569,2803369,872,29,27586,0,28458,29,1
1816385,1551772,272,138,2945,0,3217,138,1
2981537,2235320,1252,62,118718,0,119970,62,1
1250021,914916,4637,22,85913,0,90550,22,1
3636190,243040,119,73,4195,0,4314,73,1
1243539,3415302,104,2098,741,100,845,2198,1
2173241,455974,708,23,430,74,1138,97,1
4191410,3442565,1590,5,96434,0,98024,5,1
1534362,2102145,1531,53,105859,0,107390,53,1
1580988,3773217,2821,2,400133,0,402954,2,1
2147720,67047,1608,79,78786,0,80394,79,1
363750,2674715,1001,37,10994,0,11995,37,1
4030633,3881981,168,375,912,0,1080,375,1
3509903,782794,1530,24,509445,0,510975,24,1
273363,3091467,768,19,11045,0,11813,19,1
256934,3106083,287,16,11635,0,11922,16,1
3280389,356027,1101,3,411419,0,412520,3,1
3671141,1793232,1444,22,48400,0,49844,22,1
4838376,2121773,606,126,26838,0,27444,126,1
4314280,1619672,568,546,9552,0,10120,546,1
4179343,769600,119,35,9822,0,9941,35,1
2981537,3621401,1252,8,118718,0,119970,8,1
2668463,2798494,116,154,1922,0,2038,154,1
1659017,1649935,817,1,13055,0,13872,1,1
2664875,606679,48,96,342,389,390,485,1
3137585,4395089,1196,1,77354,0,78550,1,1
2884705,2815541,649,3,10233,0,10882,3,1
957197,1423046,614,3,37109,0,37723,3,1
544230,3550742,1532,287,60768,0,62300,287,1
3102873,2045922,341,15,15098,0,15439,15,1
3509903,2350188,1530,3,509445,0,510975,3,1
2092359,1349555,421,5,26936,0,27357,5,1
1900620,4531105,59,18,1163,0,1222,18,1
1192480,905058,397,1,20737,0,21134,1,1
1580988,2061669,2821,2,400133,0,402954,2,1
711824,3964183,113,131,3107,0,3220,131,1
3764177,3761579,1036,109,64563,0,65599,109,1
3361377,3682163,4841,1,761793,0,766634,1,1
1062967,2278211,260,23,15276,0,15536,23,1
1341178,3254239,899,125,16829,0,17728,125,1
2981537,2250260,1252,1,118718,0,119970,1,1
1632616,218893,218,263,1963,0,2181,263,1
3024464,1049340,27,1,121,0,148,1,1
393185,2107095,591,4,7719,0,8310,4,1
544230,1871068,1532,8,60768,0,62300,8,1
1580508,1097126,720,18,19611,0,20331,18,1
3638272,3270864,2022,1,370904,0,372926,1,1
1575009,1944360,429,86,37745,0,38174,86,1
932720,2913249,1411,51,111323,0,112734,51,1
3167388,2175540,203,69,9760,0,9963,69,1
3845119,1094148,461,30,28609,0,29070,30,1
4040599,4687557,63,3,979,0,1042,3,1
401947,244272,367,60,7890,0,8257,60,1
1138515,3583541,341,3,12443,0,12784,3,1
2940204,2774737,247,23,730,0,977,23,1
1679934,4185658,12,142,92,0,104,142,1
3837347,2416263,169,161,2761,1031,2930,1192,1
262893,3289742,161,143,3792,578,3953,721,1
354904,3368208,3193,136,105780,0,108973,136,1
439557,3224290,2090,1,61744,0,63834,1,1
4191410,3070907,1590,28,96434,0,98024,28,1
3911673,1979356,44,57,171,0,215,57,1
3361377,4098433,4841,1,761793,0,766634,1,1
3509903,818058,1530,1,509445,0,510975,1,1
4451491,2237043,817,44,8836,0,9653,44,1
1839283,46875,765,9,36658,0,37423,9,1
4672319,4095417,483,59,9652,0,10135,59,1
1580988,1589912,2821,1,400133,0,402954,1,1
3509903,1844107,1530,2,509445,0,510975,2,1
4272102,2236060,1608,39,104171,0,105779,39,1
429643,1549677,767,139,19668,139,20435,278,1
2851109,2928425,450,14,98552,0,99002,14,1
4658934,1261948,243,170,895,0,1138,170,1
3509903,508379,1530,1,509445,0,510975,1,1
4811103,157767,110,2,1639,0,1749,2,1
1015986,3379155,604,50,14201,0,14805,50,1
4112891,4263061,426,70,3572,0,3998,70,1
1580988,3649390,2821,2,400133,0,402954,2,1
4238001,3515861,869,5,61161,0,62030,5,1
813554,4578198,252,4,17214,0,17466,4,1
3096420,2277115,69,37,749,0,818,37,1
2922412,2818570,464,138,3629,253,4093,391,1
3759853,539057,451,74,16330,0,16781,74,1
1761590,564615,88,90,229,0,317,90,1
4427914,2567242,25,2,178,0,203,2,1
1749840,4823828,44,124,200,208,244,332,1
3844858,944276,1591,229,28974,0,30565,229,1
3960049,765291,140,807,2418,0,2558,807,1
474172,4680198,471,82,38713,0,39184,82,1
3361377,518988,4841,39,761793,0,766634,39,1
2281149,2792400,282,18,28082,0,28364,18,1
3280389,1419471,1101,4,411419,171,412520,175,1
1038711,2481264,96,122,606,0,702,122,1
2687552,140386,238,53,25574,0,25812,53,1
1697778,2621015,125,28,3760,0,3885,28,1
1063358,960506,1350,166,63494,0,64844,166,1
1250021,4448230,4637,28,85913,0,90550,28,1
1354066,4158624,207,43,684,0,891,43,1
2851109,769024,450,4,98552,0,99002,4,1
530200,3210674,2035,22,62809,0,64844,22,1
1265875,2984173,14,2,85,0,99,2,1
2881894,526798,211,929,7468,0,7679,929,1
3235479,131090,999,72,66486,0,67485,72,1
3509903,4005187,1530,1,509445,0,510975,1,1
1580988,4446706,2821,1,400133,0,402954,1,1
1688855,2805382,17,8,1087,0,1104,8,1
3255749,520393,9,5,501,0,510,5,1
4838376,2042087,606,16,26838,0,27444,16,1
1234540,4532388,1071,22,75251,0,76322,22,1
3816962,4555768,160,63,1665,0,1825,63,1
1896819,4743232,177,593,1154,0,1331,593,1
2464401,202547,577,59,23681,0,24258,59,1
3053018,4196367,274,41,796,0,1070,41,1
2998026,2669965,919,1,24182,0,25101,1,1
2464401,4261784,577,40,23681,0,24258,40,1
860473,4570959,751,85,20450,0,21201,85,1
846208,505616,600,85,17288,0,17888,85,1
2893334,987476,889,32,30148,0,31037,32,1
380817,4653398,32,432,1035,0,1067,432,1
4236325,3045674,372,75,6103,0,6475,75,1
3328066,4806115,17,51,223,0,240,51,1
2209136,1534403,620,75,33789,0,34409,75,1
1988347,583293,205,14,3660,0,3865,14,1
307250,3759588,919,1,35588,0,36507,1,1
4171214,2117243,358,63,4601,0,4959,63,1
1092045,3716590,242,5,9359,0,9601,5,1
1654099,3299060,1180,212,26347,0,27527,212,1
4574571,825299,186,51,6965,0,7151,51,1
4596817,437259,160,9,1879,0,2039,9,1
1328699,790280,83,5,1943,0,2026,5,1
1575009,1225872,429,4,37745,0,38174,4,1
1787075,2568929,894,53,28305,0,29199,53,1
2148937,4175214,672,101,47361,0,48033,101,1
2627841,2899103,418,333,12342,0,12760,333,1
1009277,3887137,63,15,153,0,216,15,1
1053192,5686,143,22,701,0,844,22,1
3280389,3048533,1101,1,411419,0,412520,1,1
4209323,3697020,1630,115,89460,0,91090,115,1
3907996,2191871,485,56,18964,0,19449,56,1
1633100,802741,163,428,8737,0,8900,428,1
3881634,4385481,641,2,8471,0,9112,2,1
3914135,2455082,2152,52,60084,0,62236,52,1
196521,231572,1176,104,11269,0,12445,104,1
3509903,1279597,1530,96,509445,0,510975,96,1
1494665,1324377,668,133,37638,0,38306,133,1
3115867,3740903,1350,5,61232,0,62582,5,1
3873768,632797,449,30,35424,0,35873,30,1
4827056,1106317,226,49,12578,0,12804,49,1
3435785,1784120,220,206,1519,0,1739,206,1
4592021,3992144,299,402,1376,23683,1675,24085,1
183132,4645815,370,269,2556,0,2926,269,1
4727207,4280144,925,2,84581,0,85506,2,1
3280389,1708732,1101,1,411419,0,412520,1,1
2883055,4140286,286,9,13198,0,13484,9,1
2485529,3019243,358,17,1375,0,1733,17,1
2446968,1961937,452,158,20110,0,20562,158,1
3889275,2474276,7,4,305,0,312,4,1
3914135,2441222,2152,12,60084,0,62236,12,1
805360,1638689,1514,8,119306,0,120820,8,1
1542757,479414,283,132,5996,0,6279,132,1
2343253,753415,1882,1,86401,0,88283,1,1
873241,742786,616,229,22633,0,23249,229,1
4230144,3142462,216,3,4435,0,4651,3,1
2981537,1387364,1252,1,118718,0,119970,1,1
2950311,3273453,807,25,85116,0,85923,25,1
400117,4533052,419,238,1225,0,1644,238,1
991610,1828312,281,76,1539,0,1820,76,1
2998026,3410731,919,12,24182,0,25101,12,1
1912031,732223,226,16,2674,0,2900,16,1
3361377,558580,4841,1,761793,0,766634,1,1
2906327,1657839,61,116,324,0,385,116,1
4295952,4271246,808,160,57369,0,58177,160,1
3450448,4028408,81,645,1892,0,1973,645,1
3676295,900510,374,3,70881,0,71255,3,1
2827436,3540822,882,2,271525,0,272407,2,1
3569179,4740705,1064,36,40015,0,41079,36,1
4835623,181443,17,3,83,0,100,3,1
4140279,591545,337,1,49384,0,49721,1,1
1031334,2842911,459,320,16840,0,17299,320,1
1604753,1577971,78,6,3240,0,3318,6,1
2896906,2620249,1193,67,7172,0,8365,67,1
3329658,4127134,95,20,1945,0,2040,20,1
3361377,1795116,4841,2,761793,0,766634,2,1
151034,1417425,54,640,494,2016,548,2656,1
3920285,401344,68,40,550,216,618,256,1
3438576,4117269,3424,2,137753,0,141177,2,1
2096270,4158361,970,216,26018,0,26988,216,1
3638272,1237306,2022,64,370904,0,372926,64,1
4674575,3950466,273,2,4000,0,4273,2,1
354904,3601427,3193,22,105780,0,108973,22,1
3836080,3451376,1197,98,59457,0,60654,98,1
1633100,2567823,163,2,8737,0,8900,2,1
4238001,4723716,869,13,61161,0,62030,13,1
2315745,894262,11,17,79,0,90,17,1
3155346,2842549,207,239,3132,0,3339,239,1
4782707,1336092,513,94,31665,0,32178,94,1
1209012,4258632,107,459,722,0,829,459,1
2827436,3929005,882,1,271525,0,272407,1,1
1934836,1701015,284,36,2471,0,2755,36,1
3705070,4536608,740,111,14938,0,15678,111,1
1533546,2914721,703,49,22095,0,22798,49,1
474172,1830069,471,11,38713,0,39184,11,1
1331940,779761,802,40,32617,0,33419,40,1
2707591,2827436,162,882,2360,271525,2522,272407,1
2301466,4621952,52,922,341,5245,393,6167,1
4360799,3080453,910,194,10476,0,11386,194,1
180517,4411879,118,122,4246,0,4364,122,1
1733957,1110208,554,9,15185,0,15739,9,1
408965,2340548,903,80,38623,0,39526,80,1
4451122,3070311,985,22,41669,0,42654,22,1
537144,2427842,11,6,173,0,184,6,1
3438576,1324909,3424,9,137753,0,141177,9,1
2260014,2141711,2466,19,98622,0,101088,19,1
1613202,3625624,566,13,8639,0,9205,13,1
837553,319420,1249,92,61665,0,62914,92,1
1539837,4061145,1127,9,62979,0,64106,9,1
2854573,3328078,99,151,5019,0,5118,151,1
1192480,4438687,397,11,20737,0,21134,11,1
2163640,3965930,129,6,5750,0,5879,6,1
4635332,2072627,90,30,2326,0,2416,30,1
805360,3627654,1514,42,119306,0,120820,42,1
180517,4087474,118,1058,4246,0,4364,1058,1
1031334,4792787,459,108,16840,0,17299,108,1
2877907,895254,508,11,16021,0,16529,11,1
4370378,3449097,243,177,1075,0,1318,177,1
2751572,68883,481,153,44036,0,44517,153,1
2755798,3266876,494,1,24862,0,25356,1,1
1580988,2098337,2821,1,400133,0,402954,1,1
2109216,4302891,386,1,4712,0,5098,1,1
3672238,2126521,518,6,12172,0,12690,6,1
2536472,1489475,344,2,9725,0,10069,2,1
1927211,4254367,1668,57,113322,0,114990,57,1
3112136,1327151,406,59,41366,0,41772,59,1
4054733,1690271,217,30,1907,0,2124,30,1
82764,1014943,42,2,972,0,1014,2,1
3408985,3042631,205,114,6002,0,6207,114,1
3361377,3993066,4841,1,761793,0,766634,1,1
4708250,1251314,122,4,1075,0,1197,4,1
1966548,1924817,208,93,53149,0,53357,93,1
2017226,425920,65,47,257,0,322,47,1
3206499,2812115,1337,1,32033,0,33370,1,1
3509903,1600701,1530,1,509445,0,510975,1,1
2024753,878799,172,2,1901,0,2073,2,1
1293807,1622060,1837,137,30865,0,32702,137,1
2752145,248483,79,60,1888,0,1967,60,1
2503097,1952321,414,195,3628,23,4042,218,1
4360960,3123549,1642,17,110084,0,111726,17,1
392779,394429,148,110,2136,0,2284,110,1
3361377,1846868,4841,8,761793,0,766634,8,1
1386493,491243,111,27,1396,0,1507,27,1
4558346,4439050,41,22,290,0,331,22,1
1331940,916593,802,199,32617,0,33419,199,1
1063358,3963511,1350,32,63494,0,64844,32,1
1337919,2829298,250,2,10276,0,10526,2,1
532681,1967391,433,111,35023,0,35456,111,1
1966548,3245385,208,36,53149,0,53357,36,1
4011264,4448566,1360,76,116777,0,118137,76,1
2496454,2723996,320,24,2769,0,3089,24,1
1966548,477060,208,1,53149,0,53357,1,1
1209012,4781751,107,4,722,0,829,4,1
4083878,3573544,111,46,1140,0,1251,46,1
2950311,2376634,807,10,85116,0,85923,10,1
2757156,972885,237,108,8153,0,8390,108,1
2998026,1782247,919,42,24182,101,25101,143,1
2799101,1554124,154,247,527,1205,681,1452,1
4417253,429065,1130,4,68389,0,69519,4,1
4417253,4207251,1130,71,68389,0,69519,71,1
1493489,3884014,523,113,17512,0,18035,113,1
439557,1617168,2090,1,61744,0,63834,1,1
2260556,802664,14,5,152,0,166,5,1
1436216,1197858,1068,46,68770,0,69838,46,1
4236325,2504011,372,53,6103,0,6475,53,1
2310265,143770,241,49,6278,0,6519,49,1
1812281,1395062,150,14,815,0,965,14,1
3280389,3836072,1101,2,411419,0,412520,2,1
4780428,107615,94,68,2777,0,2871,68,1
4238001,4709980,869,55,61161,0,62030,55,1
408965,4786185,903,30,38623,0,39526,30,1
20878,3571806,131,797,679,264,810,1061,1
1539837,980096,1127,42,62979,0,64106,42,1
1842355,2464080,175,12,774,0,949,12,1
2633981,2339339,83,13,836,0,919,13,1
571147,242860,364,39,5484,0,5848,39,1
3449530,875585,717,202,73648,0,74365,202,1
1083738,1239708,100,52,165,147,265,199,1
3347565,4592122,144,1748,1425,8,1569,1756,1
3638272,137203,2022,3,370904,0,372926,3,1
4167572,208863,81,6,6924,0,7005,6,1
1786855,3577612,164,35,705,0,869,35,1
3765475,391857,873,1,107914,0,108787,1,1
4785101,638132,150,66,1988,0,2138,66,1
4809559,3331468,297,1,3171,0,3468,1,1
1497278,2449205,1869,82,35111,0,36980,82,1
3509903,1248207,1530,5,509445,0,510975,5,1
3638272,1471930,2022,1,370904,0,372926,1,1
2881894,2791664,211,54,7468,0,7679,54,1
4479581,1274647,601,14,19545,0,20146,14,1
1293056,586759,29,579,178,0,207,579,1
1031334,2859121,459,52,16840,0,17299,52,1
842476,3589875,898,174,12479,0,13377,174,1
17330,1658312,154,16,972,0,1126,16,1
3993347,1913201,434,37,3778,0,4212,37,1
3607822,1898130,36,114,166,0,202,114,1
2981537,576422,1252,2,118718,0,119970,2,1
2147720,2177822,1608,61,78786,0,80394,61,1
427805,2774442,483,2,156906,0,157389,2,1
1234540,3303854,1071,27,75251,0,76322,27,1
1652056,239552,326,3,66845,0,67171,3,1
3560934,2107029,28,22,1889,0,1917,22,1
273363,3866205,768,238,11045,0,11813,238,1
4360960,1711416,1642,21,110084,0,111726,21,1
3280389,2436603,1101,2,411419,0,412520,2,1
948768,4275596,587,39,14768,0,15355,39,1
2342664,1324285,1181,7,26502,0,27683,7,1
1580988,504154,2821,1,400133,0,402954,1,1
917130,1737509,325,149,7017,0,7342,149,1
4840211,555664,145,6,2001,0,2146,6,1
3491292,3214893,69,1087,406,6553,475,7640,1
3829011,1889203,143,44,2807,0,2950,44,1
646587,2461295,122,14,5819,0,5941,14,1
584906,3535900,253,78,6639,0,6892,78,1
3511870,4306567,149,1,293,0,442,1,1
3501482,3626314,522,260,28046,0,28568,260,1
2961801,3971708,1483,16,101962,0,103445,16,1
3835618,103989,694,17,25433,0,26127,17,1
2297625,3797822,512,393,6498,0,7010,393,1
22189,3620845,125,147,402,0,527,147,1
4180345,67680,83,14,868,0,951,14,1
1580988,1749736,2821,17,400133,0,402954,17,1
2981537,3482711,1252,4,118718,0,119970,4,1
326344,2174755,132,3,1123,0,1255,3,1
377526,3001891,183,304,781,4550,964,4854,1
2436781,1179360,689,32,9972,0,10661,32,1
4519298,2177913,577,47,14443,0,15020,47,1
1494665,1458814,668,143,37638,0,38306,143,1
818302,2020786,54,2,490,0,544,2,1
3638272,4065895,2022,10,370904,0,372926,10,1
1580988,2739361,2821,1,400133,0,402954,1,1
3216498,1357867,47,103,256,217,303,320,1
4123758,329295,216,139,4336,0,4552,139,1
3361377,738311,4841,8,761793,0,766634,8,1
3509903,3034919,1530,3,509445,0,510975,3,1
4209323,95230,1630,46,89460,0,91090,46,1
4492248,3911503,237,90,17127,500,17364,590,1
1966548,2738816,208,1,53149,0,53357,1,1
738648,165608,387,14,2792,0,3179,14,1
1580988,4086656,2821,4,400133,0,402954,4,1
259575,3646415,260,11,13949,0,14209,11,1
3140664,3247724,268,24,16099,0,16367,24,1
2049692,1829471,38,37,618,272,656,309,1
354904,1843754,3193,2,105780,0,108973,2,1
2306134,3784006,337,87,5153,0,5490,87,1
1103332,1568518,732,20,59415,0,60147,20,1
3361377,3069895,4841,19,761793,0,766634,19,1
805360,3008969,1514,53,119306,0,120820,53,1
1633022,4311177,246,1,23530,0,23776,1,1
2148937,768421,672,65,47361,0,48033,65,1
873241,4128258,616,39,22633,0,23249,39,1
1054898,2358879,33,6,1374,0,1407,6,1
1708324,2879747,208,40,1065,0,1273,40,1
439557,3456615,2090,2,61744,0,63834,2,1
2502456,1001208,719,203,50725,0,51444,203,1
1503116,1546620,415,44,37079,0,37494,44,1
3500846,3407314,210,116,5085,0,5295,116,1
2342664,1354184,1181,19,26502,0,27683,19,1
44777,3129920,685,6,450,0,1135,6,1
2804347,1562992,30,2,256,0,286,2,1
2961801,2002386,1483,22,101962,0,103445,22,1
4209323,1316588,1630,79,89460,0,91090,79,1
4451122,1363438,985,49,41669,0,42654,49,1
1609659,338499,523,200,29763,0,30286,200,1
837553,3357577,1249,1,61665,0,62914,1,1
2905583,733614,132,7,353,0,485,7,1
1604753,4347778,78,1,3240,0,3318,1,1
1591435,4517305,387,39,31245,0,31632,39,1
3395938,4783990,546,20,39878,0,40424,20,1
197080,768269,21,667,288,32,309,699,1
805360,1294622,1514,15,119306,0,120820,15,1
532681,22133,433,61,35023,0,35456,61,1
1814709,4538103,316,9,5746,0,6062,9,1
4708541,1946775,981,242,15678,0,16659,242,1
4555984,354904,144,3193,2566,105780,2710,108973,1
1913445,4162223,564,115,47943,0,48507,115,1
4451122,2471718,985,71,41669,0,42654,71,1
2281149,1605184,282,44,28082,0,28364,44,1
4052496,2531906,107,62,4222,0,4329,62,1
3881566,4785562,781,30,14176,0,14957,30,1
1250021,4072505,4637,2,85913,0,90550,2,1
3853609,383400,505,20,6896,0,7401,20,1
1534362,4717434,1531,44,105859,0,107390,44,1
635715,1972090,149,8,389,0,538,8,1
1063358,2155356,1350,20,63494,0,64844,20,1
4337603,1013491,333,62,9909,0,10242,62,1
2148937,4845392,672,302,47361,0,48033,302,1
3280389,996135,1101,3,411419,0,412520,3,1
1534362,2864734,1531,21,105859,0,107390,21,1
582276,2800054,298,2,10990,0,11288,2,1
2567613,2138449,186,368,2647,0,2833,368,1
2343253,2964785,1882,18,86401,0,88283,18,1
1799076,4800494,146,100,3750,0,3896,100,1
4624595,4257170,722,55,53368,0,54090,55,1
4319972,4224814,640,4,35279,0,35919,4,1
2961552,2023407,562,24,16546,0,17108,24,1
508787,4237235,29,318,88,852,117,1170,1
2981537,3372599,1252,268,118718,0,119970,268,1
3765475,3835137,873,1,107914,0,108787,1,1
4721617,86700,307,230,12885,0,13192,230,1
3019092,810585,108,1,8595,0,8703,1,1
1279976,2968973,3,7,371,0,374,7,1
354904,972120,3193,16,105780,0,108973,16,1
2827436,4698473,882,2,271525,0,272407,2,1
3189108,1121330,421,64,6767,0,7188,64,1
1135323,2160029,169,2,12240,0,12409,2,1
363116,1093935,143,4,1478,0,1621,4,1
3823546,4310885,61,1,3026,0,3087,1,1
4417253,3011925,1130,56,68389,0,69519,56,1
2503097,4387580,414,107,3628,0,4042,107,1
2343253,3564465,1882,9,86401,0,88283,9,1
1436216,272881,1068,1,68770,0,69838,1,1
1234540,4629287,1071,21,75251,0,76322,21,1
2075015,177827,2664,25,85781,0,88445,25,1
907654,3584087,798,62,24575,0,25373,62,1
445996,232362,1175,8,12828,0,14003,8,1
1652056,2520568,326,1,66845,0,67171,1,1
3509903,268275,1530,2,509445,0,510975,2,1
623302,2922668,45,11,317,0,362,11,1
687713,1312340,436,1,47160,0,47596,1,1
4319972,1085572,640,27,35279,0,35919,27,1
427805,4335079,483,1,156906,0,157389,1,1
1497278,3918313,1869,146,35111,915,36980,1061,1
3509903,3437302,1530,1,509445,0,510975,1,1
3099326,4438243,176,17,1952,0,2128,17,1
6618,4437468,892,157,68849,0,69741,157,1
2710011,2351732,380,43,997,0,1377,43,1
1799076,2831718,146,91,3750,0,3896,91,1
2851109,3585605,450,2,98552,0,99002,2,1
1880135,18253,810,5,71924,0,72734,5,1
3836080,386583,1197,46,59457,0,60654,46,1
1276253,2227980,407,24,46534,0,46941,24,1
4022062,2512879,157,6,3780,0,3937,6,1
3118804,3505436,315,106,6025,0,6340,106,1
71779,4518054,172,12,1404,0,1576,12,1
1822719,990539,285,45,22351,0,22636,45,1
3419989,192952,350,13,16316,0,16666,13,1
3836080,984110,1197,42,59457,0,60654,42,1
3361377,4081966,4841,1,761793,0,766634,1,1
4721617,3164017,307,33,12885,0,13192,33,1
4435816,986499,262,5,8391,0,8653,5,1
2056892,722590,250,122,4216,0,4466,122,1
3509903,221243,1530,2,509445,0,510975,2,1
2405789,4752304,1010,22,93387,0,94397,22,1
2342664,4489269,1181,16,26502,0,27683,16,1
4618418,3070454,76,54,495,440,571,494,1
1903752,1866751,506,27,10494,0,11000,27,1
3866441,665164,261,396,3655,12610,3916,13006,1
3569179,313257,1064,17,40015,0,41079,17,1
3764475,40063,301,8,9092,0,9393,8,1
1580988,2337785,2821,142,400133,0,402954,142,1
1140134,142530,311,3,11111,0,11422,3,1
1273923,3454331,99,15,646,0,745,15,1
2661982,4356978,18,1,1790,0,1808,1,1
842476,3373148,898,18,12479,0,13377,18,1
3058068,3665713,124,3,12734,0,12858,3,1
3734245,2699628,915,71,34965,0,35880,71,1
2498087,884259,1630,11,32582,0,34212,11,1
2827436,3318170,882,1,271525,0,272407,1,1
1467901,116999,79,3,447,0,526,3,1
4516604,1869222,314,220,13314,0,13628,220,1
4411870,2620025,948,28,60517,0,61465,28,1
47928,2986512,120,110,3814,0,3934,110,1
2516076,769776,1455,110,77782,0,79237,110,1
3836080,781451,1197,5,59457,0,60654,5,1
2260014,925315,2466,46,98622,0,101088,46,1
3633019,3714578,746,46,32317,0,33063,46,1
830649,4825836,2,1,16,0,18,1,1
3361377,916877,4841,4,761793,0,766634,4,1
4731849,8568,455,8,10886,0,11341,8,1
2348093,4120875,335,24,12064,0,12399,24,1
4678614,953947,452,213,16881,0,17333,213,1
3594818,3914213,81,23,1945,0,2026,23,1
577580,1592630,187,6,3831,0,4018,6,1
1580988,751602,2821,3,400133,0,402954,3,1
1708324,1459948,208,81,1065,0,1273,81,1
3067549,4015080,684,144,1696,1337,2380,1481,1
765601,1332595,1485,92,101510,0,102995,92,1
1580988,3083780,2821,1,400133,0,402954,1,1
393185,2079499,591,143,7719,0,8310,143,1
4209323,3297489,1630,69,89460,0,91090,69,1
2490914,1025830,570,124,22965,0,23535,124,1
3387987,4665245,268,36,19035,0,19303,36,1
4342519,2287012,138,195,11317,0,11455,195,1
1966548,863075,208,1,53149,0,53357,1,1
4119505,4504739,344,355,1991,0,2335,355,1
4329730,1021595,395,105,3730,0,4125,105,1
4183784,4501862,931,43,59894,0,60825,43,1
4587866,4501434,507,27,2074,0,2581,27,1
3300452,3328352,114,13,1992,0,2106,13,1
3754637,4521322,104,83,570,0,674,83,1
1062967,4083416,260,3,15276,0,15536,3,1
307250,2490477,919,4,35588,0,36507,4,1
3509422,2126530,255,72,1344,0,1599,72,1
3509903,2483776,1530,4,509445,0,510975,4,1
4100923,1720512,260,11,7743,0,8003,11,1
1652056,254788,326,1,66845,0,67171,1,1
4479158,4569646,185,182,1447,0,1632,182,1
2148937,3985396,672,1,47361,0,48033,1,1
2041134,2727473,477,31,4284,0,4761,31,1
2266398,1719803,209,218,1473,0,1682,218,1
4110535,339191,395,14,7311,0,7706,14,1
1479308,3020951,83,9,480,0,563,9,1
3257465,796857,541,42,27614,0,28155,42,1
3610598,3940798,380,10,17343,0,17723,10,1
3509903,4388499,1530,1,509445,0,510975,1,1
4280022,3044658,67,14,821,0,888,14,1
4677576,1992078,103,6,1655,0,1758,6,1
3419989,1001502,350,236,16316,0,16666,236,1
2827436,165976,882,2,271525,0,272407,2,1
1539837,737225,1127,75,62979,0,64106,75,1
3645402,2191287,153,239,7400,0,7553,239,1
2075015,1327110,2664,33,85781,0,88445,33,1
1580988,481879,2821,4,400133,0,402954,4,1
2721412,3327794,273,24,2733,0,3006,24,1
711442,689519,300,92,999,1171,1299,1263,1
592541,2242420,132,22,6913,0,7045,22,1
3125762,95016,254,14,8285,0,8539,14,1
2882060,1814756,163,49,1992,0,2155,49,1
3638272,981901,2022,1,370904,0,372926,1,1
907654,3561659,798,43,24575,0,25373,43,1
1063358,4264312,1350,109,63494,0,64844,109,1
1600857,1476180,324,5,10576,0,10900,5,1
2774493,3079553,551,79,12712,0,13263,79,1
2654633,308104,151,121,2699,0,2850,121,1
4447911,2980646,38,23,474,0,512,23,1
2194948,4074560,13,1,83,0,96,1,1
276502,855030,30,77,2245,164,2275,241,1
268844,821526,422,39,5070,0,5492,39,1
1516853,4367823,426,3,10168,0,10594,3,1
3638272,2083186,2022,3,370904,0,372926,3,1
21944,1238057,317,117,9419,0,9736,117,1
1339664,509324,228,490,6682,0,6910,490,1
2309976,2025585,458,1,2527,0,2985,1,1
326344,4476717,132,71,1123,0,1255,71,1
2464401,1451412,577,5,23681,0,24258,5,1
1580988,4096421,2821,5,400133,0,402954,5,1
3361377,3172811,4841,1,761793,0,766634,1,1
1787075,3585905,894,38,28305,0,29199,38,1
370461,3985110,103,15,1991,0,2094,15,1
3144238,3184124,326,7,28455,0,28781,7,1
2564955,1505038,108,43,1325,0,1433,43,1
3638272,3458040,2022,1,370904,0,372926,1,1
2542968,3553459,444,1,4728,0,5172,1,1
1015986,3319242,604,144,14201,0,14805,144,1
3638272,3502157,2022,2,370904,0,372926,2,1
4004339,2740579,153,2,6086,0,6239,2,1
781211,14355,976,26,51781,0,52757,26,1
302328,3911264,266,1,732,0,998,1,1
162775,193736,72,274,134,767,206,1041,1
3294702,3855448,991,74,68888,0,69879,74,1
97028,428726,619,119,8923,0,9542,119,1
4011264,257613,1360,17,116777,0,118137,17,1
3561502,4117027,1144,25,68800,0,69944,25,1
4841158,2067843,194,176,1607,0,1801,176,1
4751453,2563918,520,89,27570,0,28090,89,1
2947429,2302436,19,34,892,0,911,34,1
4130358,3563147,47,22,847,0,894,22,1
1542757,3380083,283,44,5996,0,6279,44,1
2249093,1501903,134,27,2139,0,2273,27,1
646688,50530,115,327,243,36,358,363,1
4183784,4065560,931,54,59894,0,60825,54,1
1063857,1667018,248,3,15849,0,16097,3,1
3765475,496234,873,58,107914,0,108787,58,1
3135952,1936662,56,1,593,0,649,1,1
3097424,4369777,10,45,302,0,312,45,1
1539837,1822088,1127,41,62979,0,64106,41,1
3214323,3292918,147,8,12543,0,12690,8,1
4095026,4496178,71,4,1175,0,1246,4,1
530200,4037697,2035,463,62809,0,64844,463,1
3638272,1418609,2022,4,370904,0,372926,4,1
2307868,1924905,1131,54,38777,0,39908,54,1
4503643,1468622,8,34,715,0,723,34,1
4411870,572716,948,1,60517,0,61465,1,1
4701737,4708488,98,159,4855,0,4953,159,1
1234540,4710526,1071,67,75251,0,76322,67,1
573101,3722022,781,74,12750,0,13531,74,1
1718856,817106,54,12,630,0,684,12,1
3842148,3989170,719,96,11430,0,12149,96,1
3280389,3663697,1101,1,411419,0,412520,1,1
4011264,3051586,1360,3,116777,0,118137,3,1
3187565,1063024,97,63,4164,0,4261,63,1
3638272,997364,2022,1,370904,0,372926,1,1
4337603,4301993,333,73,9909,0,10242,73,1
300239,3963550,254,52,560,0,814,52,1
3019092,3950566,108,22,8595,0,8703,22,1
1580988,4531882,2821,1,400133,0,402954,1,1
787474,4135518,71,9,142,0,213,9,1
932720,3056649,1411,8,111323,0,112734,8,1
1063358,2918792,1350,440,63494,0,64844,440,1
2985909,1272163,706,1,43348,0,44054,1,1
1311307,2067764,358,37,10864,0,11222,37,1
427805,1270133,483,1,156906,0,157389,1,1
2985909,1093136,706,42,43348,0,44054,42,1
2827436,3102696,882,12,271525,0,272407,12,1
2260014,4287187,2466,5,98622,0,101088,5,1
3509903,3879621,1530,1,509445,0,510975,1,1
4181344,649347,95,19,381,0,476,19,1
2961801,3888138,1483,38,101962,0,103445,38,1
1927211,1361572,1668,8,113322,0,114990,8,1
595757,464158,340,391,26738,0,27078,391,1
1052093,1533225,15,780,50,268,65,1048,1
4100923,4821061,260,76,7743,0,8003,76,1
4727207,4517624,925,12,84581,0,85506,12,1
3638272,2401957,2022,1,370904,0,372926,1,1
1984622,638432,145,12,20659,0,20804,12,1
3987684,1977261,286,14,17372,0,17658,14,1
813554,4505406,252,9,17214,0,17466,9,1
427805,3947052,483,2,156906,0,157389,2,1
4738916,4206456,1165,7,34124,0,35289,7,1
501914,3667074,217,909,5217,0,5434,909,1
355682,4334765,70,115,115,119,185,234,1
595757,4456596,340,118,26738,0,27078,118,1
3361377,3881450,4841,1,761793,0,766634,1,1
530200,4771078,2035,398,62809,0,64844,398,1
2446968,550985,452,213,20110,0,20562,213,1
2405789,3614919,1010,7,93387,0,94397,7,1
3638272,3147672,2022,1,370904,0,372926,1,1
3280389,2872749,1101,2,411419,0,412520,2,1
3361377,1332243,4841,4,761793,0,766634,4,1
3123201,3804754,126,97,5539,0,5665,97,1
1521855,452476,228,68,7649,0,7877,68,1
3280389,2626472,1101,2,411419,0,412520,2,1
1735116,2062993,503,51,16146,0,16649,51,1
3522049,4467336,301,6,12347,0,12648,6,1
3137585,1920970,1196,76,77354,0,78550,76,1
3823546,1446974,61,18,3026,0,3087,18,1
4582129,2927078,1231,27,10356,0,11587,27,1
1534362,4802208,1531,52,105859,0,107390,52,1
1828358,339807,106,192,927,1267,1033,1459,1
3676295,4360981,374,1,70881,0,71255,1,1
1591435,2010455,387,50,31245,0,31632,50,1
1086912,378666,907,84,33396,584,34303,668,1
3561502,3982093,1144,113,68800,0,69944,113,1
3980540,2304093,152,4,1918,0,2070,4,1
1331940,4066461,802,220,32617,0,33419,220,1
3561502,3581722,1144,25,68800,0,69944,25,1
2553405,165302,568,84,12913,0,13481,84,1
3361377,4244669,4841,3,761793,0,766634,3,1
315254,2342187,99,87,3983,0,4082,87,1
4653007,3862829,169,4,728,0,897,4,1
687713,1785585,436,4,47160,0,47596,4,1
4360960,3676458,1642,5,110084,0,111726,5,1
4301252,3799434,118,273,2905,0,3023,273,1
4560313,4189798,284,140,4566,1874,4850,2014,1
3438576,2926567,3424,3,137753,0,141177,3,1
4191727,1628057,463,343,26315,0,26778,343,1
1243368,3119634,319,291,5045,0,5364,291,1
4295952,115109,808,23,57369,0,58177,23,1
4295952,3278164,808,156,57369,0,58177,156,1
1792987,4316489,97,78,3867,0,3964,78,1
4054891,2147720,96,1608,1451,78786,1547,80394,1
4011264,4440178,1360,12,116777,0,118137,12,1
3638272,1468598,2022,1,370904,0,372926,1,1
3845119,1721561,461,25,28609,0,29070,25,1
4653941,3238743,951,21,45883,0,46834,21,1
1580988,3656131,2821,1,400133,0,402954,1,1
3176788,4324568,95,73,1038,0,1133,73,1
3981429,1744770,208,91,1911,0,2119,91,1
873006,1012299,375,34,33630,0,34005,34,1
3280389,3546462,1101,1,411419,0,412520,1,1
316330,3518119,63,1,1944,0,2007,1,1
2318588,2874881,104,5,1272,0,1376,5,1
1234540,174311,1071,12,75251,0,76322,12,1
1534526,3696713,51,1,1638,0,1689,1,1
3112136,160543,406,76,41366,0,41772,76,1
1234540,3010865,1071,5,75251,0,76322,5,1
4485028,2208243,445,6,14565,0,15010,6,1
455994,3333190,95,145,2615,0,2710,145,1
4192206,3290191,468,279,18229,0,18697,279,1
4671601,2755254,12,2,88,0,100,2,1
1436216,1084482,1068,72,68770,0,69838,72,1
3873768,3397417,449,37,35424,0,35873,37,1
524924,1615051,45,6,910,0,955,6,1
2960818,4366854,114,186,317,737,431,923,1
1339664,1760685,228,102,6682,0,6910,102,1
2670449,2471597,277,1,3488,0,3765,1,1
1374576,2711040,33,3,99,0,132,3,1
2827436,1587386,882,1,271525,0,272407,1,1
2301663,3080788,72,6,1728,0,1800,6,1
3844858,943914,1591,109,28974,0,30565,109,1
3734245,425451,915,45,34965,0,35880,45,1
92352,2301959,1138,5,20575,0,21713,5,1
4651264,3509584,34,39,332,0,366,39,1
2887240,3224370,1143,3,118405,0,119548,3,1
3294702,85747,991,8,68888,0,69879,8,1
3065808,2417891,1235,45,82317,0,83552,45,1
4727207,3091114,925,1,84581,0,85506,1,1
4192206,2227443,468,2,18229,0,18697,2,1
3638272,1930835,2022,4,370904,0,372926,4,1
2950311,1677653,807,29,85116,0,85923,29,1
3504290,3328014,33,14,371,0,404,14,1
2516076,3460675,1455,23,77782,0,79237,23,1
3873768,4272070,449,11,35424,0,35873,11,1
1580988,3637870,2821,3,400133,0,402954,3,1
958615,647572,56,6,2225,0,2281,6,1
2713411,2503902,384,4,4637,0,5021,4,1
3140664,1546435,268,3,16099,0,16367,3,1
82918,2280639,88,43,3786,0,3874,43,1
4183784,2447581,931,101,59894,0,60825,101,1
2910951,2294213,22,32,34,0,56,32,1
4233503,25593,224,1914,7867,502,8091,2416,1
1615854,1712847,286,14,2590,0,2876,14,1
1580988,4125790,2821,63,400133,0,402954,63,1
4183784,1425614,931,31,59894,0,60825,31,1
1534362,4704493,1531,73,105859,0,107390,73,1
2044668,1684368,112,55,1553,129,1665,184,1
1250021,3894679,4637,2,85913,0,90550,2,1
3509903,26826,1530,1,509445,0,510975,1,1
4384375,4195720,129,111,4747,0,4876,111,1
4547438,3691318,1291,79,25237,0,26528,79,1
1127093,416601,554,112,6014,0,6568,112,1
4319972,1874415,640,35,35279,0,35919,35,1
3361377,2509691,4841,17,761793,0,766634,17,1
748348,3096106,68,5,798,0,866,5,1
1580988,3227769,2821,47,400133,0,402954,47,1
1913445,1051059,564,15,47943,0,48507,15,1
4798192,2283863,816,1,20426,0,21242,1,1
2050190,4483495,153,32,9156,0,9309,32,1
593740,4505976,1107,86,62807,0,63914,86,1
1818911,4662753,425,1,2972,0,3397,1,1
408965,1154909,903,20,38623,0,39526,20,1
1471685,2278896,1681,15,25550,0,27231,15,1
1533546,1103332,703,732,22095,59415,22798,60147,1
3638272,3848287,2022,1,370904,0,372926,1,1
2827436,1535298,882,1,271525,0,272407,1,1
519175,2500022,173,4,7221,0,7394,4,1
3632293,3404116,570,10,21294,0,21864,10,1
3588630,4689894,351,24,7803,0,8154,24,1
4417253,824737,1130,50,68389,0,69519,50,1
4593330,3333839,203,94,8083,0,8286,94,1
2168218,1491640,404,37,3126,0,3530,37,1
2697956,525734,129,110,85,1011,214,1121,1
2950311,3648294,807,3,85116,0,85923,3,1
2950311,1572988,807,45,85116,0,85923,45,1
1149497,2284146,166,115,333,25,499,140,1
3016810,1485466,164,11,4329,0,4493,11,1
1761151,4073398,260,41,4153,0,4413,41,1
1164238,2488744,179,264,2363,0,2542,264,1
3638272,1138850,2022,4,370904,0,372926,4,1
4191410,1586091,1590,100,96434,0,98024,100,1
3836080,3938121,1197,22,59457,0,60654,22,1
1441303,2439241,30,14,491,0,521,14,1
2202786,736300,92,181,942,0,1034,181,1
628351,1583310,333,132,4229,0,4562,132,1
3509903,553975,1530,2,509445,0,510975,2,1
1364801,1581753,450,63,4704,110,5154,173,1
315254,4113955,99,101,3983,0,4082,101,1
1875,752185,656,7,61388,0,62044,7,1
1847461,1015897,1211,11,51149,0,52360,11,1
67454,3721449,515,64,5700,0,6215,64,1
4191410,55722,1590,121,96434,0,98024,121,1
1580988,89850,2821,4,400133,0,402954,4,1
2281149,3958859,282,24,28082,0,28364,24,1
4287440,2482283,18,7,276,0,294,7,1
1534362,4733239,1531,61,105859,0,107390,61,1
4202576,3804237,600,4,10697,0,11297,4,1
3658026,630954,223,13,1451,0,1674,13,1
3437068,4465769,295,19,1597,0,1892,19,1
1234540,591346,1071,61,75251,0,76322,61,1
2772113,3592546,792,14,42907,0,43699,14,1
2757156,4197392,237,106,8153,0,8390,106,1
3099326,763828,176,84,1952,0,2128,84,1
65845,2007144,411,104,4088,177,4499,281,1
4417253,2050884,1130,22,68389,0,69519,22,1
873006,224871,375,76,33630,0,34005,76,1
3501677,4331579,33,5,127,0,160,5,1
1787075,4336912,894,58,28305,0,29199,58,1
159285,4670147,240,105,4650,0,4890,105,1
2961801,3489667,1483,335,101962,0,103445,335,1
427805,3563749,483,1,156906,0,157389,1,1
3638272,3935858,2022,1,370904,0,372926,1,1
3280389,3122232,1101,4,411419,0,412520,4,1
889433,4225842,170,84,3898,0,4068,84,1
1591435,614683,387,92,31245,0,31632,92,1
2827436,2685711,882,1,271525,0,272407,1,1
2002256,1432341,86,55,618,0,704,55,1
755739,4771574,1117,30,58043,0,59160,30,1
488817,1919568,12,930,283,967,295,1897,1
209136,854025,51,1,320,0,371,1,1
2281149,722665,282,14,28082,0,28364,14,1
2309618,2808697,980,61,5354,0,6334,61,1
3545321,1144792,239,9,4366,0,4605,9,1
2498087,1303350,1630,130,32582,0,34212,130,1
3836080,2874454,1197,8,59457,0,60654,8,1
1580988,2535368,2821,2,400133,0,402954,2,1
1015986,2815517,604,29,14201,0,14805,29,1
4552666,1582761,341,174,9279,0,9620,174,1
496280,1448332,131,299,115,129,246,428,1
2354110,2577869,360,180,1792,159,2152,339,1
2702724,996437,566,11,10448,0,11014,11,1
1778939,765291,248,807,937,0,1185,807,1
3280389,3355167,1101,2,411419,0,412520,2,1
78836,3155574,86,27,3525,0,3611,27,1
3509903,2857630,1530,2,509445,0,510975,2,1
911192,1025946,106,9,6327,0,6433,9,1
3509903,652663,1530,1,509445,0,510975,1,1
3715857,1878960,32,30,166,0,198,30,1
2226753,2614338,14,132,274,1078,288,1210,1
3361377,1527065,4841,9,761793,0,766634,9,1
2267633,3129096,422,29,13247,0,13669,29,1
3845119,3641550,461,76,28609,0,29070,76,1
2147720,3591560,1608,96,78786,0,80394,96,1
2793437,3463904,582,8,25447,0,26029,8,1
846208,3920924,600,10,17288,0,17888,10,1
6618,2231697,892,80,68849,0,69741,80,1
4416945,4104610,417,13,33228,0,33645,13,1
2001244,2437191,38,26,2115,0,2153,26,1
1779486,4261974,211,200,1444,1448,1655,1648,1
1580988,4723261,2821,4,400133,0,402954,4,1
517189,2451153,115,13,1511,0,1626,13,1
2405789,60216,1010,283,93387,0,94397,283,1
3684505,696662,358,91,1344,0,1702,91,1
4838376,4620770,606,20,26838,0,27444,20,1
3395938,2644095,546,38,39878,0,40424,38,1
3765475,811690,873,128,107914,0,108787,128,1
3112136,4103286,406,11,41366,0,41772,11,1
4313884,705605,68,4,864,0,932,4,1
1227855,1939437,157,228,4545,827,4702,1055,1
4496752,3037345,554,2,16258,0,16812,2,1
1557086,3765473,156,6,571,0,727,6,1
4191727,731198,463,50,26315,0,26778,50,1
4525161,1914503,28,13,184,0,212,13,1
2887240,4787272,1143,107,118405,0,119548,107,1
3514277,2945883,1338,266,13269,0,14607,266,1
2147720,2277120,1608,71,78786,0,80394,71,1
3638272,3330814,2022,2,370904,0,372926,2,1
1647518,4411050,15,1,217,0,232,1,1
2261139,1439477,2014,31,42851,0,44865,31,1
4803701,2576812,333,177,6414,0,6747,177,1
752618,2743105,169,2,5929,0,6098,2,1
3395938,869963,546,67,39878,0,40424,67,1
1580988,3496966,2821,2,400133,0,402954,2,1
2989110,2696452,1042,352,19283,0,20325,352,1
338208,160832,156,36,416,230,572,266,1
3638272,1432143,2022,19,370904,0,372926,19,1
2853969,2417639,1051,2,42591,0,43642,2,1
3115867,3193340,1350,2,61232,0,62582,2,1
502082,1264819,589,7,16428,0,17017,7,1
611151,3171703,44,217,383,0,427,217,1
1055530,2571747,415,60,14969,0,15384,60,1
3765475,851132,873,12,107914,0,108787,12,1
593740,759825,1107,35,62807,0,63914,35,1
3897604,4184742,6,15,120,0,126,15,1
2445252,1715274,125,40,1491,0,1616,40,1
530200,133201,2035,21,62809,0,64844,21,1
4103612,217970,932,20,5655,0,6587,20,1
866888,2826073,391,7,2049,0,2440,7,1
3650069,3799100,217,195,4118,0,4335,195,1
2702724,2150552,566,41,10448,0,11014,41,1
4382046,2237914,83,86,1321,0,1404,86,1
3957113,4383809,864,16,211,0,1075,16,1
1913445,2935979,564,45,47943,0,48507,45,1
1486813,4196815,19,103,157,0,176,103,1
4183953,3837964,13,1,324,0,337,1,1
2989322,412592,103,7,106,0,209,7,1
1233214,4352121,33,99,213,27,246,126,1
4853234,1658929,1256,6,29554,0,30810,6,1
1719848,2796578,252,27,3039,0,3291,27,1
4064346,1613183,195,76,1521,372,1716,448,1
4445029,255293,44,5,1042,0,1086,5,1
3079649,4863164,549,1,2116,0,2665,1,1
805360,2809240,1514,38,119306,0,120820,38,1
2395019,4127610,75,26,1352,0,1427,26,1
3361377,1067516,4841,1,761793,0,766634,1,1
4209323,981900,1630,27,89460,0,91090,27,1
2485529,231776,358,32,1375,0,1733,32,1
3124653,3660662,163,29,2005,0,2168,29,1
3935366,572263,377,132,3803,0,4180,132,1
748019,2328868,675,27,18480,0,19155,27,1
1468737,2800271,172,357,792,0,964,357,1
1875,4860397,656,2,61388,0,62044,2,1
610143,2365106,26,11,2000,0,2026,11,1
1196844,577916,548,1086,36289,0,36837,1086,1
2877907,4018449,508,108,16021,0,16529,108,1
2498087,4329043,1630,69,32582,0,34212,69,1
1201711,3654642,357,203,15948,0,16305,203,1
3225310,1618269,320,107,10537,0,10857,107,1
1581769,1933244,75,1,407,0,482,1,1
2104619,2256444,197,3,694,0,891,3,1
2877907,3035003,508,57,16021,0,16529,57,1
688537,2687987,94,99,1363,0,1457,99,1
2255162,4821281,92,105,1209,0,1301,105,1
3509903,1316007,1530,6,509445,0,510975,6,1
4209323,385707,1630,9,89460,0,91090,9,1
2209136,4723899,620,140,33789,0,34409,140,1
4681898,2238932,45,6,320,0,365,6,1
4751453,4332297,520,263,27570,0,28090,263,1
530200,1977385,2035,15,62809,0,64844,15,1
1580988,4404912,2821,61,400133,0,402954,61,1
3264759,3793304,24,1,61,0,85,1,1
3395938,3029675,546,34,39878,0,40424,34,1
4416945,454913,417,36,33228,0,33645,36,1
4727207,1522146,925,2,84581,0,85506,2,1
3875114,4369554,233,415,3154,0,3387,415,1
3683235,1641147,311,53,23110,0,23421,53,1
2827436,3480806,882,1,271525,0,272407,1,1
214631,416281,319,489,2590,0,2909,489,1
1015986,2670559,604,45,14201,0,14805,45,1
2075015,3370954,2664,73,85781,0,88445,73,1
4295952,1190790,808,18,57369,0,58177,18,1
4202576,357862,600,1,10697,0,11297,1,1
2231398,814961,50,28,1992,0,2042,28,1
3361377,496509,4841,4,761793,0,766634,4,1
2031305,1902641,396,14,23435,0,23831,14,1
1928928,465138,169,108,5084,0,5253,108,1
2589492,722928,129,50,179,0,308,50,1
282129,1805276,146,33,2112,0,2258,33,1
4360960,2670113,1642,31,110084,0,111726,31,1
2827436,2247214,882,1,271525,0,272407,1,1
4334842,4680781,85,9,4749,0,4834,9,1
2893334,612999,889,66,30148,0,31037,66,1
3361377,104800,4841,62,761793,0,766634,62,1
3065808,77191,1235,16,82317,0,83552,16,1
4192206,1317789,468,68,18229,0,18697,68,1
3280389,4098732,1101,1,411419,0,412520,1,1
1138515,1934493,341,197,12443,0,12784,197,1
4360960,872638,1642,43,110084,0,111726,43,1
3758692,3634001,711,64,34731,0,35442,64,1
1609659,1476562,523,209,29763,0,30286,209,1
2260014,3282475,2466,82,98622,0,101088,82,1
636814,2289731,116,1,9387,0,9503,1,1
3398118,3984250,49,247,1466,0,1515,247,1
3514446,2144603,92,233,3233,0,3325,233,1
2310300,2672203,229,2,1157,0,1386,2,1
3509903,1761958,1530,59,509445,0,510975,59,1
4680108,4154903,49,34,1965,0,2014,34,1
4440160,1084607,736,178,20522,0,21258,178,1
1317294,2491198,89,1,7800,0,7889,1,1
4012878,2288799,50,6,1271,0,1321,6,1
3395938,2543294,546,202,39878,0,40424,202,1
57574,3898053,289,5,4616,0,4905,5,1
1588330,1259401,694,226,10280,0,10974,226,1
1777808,2312941,211,231,3413,0,3624,231,1
1580988,3645959,2821,2,400133,0,402954,2,1
3654276,982958,153,9,3512,0,3665,9,1
2636494,2070442,36,76,793,0,829,76,1
3699986,3896595,189,165,1282,2165,1471,2330,1
345047,2349062,111,102,2534,0,2645,102,1
3638272,1773892,2022,1,370904,0,372926,1,1
1148578,4763936,246,387,2567,0,2813,387,1
1763353,1934600,126,3,10072,0,10198,3,1
1102748,3238878,555,83,6504,0,7059,83,1
805360,4235105,1514,108,119306,0,120820,108,1
3765475,13264,873,1,107914,0,108787,1,1
941212,431086,184,619,6404,14910,6588,15529,1
532681,2414327,433,26,35023,0,35456,26,1
2147720,2168602,1608,34,78786,0,80394,34,1
2494800,1073717,752,7,5329,0,6081,7,1
4782707,1241856,513,149,31665,0,32178,149,1
1545237,1444843,381,9,14327,0,14708,9,1
991610,4553033,281,128,1539,1503,1820,1631,1
1243368,1138195,319,39,5045,0,5364,39,1
1880135,3197253,810,209,71924,0,72734,209,1
2005731,4592747,76,730,1036,0,1112,730,1
1225988,977334,157,11,8881,0,9038,11,1
2190840,4843012,8,4,75,0,83,4,1
3092943,1160173,352,155,2435,0,2787,155,1
1541866,4512741,542,123,16481,0,17023,123,1
1549334,4465279,81,3,6693,0,6774,3,1
1847461,1737387,1211,47,51149,0,52360,47,1
2751572,1015743,481,67,44036,0,44517,67,1
307250,2009141,919,1,35588,0,36507,1,1
2897926,1128722,565,100,25983,0,26548,100,1
2247657,4203371,306,65,7138,0,7444,65,1
4467148,4351124,9,627,63,39,72,666,1
4629176,2564163,2058,9,9211,0,11269,9,1
185943,1919631,620,185,6573,2750,7193,2935,1
1839283,3008182,765,103,36658,0,37423,103,1
1541866,4219869,542,286,16481,0,17023,286,1
1301815,3085164,752,35,48944,0,49696,35,1
2221652,3366743,47,9,387,0,434,9,1
4360960,4545326,1642,16,110084,0,111726,16,1
3684505,4457463,358,23,1344,0,1702,23,1
3509903,19227,1530,15,509445,0,510975,15,1
3866441,733180,261,111,3655,0,3916,111,1
3871554,4345608,947,234,16042,2526,16989,2760,1
2721412,1461053,273,45,2733,0,3006,45,1
6618,1093919,892,350,68849,0,69741,350,1
1225988,4505078,157,335,8881,0,9038,335,1
1328699,2594785,83,4,1943,0,2026,4,1
1603899,422484,497,217,5551,0,6048,217,1
2147720,546195,1608,42,78786,0,80394,42,1
2981537,3691837,1252,32,118718,0,119970,32,1
4788253,4595442,364,217,3550,568,3914,785,1
3844858,3447114,1591,16,28974,0,30565,16,1
2109216,3338056,386,24,4712,0,5098,24,1
4257751,2267210,109,2,8420,0,8529,2,1
2261139,1576565,2014,15,42851,0,44865,15,1
3676295,2823353,374,1,70881,0,71255,1,1
3509903,4177376,1530,1,509445,0,510975,1,1
2779329,4703692,217,141,6021,0,6238,141,1
2841828,1370607,106,23,2223,0,2329,23,1
3438576,1919117,3424,17,137753,0,141177,17,1
127479,1582727,94,117,329,0,423,117,1
1580988,2923534,2821,10,400133,0,402954,10,1
3638272,1348345,2022,31,370904,0,372926,31,1
2981537,3545076,1252,50,118718,0,119970,50,1
1367688,4696176,101,521,557,201,658,722,1
2502456,4230823,719,96,50725,0,51444,96,1
3137585,202094,1196,38,77354,0,78550,38,1
4853234,446284,1256,2,29554,0,30810,2,1
858791,2556505,110,186,2663,0,2773,186,1
2199247,4070260,61,3,1954,0,2015,3,1
3095050,2668236,364,3,3358,0,3722,3,1
3361377,861298,4841,1,761793,0,766634,1,1
3186537,431679,14,2,104,0,118,2,1
2341282,1139041,36,573,401,0,437,573,1
1787075,4382428,894,7,28305,0,29199,7,1
3509903,3557544,1530,307,509445,0,510975,307,1
408965,4680509,903,45,38623,0,39526,45,1
2502456,3662199,719,17,50725,0,51444,17,1
4528103,3128696,268,8,14258,0,14526,8,1
1471685,578305,1681,27,25550,0,27231,27,1
1717922,3650069,432,217,6340,4118,6772,4335,1
3742930,340169,410,13,22242,0,22652,13,1
2736770,2136250,55,6,1047,0,1102,6,1
443309,4862505,100,1,1783,0,1883,1,1
653164,3159257,106,16,1488,0,1594,16,1
3549674,4351247,602,94,38542,0,39144,94,1
2529661,2095167,493,59,27309,0,27802,59,1
3676295,2198697,374,1,70881,0,71255,1,1
3115867,2020575,1350,10,61232,0,62582,10,1
3509903,1953745,1530,1,509445,0,510975,1,1
6618,2021595,892,12,68849,0,69741,12,1
1787075,18586,894,59,28305,0,29199,59,1
431086,3121295,619,1277,14910,0,15529,1277,1
3248738,449978,102,51,4433,0,4535,51,1
1114725,3667074,76,909,674,0,750,909,1
1579729,4401915,176,633,1152,0,1328,633,1
2267633,4384872,422,41,13247,0,13669,41,1
837553,4645084,1249,26,61665,0,62914,26,1
2513691,2918842,244,32,17485,0,17729,32,1
1241907,4574494,176,73,1602,0,1778,73,1
3040778,1237696,47,24,1977,0,2024,24,1
2785706,2491905,130,92,1838,0,1968,92,1
4423184,3318847,384,2,29809,0,30193,2,1
320344,3839906,351,1,3831,0,4182,1,1
1331940,2302968,802,3,32617,0,33419,3,1
3638272,3750462,2022,1,370904,0,372926,1,1
3698287,282237,22,6,242,0,264,6,1
1580988,2318605,2821,1,400133,0,402954,1,1
4319972,4467395,640,2084,35279,14574,35919,16658,1
3509903,1880730,1530,1,509445,0,510975,1,1
2260014,120743,2466,29,98622,0,101088,29,1
3916976,3028942,188,8,6098,0,6286,8,1
1639434,3574203,587,138,8053,0,8640,138,1
4678614,997502,452,2,16881,0,17333,2,1
893927,1061552,109,7,1645,0,1754,7,1
521586,3202267,782,42,18489,0,19271,42,1
4860485,1578030,89,124,3655,0,3744,124,1
2922412,3810760,464,13,3629,0,4093,13,1
4494577,4800082,92,29,1053,0,1145,29,1
1024144,1782079,368,8,76,0,444,8,1
3094886,564644,675,16,6621,0,7296,16,1
3509903,3146151,1530,2,509445,0,510975,2,1
3068881,793426,38,13,228,0,266,13,1
1032137,1556337,86,1177,256,585,342,1762,1
4395281,3469803,49,20,145,0,194,20,1
1719848,592320,252,1,3039,0,3291,1,1
4384375,1595540,129,58,4747,0,4876,58,1
3438576,4011208,3424,122,137753,0,141177,122,1
2261139,892024,2014,117,42851,0,44865,117,1
3172610,4739162,34,1,2000,0,2034,1,1
3115867,1457783,1350,66,61232,0,62582,66,1
873006,3424203,375,37,33630,0,34005,37,1
3914135,780521,2152,4,60084,0,62236,4,1
1234540,1772705,1071,8,75251,0,76322,8,1
2130979,3499704,452,111,4717,0,5169,111,1
516562,2905200,70,277,812,0,882,277,1
4738916,2083575,1165,1,34124,0,35289,1,1
1031334,2069396,459,216,16840,0,17299,216,1
2976684,1890872,257,17,3759,0,4016,17,1
681618,2372822,75,1,8789,0,8864,1,1
687713,3733568,436,10,47160,0,47596,10,1
2897926,3799091,565,6,25983,0,26548,6,1
2195890,986936,134,154,5208,0,5342,154,1
4464777,4705188,178,336,1410,8658,1588,8994,1
1179906,3342670,316,343,14467,0,14783,343,1
3438576,2919767,3424,32,137753,0,141177,32,1
339563,3276834,1999,142,7561,1026,9560,1168,1
3438576,3950994,3424,13,137753,0,141177,13,1
273363,824343,768,121,11045,0,11813,121,1
1234540,4595721,1071,19,75251,0,76322,19,1
4858131,2974316,45,4,1083,0,1128,4,1
1722972,1329780,235,783,3572,0,3807,783,1
378943,232825,340,252,12563,0,12903,252,1
3396550,2864935,77,19,221,0,298,19,1
3065808,4159919,1235,41,82317,0,83552,41,1
3361377,2559815,4841,1,761793,0,766634,1,1
3361377,4009753,4841,1,761793,0,766634,1,1
4360960,1207194,1642,43,110084,0,111726,43,1
1580988,4006302,2821,2,400133,0,402954,2,1
57574,2006448,289,60,4616,0,4905,60,1
2147720,95421,1608,11,78786,0,80394,11,1
1161799,1494965,92,38,345,0,437,38,1
3361377,2242451,4841,1,761793,0,766634,1,1
2339149,4654129,97,102,4258,0,4355,102,1
571147,604156,364,17,5484,0,5848,17,1
781211,4224425,976,12,51781,0,52757,12,1
2998026,873396,919,1,24182,0,25101,1,1
2343253,3702924,1882,9,86401,0,88283,9,1
2490914,4418896,570,40,22965,0,23535,40,1
3509903,3228459,1530,1,509445,0,510975,1,1
3638272,1147047,2022,2,370904,0,372926,2,1
1880135,1872344,810,6,71924,0,72734,6,1
515290,2947910,285,8,34080,0,34365,8,1
2854744,2584855,92,27,1158,0,1250,27,1
2075015,114872,2664,44,85781,0,88445,44,1
765601,3295726,1485,59,101510,0,102995,59,1
2841394,2249304,159,6,3045,0,3204,6,1
2827436,2643434,882,122,271525,0,272407,122,1
25871,2351427,214,34,1848,0,2062,34,1
4220190,4638564,320,25,15994,0,16314,25,1
4327096,1485628,234,11,2944,0,3178,11,1
3638272,2934783,2022,1,370904,0,372926,1,1
489584,1119475,421,24,12098,0,12519,24,1
595757,547568,340,7,26738,0,27078,7,1
1777298,3470118,468,6,6381,0,6849,6,1
1333761,2781333,193,100,5573,0,5766,100,1
3438576,1692852,3424,26,137753,0,141177,26,1
2405789,2451703,1010,57,93387,0,94397,57,1
259575,531785,260,3,13949,0,14209,3,1
446533,2003573,243,122,2507,0,2750,122,1
4656799,1030992,187,577,2411,0,2598,577,1
1539837,4215202,1127,57,62979,0,64106,57,1
687713,3359868,436,8,47160,0,47596,8,1
875909,3689484,118,245,3602,0,3720,245,1
3781638,300444,202,253,550,0,752,253,1
1803007,2425245,90,23,1999,0,2089,23,1
2851109,1012747,450,2,98552,0,99002,2,1
2502456,3368151,719,44,50725,0,51444,44,1
4021290,2155174,5,5,199,0,204,5,1
3361377,3449201,4841,2,761793,0,766634,2,1
3985008,3172422,44,62,148,0,192,62,1
2191194,298625,21,89,2190,0,2211,89,1
4641044,2650511,300,10,1842,0,2142,10,1
2592965,4710628,567,43,1811,0,2378,43,1
2281149,2677220,282,31,28082,0,28364,31,1
687713,1346350,436,1,47160,0,47596,1,1
1213040,3251599,39,4,716,0,755,4,1
1637447,2124284,555,602,8549,0,9104,602,1
4191727,3604103,463,276,26315,0,26778,276,1
3280389,4556634,1101,7,411419,0,412520,7,1
1370197,2242186,665,10,3306,0,3971,10,1
4423184,4259678,384,9,29809,0,30193,9,1
2163640,4443098,129,260,5750,0,5879,260,1
2529661,4760257,493,49,27309,0,27802,49,1
1833769,4253233,27,7,114,0,141,7,1
2757156,3048908,237,158,8153,0,8390,158,1
4219266,1973663,85,57,3252,0,3337,57,1
2879897,2189596,164,114,3212,0,3376,114,1
3144238,1989101,326,32,28455,0,28781,32,1
3438576,469005,3424,6,137753,0,141177,6,1
1722972,403709,235,1,3572,0,3807,1,1
1815739,526798,248,929,6590,0,6838,929,1
1575009,2985324,429,4,37745,0,38174,4,1
1591435,1445716,387,111,31245,0,31632,111,1
2453249,3103177,42,2,587,0,629,2,1
3671141,1288167,1444,8,48400,0,49844,8,1
4330391,3741724,773,59,32759,0,33532,59,1
4785101,2717469,150,5,1988,0,2138,5,1
2295029,2893056,32,22,348,0,380,22,1
1903752,933738,506,223,10494,0,11000,223,1
4238001,72462,869,111,61161,0,62030,111,1
2516076,1591982,1455,2,77782,0,79237,2,1
2569009,3011950,424,88,13423,0,13847,88,1
3116723,2117417,194,114,4798,0,4992,114,1
3125762,3756973,254,1,8285,0,8539,1,1
2237068,2022684,211,260,2206,0,2417,260,1
515290,3139399,285,11,34080,0,34365,11,1
354904,4361226,3193,20,105780,0,108973,20,1
3638272,4753813,2022,3,370904,0,372926,3,1
3361377,352023,4841,2,761793,0,766634,2,1
3701625,391716,86,2,2327,0,2413,2,1
3395938,4090995,546,16,39878,0,40424,16,1
3509903,1066049,1530,1,509445,0,510975,1,1
3361377,2314281,4841,172,761793,0,766634,172,1
2611624,696502,105,362,4088,0,4193,362,1
4727207,177463,925,41,84581,0,85506,41,1
159285,2349450,240,9,4650,0,4890,9,1
499414,4434869,316,170,3543,247,3859,417,1
148308,3901020,15,5,1948,0,1963,5,1
2713411,1087731,384,8,4637,0,5021,8,1
873241,3384159,616,415,22633,6659,23249,7074,1
4287945,2835239,36,194,69,443,105,637,1
4374509,2463253,770,61,9940,0,10710,61,1
4547438,2245992,1291,56,25237,0,26528,56,1
687713,917975,436,208,47160,0,47596,208,1
3966421,2528174,104,14,1999,0,2103,14,1
3638272,3368515,2022,1,370904,0,372926,1,1
60980,1555792,649,3,20708,0,21357,3,1
3294702,2809164,991,61,68888,0,69879,61,1
1310800,3425244,200,10,6100,0,6300,10,1
3438576,2275714,3424,51,137753,0,141177,51,1
2950311,3529750,807,15,85116,0,85923,15,1
3214323,4458984,147,85,12543,0,12690,85,1
3140664,430393,268,3,16099,0,16367,3,1
1621606,3190653,559,54,4228,0,4787,54,1
2075015,687400,2664,13,85781,0,88445,13,1
3085500,2378498,25,1,136,0,161,1,1
2336530,1359393,250,104,1103,96,1353,200,1
1103332,4510816,732,41,59415,0,60147,41,1
3765475,2432074,873,12,107914,0,108787,12,1
2827436,4399378,882,2,271525,0,272407,2,1
3280389,3020012,1101,1,411419,0,412520,1,1
584906,2508288,253,57,6639,0,6892,57,1
4816740,856431,141,6,7750,0,7891,6,1
3023130,3866659,778,97,6402,0,7180,97,1
4295952,2678972,808,44,57369,0,58177,44,1
1984622,3849481,145,51,20659,0,20804,51,1
655379,3125411,23,93,400,0,423,93,1
2961552,928784,562,33,16546,0,17108,33,1
135188,2835054,51,1,5860,0,5911,1,1
1549334,3914188,81,23,6693,0,6774,23,1
2950311,4010033,807,209,85116,0,85923,209,1
2087003,1814947,402,17,4405,0,4807,17,1
2887240,2013614,1143,4,118405,0,119548,4,1
2261139,3660318,2014,73,42851,0,44865,73,1
2981537,877396,1252,8,118718,0,119970,8,1
4708835,1222509,190,2,7539,0,7729,2,1
474172,474149,471,37,38713,0,39184,37,1
3438576,2482264,3424,38,137753,0,141177,38,1
3509903,3671481,1530,130,509445,0,510975,130,1
3509903,716802,1530,1,509445,0,510975,1,1
2346646,719653,101,3,2267,0,2368,3,1
2872979,3068869,341,20,28510,0,28851,20,1
1733957,810787,554,22,15185,0,15739,22,1
3108468,4127272,13,66,14,0,27,66,1
3280389,2278301,1101,1,411419,0,412520,1,1
483251,4410560,154,1,5257,0,5411,1,1
3280389,1590910,1101,1,411419,0,412520,1,1
462298,1440517,414,58,10933,0,11347,58,1
4099957,3976714,129,46,1096,0,1225,46,1
837459,4245752,82,192,882,0,964,192,1
3509903,3677472,1530,1,509445,0,510975,1,1
652717,2632613,1,158,190,0,191,158,1
1580988,1857204,2821,4,400133,0,402954,4,1
3509903,3957263,1530,2,509445,0,510975,2,1
573101,3729984,781,289,12750,0,13531,289,1
575638,1752071,363,175,3219,1035,3582,1210,1
1317294,837815,89,57,7800,0,7889,57,1
1580988,3321730,2821,2,400133,0,402954,2,1
2981537,2667338,1252,3,118718,0,119970,3,1
3395853,3771698,252,21,3685,0,3937,21,1
307250,4546358,919,13,35588,0,36507,13,1
2962038,283819,495,1,14236,0,14731,1,1
612450,2680478,94,7,547,0,641,7,1
3638272,3498730,2022,1,370904,0,372926,1,1
3842148,4502679,719,156,11430,0,12149,156,1
4191410,710513,1590,62,96434,0,98024,62,1
932720,4690747,1411,60,111323,0,112734,60,1
1163500,3523367,398,75,9540,0,9938,75,1
3088808,3564952,227,26,7820,0,8047,26,1
2827436,3681201,882,2,271525,0,272407,2,1
1281003,107885,363,41,2000,0,2363,41,1
932720,3212649,1411,4,111323,0,112734,4,1
2470160,3630279,103,8,4362,0,4465,8,1
320344,2544808,351,2,3831,0,4182,2,1
544230,4260311,1532,253,60768,0,62300,253,1
3509903,4239116,1530,3,509445,0,510975,3,1
1575009,3200399,429,32,37745,0,38174,32,1
2345261,1405073,92,19,1694,0,1786,19,1
280171,1817055,232,6,3378,0,3610,6,1
2209136,3871203,620,102,33789,0,34409,102,1
3936039,3740168,799,5,23884,0,24683,5,1
1609659,4768837,523,32,29763,0,30286,32,1
2713411,1982267,384,3,4637,0,5021,3,1
1276253,1236877,407,1,46534,0,46941,1,1
2405789,2291912,1010,6,93387,0,94397,6,1
427805,1872610,483,1,156906,0,157389,1,1
3873768,4806484,449,96,35424,0,35873,96,1
1277482,2435911,73,7,564,0,637,7,1
4656285,2394682,1446,69,35428,0,36874,69,1
1301815,1615967,752,23,48944,0,49696,23,1
748019,924621,675,92,18480,0,19155,92,1
3509903,4383906,1530,2,509445,0,510975,2,1
3844858,486068,1591,505,28974,0,30565,505,1
3787285,744217,28,13,591,0,619,13,1
2887240,1637992,1143,6,118405,0,119548,6,1
3115867,4336809,1350,7,61232,0,62582,7,1
1301815,574616,752,24,48944,0,49696,24,1
3361377,996636,4841,1,761793,0,766634,1,1
3361377,2247698,4841,1,761793,0,766634,1,1
955464,3426941,26,77,146,552,172,629,1
4750855,2987582,355,253,18880,0,19235,253,1
886382,2567151,131,216,243,887,374,1103,1
4803701,755739,333,1117,6414,58043,6747,59160,1
3225310,3788358,320,119,10537,0,10857,119,1
851438,598922,103,144,1994,0,2097,144,1
1521082,1135735,766,5,6562,0,7328,5,1
2853969,4574188,1051,1,42591,0,43642,1,1
1117077,3006251,28,131,467,0,495,131,1
4653941,1235949,951,6,45883,0,46834,6,1
3361377,3406022,4841,1,761793,0,766634,1,1
3509903,1887813,1530,28,509445,0,510975,28,1
4201,271364,128,1541,1989,171,2117,1712,1
4451491,4739503,817,67,8836,0,9653,67,1
2338082,2174109,138,12,3081,0,3219,12,1
907654,302847,798,117,24575,0,25373,117,1
3361377,3245691,4841,1,761793,0,766634,1,1
1196403,2596109,363,154,2062,0,2425,154,1
1020529,519420,489,291,2075,0,2564,291,1
4261974,4125527,200,305,1448,1880,1648,2185,1
3070589,4685355,280,2,4483,0,4763,2,1
3509903,2615005,1530,1,509445,0,510975,1,1
1139873,1800577,670,40,10236,0,10906,40,1
1277656,1867570,65,1,480,0,545,1,1
276502,775768,30,104,2245,0,2275,104,1
544230,2410225,1532,40,60768,0,62300,40,1
3137585,4803682,1196,76,77354,0,78550,76,1
4011264,880097,1360,56,116777,0,118137,56,1
932720,2669284,1411,48,111323,0,112734,48,1
3280389,3832473,1101,1,411419,0,412520,1,1
4144305,34372,50,349,338,166,388,515,1
3255990,3023881,170,1035,583,996,753,2031,1
3419989,2584359,350,46,16316,0,16666,46,1
576373,41426,54,289,751,0,805,289,1
2897926,2232520,565,110,25983,0,26548,110,1
3764177,2425152,1036,43,64563,0,65599,43,1
2985909,2219780,706,69,43348,0,44054,69,1
4140279,3591351,337,81,49384,0,49721,81,1
4384375,4564156,129,45,4747,0,4876,45,1
3361377,3584390,4841,2,761793,0,766634,2,1
3361377,1240065,4841,1,761793,0,766634,1,1
974650,3858074,114,9,1990,0,2104,9,1
1875,2975820,656,40,61388,0,62044,40,1
3361377,2442836,4841,14,761793,0,766634,14,1
3280389,1887186,1101,1,411419,0,412520,1,1
1926532,2065388,336,10,9127,0,9463,10,1
4011264,4592926,1360,122,116777,0,118137,122,1
2260014,3855002,2466,30,98622,208,101088,238,1
4213976,1272404,355,7,902,0,1257,7,1
2516076,1063358,1455,1350,77782,63494,79237,64844,1
4209323,1881243,1630,61,89460,0,91090,61,1
570984,4650764,430,274,4607,0,5037,274,1
1633022,639114,246,1,23530,0,23776,1,1
3291145,917557,105,146,4218,0,4323,146,1
1580988,4500904,2821,2,400133,0,402954,2,1
226540,4155982,463,45,10650,0,11113,45,1
3280389,3272074,1101,4,411419,0,412520,4,1
3115867,3583411,1350,5,61232,0,62582,5,1
3764177,2578204,1036,67,64563,0,65599,67,1
97028,3317107,619,58,8923,0,9542,58,1
2818749,3099066,92,81,3797,0,3889,81,1
4117427,681952,329,120,9639,0,9968,120,1
312363,2681739,71,65,138,271,209,336,1
1610278,1855516,230,132,1608,0,1838,132,1
703912,3709924,119,4,5153,0,5272,4,1
940526,4434460,475,1,20786,0,21261,1,1
3460849,3086931,216,597,2518,0,2734,597,1
3065808,2557053,1235,18,82317,0,83552,18,1
4191410,4198903,1590,66,96434,0,98024,66,1
2853969,3632042,1051,34,42591,0,43642,34,1
1250021,2381056,4637,2,85913,0,90550,2,1
2260014,535217,2466,14,98622,0,101088,14,1
2772113,3415257,792,63,42907,0,43699,63,1
4619326,4008147,539,30,22721,0,23260,30,1
2498087,1728720,1630,25,32582,0,34212,25,1
3954325,2035185,1743,9,16616,0,18359,9,1
3235479,823187,999,142,66486,0,67485,142,1
4843360,3605226,355,111,7866,0,8221,111,1
3361377,4433162,4841,2,761793,0,766634,2,1
2911269,1184324,740,39,20606,0,21346,39,1
1445377,4351908,95,511,2001,0,2096,511,1
2490914,3364892,570,19,22965,0,23535,19,1
2893334,3682079,889,16,30148,0,31037,16,1
4342519,2152929,138,443,11317,0,11455,443,1
3361377,4504198,4841,1,761793,0,766634,1,1
3438576,113150,3424,4,137753,0,141177,4,1
1875,1111351,656,30,61388,0,62044,30,1
3225310,620624,320,312,10537,0,10857,312,1
4195490,2054697,47,45,1105,0,1152,45,1
515290,4276210,285,71,34080,0,34365,71,1
3361377,4570817,4841,1,761793,0,766634,1,1
4140279,4679883,337,1,49384,0,49721,1,1
4360960,4130482,1642,39,110084,0,111726,39,1
1580988,4185386,2821,49,400133,0,402954,49,1
3280389,2739934,1101,2,411419,0,412520,2,1
1040877,628351,51,333,478,4229,529,4562,1
1984622,4076607,145,1,20659,0,20804,1,1
1676923,515258,250,38,1988,0,2238,38,1
2721412,869051,273,27,2733,0,3006,27,1
521586,197024,782,34,18489,0,19271,34,1
1697778,4214145,125,4,3760,0,3885,4,1
3871554,122963,947,135,16042,0,16989,135,1
1591435,1493693,387,25,31245,0,31632,25,1
860409,3100603,38,3,2413,0,2451,3,1
1327939,1208549,65,84,48,187,113,271,1
2260014,3493291,2466,1,98622,0,101088,1,1
3873768,2195343,449,136,35424,0,35873,136,1
97028,3438576,619,3424,8923,137753,9542,141177,1
2476549,4036558,266,81,3070,0,3336,81,1
1615261,4467193,955,30,12715,0,13670,30,1
3438576,3612286,3424,4,137753,0,141177,4,1
256934,4259492,287,51,11635,0,11922,51,1
89979,3871554,65,947,658,16042,723,16989,1
2148937,663931,672,1,47361,0,48033,1,1
2981537,1841152,1252,3,118718,0,119970,3,1
3288730,2759687,117,63,4627,0,4744,63,1
1927211,3102873,1668,341,113322,15098,114990,15439,1
3549674,1058032,602,109,38542,0,39144,109,1
4295952,1040749,808,48,57369,0,58177,48,1
3115867,2063041,1350,238,61232,0,62582,238,1
4816740,17658,141,115,7750,0,7891,115,1
427805,3663168,483,9,156906,0,157389,9,1
2851109,1955495,450,3,98552,0,99002,3,1
3065808,1870577,1235,79,82317,0,83552,79,1
1541866,2560514,542,17,16481,0,17023,17,1
3088808,4735853,227,29,7820,0,8047,29,1
2800745,1051606,34,13,129,0,163,13,1
3462923,1396803,369,271,817,0,1186,271,1
354904,319135,3193,22,105780,0,108973,22,1
2355092,4457442,30,41,2544,0,2574,41,1
2260014,2637902,2466,13,98622,0,101088,13,1
529424,2007491,39,803,447,0,486,803,1
2827436,4211046,882,32,271525,0,272407,32,1
2886330,3046452,415,13,10154,0,10569,13,1
1276253,395766,407,1,46534,0,46941,1,1
1763353,2361862,126,1,10072,0,10198,1,1
4008078,1591206,44,4,40,33,84,37,1
4360960,1179245,1642,10,110084,0,111726,10,1
4777127,325789,53,1,2347,0,2400,1,1
4642569,4660337,872,152,27586,0,28458,152,1
3871554,2571898,947,23,16042,0,16989,23,1
4856623,2885693,125,123,1815,0,1940,123,1
544230,3527356,1532,1,60768,0,62300,1,1
4266665,2256060,91,36,1894,0,1985,36,1
1887148,4313160,189,81,672,0,861,81,1
4179343,4373873,119,8,9822,0,9941,8,1
765601,194599,1485,67,101510,0,102995,67,1
2199673,2142510,118,58,2496,0,2614,58,1
3137900,1406521,357,3,6655,0,7012,3,1
2164178,369537,574,90,6134,0,6708,90,1
765601,2825118,1485,92,101510,0,102995,92,1
4853234,4834903,1256,16,29554,0,30810,16,1
1064989,3603321,140,26,1201,0,1341,26,1
491505,1173242,202,50,546,0,748,50,1
3842148,2793360,719,177,11430,0,12149,177,1
786311,1559950,32,382,18,1524,50,1906,1
155821,35868,117,16,5678,0,5795,16,1
595757,1115667,340,310,26738,0,27078,310,1
3502325,4389781,93,33,1096,166,1189,199,1
1317294,3239528,89,1,7800,0,7889,1,1
3814106,2773593,163,9,1144,0,1307,9,1
3742930,2518122,410,23,22242,0,22652,23,1
3936039,137947,799,70,23884,0,24683,70,1
3071504,4629260,80,93,3797,0,3877,93,1
2516076,4408724,1455,30,77782,0,79237,30,1
3438576,3041180,3424,2,137753,0,141177,2,1
3361377,2502566,4841,1,761793,0,766634,1,1
1777808,3074566,211,55,3413,0,3624,55,1
2093446,1231051,4,4,78,0,82,4,1
4838376,406502,606,42,26838,0,27444,42,1
4730895,1927211,125,1668,1911,113322,2036,114990,1
522588,2978297,496,130,20091,0,20587,130,1
3280389,391055,1101,2,411419,0,412520,2,1
2147720,3808242,1608,31,78786,0,80394,31,1
1062967,4787628,260,14,15276,0,15536,14,1
259575,2972986,260,135,13949,0,14209,135,1
3509903,3223774,1530,3,509445,0,510975,3,1
431086,2249551,619,3,14910,0,15529,3,1
1552756,1005989,7,1,24,0,31,1,1
4563259,4572141,136,32,4740,0,4876,32,1
3707352,1293807,144,1837,5112,30865,5256,32702,1
4360960,2128195,1642,56,110084,0,111726,56,1
3264857,3473478,17,11,86,0,103,11,1
3842148,4088988,719,93,11430,0,12149,93,1
2158267,711396,62,130,692,0,754,130,1
2827436,562367,882,2,271525,0,272407,2,1
1436174,1547545,105,1,9512,0,9617,1,1
1887669,893440,733,45,23145,0,23878,45,1
940526,3412543,475,4,20786,0,21261,4,1
907654,3341068,798,192,24575,0,25373,192,1
1534362,2488010,1531,208,105859,0,107390,208,1
530200,3715085,2035,27,62809,0,64844,27,1
2107861,942786,535,17,25743,0,26278,17,1
4710065,755739,41,1117,225,58043,266,59160,1
1822719,147154,285,14,22351,0,22636,14,1
1103332,3162070,732,65,59415,0,60147,65,1
3922194,2721412,175,273,1847,2733,2022,3006,1
1276253,1811942,407,1,46534,0,46941,1,1
2887240,2335903,1143,15,118405,0,119548,15,1
2278719,953685,107,294,786,1000,893,1294,1
3361377,2091180,4841,4,761793,0,766634,4,1
842615,3774090,510,201,12316,0,12826,201,1
2496454,3364382,320,85,2769,0,3089,85,1
4624595,263860,722,3,53368,0,54090,3,1
2417353,1979390,37,28,139,0,176,28,1
4417253,1625896,1130,24,68389,0,69519,24,1
4209323,4461433,1630,55,89460,0,91090,55,1
2412131,2783010,119,24,1767,0,1886,24,1
2851109,1170129,450,2,98552,0,99002,2,1
2890380,3730785,78,51,255,0,333,51,1
1528477,1761432,9,526,103,3381,112,3907,1
4296372,767094,33,7,686,0,719,7,1
3361377,1587420,4841,1,761793,0,766634,1,1
4411870,2812155,948,79,60517,0,61465,79,1
307250,4049784,919,2,35588,0,36507,2,1
1431189,4670884,167,9,3075,0,3242,9,1
3638272,4340719,2022,1,370904,0,372926,1,1
3361377,486564,4841,1,761793,0,766634,1,1
2948092,2461760,412,162,18486,0,18898,162,1
2540979,1702872,245,7,1451,0,1696,7,1
2157608,117186,50,29,528,0,578,29,1
2827436,1296462,882,1,271525,0,272407,1,1
3424598,89635,30,29,341,0,371,29,1
4715501,3154815,176,1,1688,0,1864,1,1
4539039,299927,35,2,5584,0,5619,2,1
474172,4341830,471,53,38713,0,39184,53,1
3764177,1655484,1036,66,64563,0,65599,66,1
3257653,4333234,100,3,5222,0,5322,3,1
1843507,2421009,537,3,11729,0,12266,3,1
510245,493306,38,9,757,0,795,9,1
1600857,2246509,324,2,10576,0,10900,2,1
2498087,2143465,1630,213,32582,0,34212,213,1
3671141,1875089,1444,55,48400,0,49844,55,1
1580988,663754,2821,1,400133,0,402954,1,1
790848,3805685,196,21,957,0,1153,21,1
3395938,3927503,546,8,39878,0,40424,8,1
1345777,3065504,187,12,1667,0,1854,12,1
4853234,4173883,1256,1,29554,0,30810,1,1
3280389,4546025,1101,8,411419,0,412520,8,1
860473,4673478,751,4,20450,0,21201,4,1
2698749,847669,108,3,2511,0,2619,3,1
4302921,1553389,509,5,13289,0,13798,5,1
4744878,839182,68,89,1896,0,1964,89,1
1836049,4164625,13,3,160,0,173,3,1
987626,1838271,238,849,1743,0,1981,849,1
2752145,2399401,79,73,1888,0,1967,73,1
4272102,3222336,1608,122,104171,0,105779,122,1
386424,1015918,131,57,7871,0,8002,57,1
414608,1784309,50,25,5531,0,5581,25,1
3836080,198484,1197,44,59457,0,60654,44,1
307250,557802,919,2,35588,0,36507,2,1
2376170,1644309,42,29,1086,0,1128,29,1
2260014,1981818,2466,6,98622,0,101088,6,1
1913445,260551,564,49,47943,0,48507,49,1
847029,1762138,174,29,693,0,867,29,1
855821,954991,770,85,5493,0,6263,85,1
4236325,2799855,372,64,6103,0,6475,64,1
4801471,688037,585,6,17979,0,18564,6,1
3765475,2608134,873,1,107914,0,108787,1,1
3178233,2191591,122,179,348,0,470,179,1
4727207,2022124,925,1,84581,0,85506,1,1
3280389,902960,1101,1,411419,0,412520,1,1
1635215,3155084,209,78,8253,0,8462,78,1
1927211,3625844,1668,14,113322,0,114990,14,1
4011264,133329,1360,25,116777,0,118137,25,1
3173081,2770141,204,14,1344,0,1548,14,1
1580988,2118676,2821,1,400133,0,402954,1,1
4604311,4068396,29,2,7472,0,7501,2,1
2443201,1436216,75,1068,669,68770,744,69838,1
1705425,3951977,248,77,6280,0,6528,77,1
1436216,2241387,1068,11,68770,0,69838,11,1
2261139,360892,2014,165,42851,0,44865,165,1
1293807,835734,1837,5,30865,0,32702,5,1
1906576,2875205,3,9,185,0,188,9,1
2514271,4632001,387,131,19070,0,19457,131,1
3280389,4434102,1101,2,411419,0,412520,2,1
4751453,2296339,520,101,27570,0,28090,101,1
672662,187379,86,267,194,0,280,267,1
1250021,2016737,4637,6,85913,0,90550,6,1
4191410,4272534,1590,4,96434,0,98024,4,1
2576364,520760,108,124,1654,0,1762,124,1
3671141,72121,1444,82,48400,0,49844,82,1
748019,4113904,675,22,18480,0,19155,22,1
4395006,4232568,239,275,1862,36,2101,311,1
4030529,622660,299,6,3324,0,3623,6,1
2745133,4591543,85,488,2347,0,2432,488,1
1591435,2322661,387,4,31245,0,31632,4,1
2257251,4321977,149,19,470,0,619,19,1
1236075,1620263,344,36,2346,0,2690,36,1
3438576,3835880,3424,4,137753,0,141177,4,1
2075015,568564,2664,77,85781,0,88445,77,1
2516076,152823,1455,58,77782,0,79237,58,1
3054589,3406104,68,68,1104,0,1172,68,1
3910135,858054,298,28,14348,0,14646,28,1
2052485,2145633,59,55,2664,0,2723,55,1
3940115,3956913,111,197,462,167,573,364,1
2161539,4787157,9,10,22,0,31,10,1
4416945,2814617,417,74,33228,0,33645,74,1
3280389,2607889,1101,1,411419,0,412520,1,1
1800445,2700916,132,651,2387,0,2519,651,1
1055530,4423184,415,384,14969,29809,15384,30193,1
4653941,2292702,951,2,45883,0,46834,2,1
507060,4338741,191,284,6141,0,6332,284,1
4103612,3575260,932,242,5655,5576,6587,5818,1
1988347,4201375,205,182,3660,0,3865,182,1
2872979,2025845,341,14,28510,0,28851,14,1
288324,336220,90,4,1983,0,2073,4,1
3422093,3374678,201,18,2559,0,2760,18,1
2772113,609775,792,26,42907,0,43699,26,1
3361377,2774871,4841,1,761793,0,766634,1,1
2791231,4354289,183,3,5221,0,5404,3,1
4533803,2819798,8,21,48,47,56,68,1
3419326,366980,24,114,1048,497,1072,611,1
3509903,4019697,1530,2,509445,0,510975,2,1
3278135,4762637,358,56,7252,0,7610,56,1
4209323,2216375,1630,633,89460,0,91090,633,1
3291396,4590105,195,21,11502,0,11697,21,1
2827436,3371744,882,1,271525,0,272407,1,1
3291396,1002186,195,4,11502,0,11697,4,1
2498087,3593620,1630,234,32582,0,34212,234,1
4435816,3778138,262,4,8391,0,8653,4,1
2343253,3727181,1882,21,86401,0,88283,21,1
4169623,37520,21,179,110,0,131,179,1
4467395,2934717,2084,53,14574,0,16658,53,1
2204348,2544503,89,8,970,0,1059,8,1
4829442,3709040,75,168,1847,0,1922,168,1
1534362,4255150,1531,116,105859,0,107390,116,1
1494665,547011,668,19,37638,0,38306,19,1
1897168,184448,85,19,1905,0,1990,19,1
3206499,2898851,1337,29,32033,157,33370,186,1
3683235,1975550,311,3,23110,0,23421,3,1
1206697,2529661,685,493,5595,27309,6280,27802,1
1787075,231970,894,37,28305,0,29199,37,1
4842461,2405845,450,97,3728,0,4178,97,1
2092043,2908445,73,21,2886,0,2959,21,1
1250021,1201440,4637,8,85913,0,90550,8,1
276216,2290962,312,20,12600,0,12912,20,1
3058068,477464,124,2,12734,0,12858,2,1
3294702,4803016,991,8,68888,0,69879,8,1
805360,761937,1514,23,119306,0,120820,23,1
4272102,4506104,1608,49,104171,0,105779,49,1
3201636,4210163,6,16,286,0,292,16,1
1541866,4732706,542,94,16481,0,17023,94,1
1966548,4290640,208,107,53149,0,53357,107,1
4143940,3369079,49,4,418,0,467,4,1
3280389,2564385,1101,2,411419,0,412520,2,1
2521890,2817499,7,20,21,0,28,20,1
3288730,2869242,117,71,4627,0,4744,71,1
957197,4740438,614,1,37109,0,37723,1,1
932720,3022716,1411,16,111323,0,112734,16,1
607449,1225096,380,31,19369,0,19749,31,1
151693,3937380,436,73,12181,0,12617,73,1
1927211,2621293,1668,237,113322,0,114990,237,1
3361377,985717,4841,3,761793,0,766634,3,1
679540,2376259,396,136,8028,0,8424,136,1
1086912,2011085,907,10,33396,0,34303,10,1
2188394,4203863,166,30,2340,350,2506,380,1
3147075,2931055,7,28,109,0,116,28,1
1534362,2096151,1531,208,105859,0,107390,208,1
1196844,1876426,548,16,36289,0,36837,16,1
1792987,3567246,97,192,3867,3712,3964,3904,1
3444181,2853821,69,3,217,45,286,48,1
530200,3818652,2035,3,62809,0,64844,3,1
3361377,712926,4841,124,761793,0,766634,124,1
4727207,4687507,925,3,84581,0,85506,3,1
4327096,1022993,234,47,2944,0,3178,47,1
4451122,4291872,985,78,41669,0,42654,78,1
3280389,4491689,1101,1,411419,0,412520,1,1
3454888,2638074,162,118,7886,0,8048,118,1
4360960,4698097,1642,35,110084,0,111726,35,1
422075,2956553,163,610,485,314,648,924,1
4011264,2695943,1360,6,116777,0,118137,6,1
4539231,2559683,81,12,2053,0,2134,12,1
1185597,1739376,64,6,1501,0,1565,6,1
3280389,544345,1101,2,411419,0,412520,2,1
2772256,4342395,82,59,4404,0,4486,59,1
1225988,382471,157,166,8881,0,9038,166,1
4360960,4296500,1642,48,110084,0,111726,48,1
4113414,1730590,403,101,3521,0,3924,101,1
1792987,1847077,97,163,3867,0,3964,163,1
607449,1212542,380,6,19369,0,19749,6,1
139255,2212785,12,2,1615,0,1627,2,1
2650412,937378,931,51,29038,0,29969,51,1
932720,4777557,1411,6,111323,0,112734,6,1
1628302,2757434,11,1,4819,0,4830,1,1
3676295,1518809,374,3,70881,0,71255,3,1
354904,2061860,3193,1,105780,0,108973,1,1
431769,2799941,89,662,231,55,320,717,1
4179002,306272,235,98,1340,0,1575,98,1
3857537,4019478,1008,11,5225,0,6233,11,1
4816740,3162591,141,174,7750,0,7891,174,1
2540979,1625895,245,157,1451,0,1696,157,1
2147720,3957425,1608,153,78786,0,80394,153,1
1331940,4634661,802,8,32617,0,33419,8,1
3280389,417185,1101,3,411419,0,412520,3,1
4411870,3224439,948,6,60517,0,61465,6,1
3671141,3855274,1444,217,48400,0,49844,217,1
4205408,202277,67,9,251,0,318,9,1
3361377,1305881,4841,1,761793,0,766634,1,1
2790006,297070,367,84,14747,0,15114,84,1
1348342,599121,241,80,1456,0,1697,80,1
914350,2984041,80,4,256,0,336,4,1
4023687,4282418,69,1,7295,0,7364,1,1
386424,1303064,131,21,7871,0,8002,21,1
1486758,4585089,337,70,11346,0,11683,70,1
532681,1722512,433,10,35023,0,35456,10,1
2827436,4510009,882,14,271525,0,272407,14,1
862958,653520,87,201,4203,0,4290,201,1
4018742,2780368,115,12,3140,0,3255,12,1
302470,3881634,229,641,799,8471,1028,9112,1
1189314,3649714,229,76,2366,0,2595,76,1
2281149,2459822,282,54,28082,0,28364,54,1
3375235,511247,562,91,3864,0,4426,91,1
1563367,4132582,15,13,709,0,724,13,1
4656285,4183291,1446,55,35428,0,36874,55,1
427805,4801729,483,24,156906,0,157389,24,1
408965,3622264,903,8,38623,0,39526,8,1
1241907,4057848,176,556,1602,3400,1778,3956,1
550699,4641162,19,3,229,0,248,3,1
3280389,904285,1101,1,411419,0,412520,1,1
2827436,3513644,882,1,271525,0,272407,1,1
3638272,1057958,2022,5,370904,0,372926,5,1
2100448,2525425,2,440,299,1129,301,1569,1
4044141,2848619,48,325,265,0,313,325,1
2790006,4603702,367,174,14747,0,15114,174,1
3987684,4091184,286,169,17372,1179,17658,1348,1
1250021,2924686,4637,6,85913,0,90550,6,1
2381218,4414381,298,59,3375,0,3673,59,1
1475591,4309586,178,8,3828,0,4006,8,1
875909,3157823,118,15,3602,0,3720,15,1
4191410,2614698,1590,56,96434,0,98024,56,1
2516076,15247,1455,60,77782,0,79237,60,1
3611989,1455977,200,168,1156,0,1356,168,1
2260014,325859,2466,92,98622,0,101088,92,1
2950311,1525797,807,97,85116,0,85923,97,1
532681,4725128,433,19,35023,0,35456,19,1
4220533,3548551,329,1,3527,0,3856,1,1
4360960,1600610,1642,19,110084,0,111726,19,1
3128197,3020559,122,46,6176,0,6298,46,1
940526,2353099,475,5,20786,0,21261,5,1
4318206,2110657,251,44,13123,0,13374,44,1
1839283,736677,765,5,36658,0,37423,5,1
1919631,847782,185,364,2750,1411,2935,1775,1
490279,4184944,73,171,639,0,712,171,1
2209136,744423,620,106,33789,0,34409,106,1
3280389,4597341,1101,1,411419,0,412520,1,1
1880135,1991068,810,97,71924,0,72734,97,1
4738916,3902256,1165,70,34124,0,35289,70,1
1984092,2174133,68,51,1890,0,1958,51,1
1225988,3709040,157,168,8881,0,9038,168,1
4493181,59360,351,3,2136,0,2487,3,1
2851109,3958556,450,1,98552,0,99002,1,1
4023687,1006915,69,3,7295,0,7364,3,1
2428341,560736,826,81,10151,0,10977,81,1
1234540,3434057,1071,79,75251,0,76322,79,1
3946538,1282861,127,18,400,0,527,18,1
4360960,4234558,1642,58,110084,0,111726,58,1
111922,3058280,303,10,6879,0,7182,10,1
1984092,886937,68,218,1890,923,1958,1141,1
3531730,1804029,334,54,9763,0,10097,54,1
1591435,228196,387,3,31245,0,31632,3,1
2881894,1921585,211,11,7468,0,7679,11,1
3671141,93306,1444,272,48400,0,49844,272,1
892512,4091129,1505,15,11757,51,13262,66,1
4846840,2045520,69,41,561,0,630,41,1
4649206,4273692,566,37,31367,0,31933,37,1
3294702,2099723,991,97,68888,1446,69879,1543,1
3361377,4399191,4841,4,761793,0,766634,4,1
4241523,3152785,71,447,1727,0,1798,447,1
2981537,3896860,1252,10,118718,0,119970,10,1
1110514,1730763,68,87,3569,0,3637,87,1
2502456,1464348,719,17,50725,0,51444,17,1
1735116,2054227,503,46,16146,0,16649,46,1
4701417,764970,305,17,3855,0,4160,17,1
4411870,2581746,948,40,60517,0,61465,40,1
3434766,2732723,82,556,894,0,976,556,1
4147530,333902,75,116,661,0,736,116,1
3361377,502002,4841,2,761793,0,766634,2,1
415521,2700916,175,651,2013,0,2188,651,1
2094626,2947351,194,1,2066,0,2260,1,1
2446968,4090994,452,27,20110,0,20562,27,1
3509903,238037,1530,4,509445,0,510975,4,1
320344,4479581,351,601,3831,19545,4182,20146,1
2536472,2869854,344,16,9725,0,10069,16,1
1903752,1642543,506,1,10494,0,11000,1,1
55290,4302343,58,2,250,0,308,2,1
4191727,3167410,463,1,26315,0,26778,1,1
2883731,1643790,213,62,5217,0,5430,62,1
519175,618422,173,402,7221,0,7394,402,1
4417253,1328480,1130,43,68389,0,69519,43,1
2897926,3734565,565,19,25983,0,26548,19,1
4417253,3956579,1130,18,68389,0,69519,18,1
932720,2010071,1411,31,111323,0,112734,31,1
663087,4222780,551,136,3410,0,3961,136,1
3065808,2074115,1235,31,82317,0,83552,31,1
4011264,309168,1360,67,116777,0,118137,67,1
2516076,3206270,1455,49,77782,0,79237,49,1
3112136,843166,406,14,41366,0,41772,14,1
2024753,2643544,172,520,1901,2,2073,522,1
1063358,2074375,1350,46,63494,0,64844,46,1
570984,2581162,430,137,4607,0,5037,137,1
3764177,2524964,1036,128,64563,0,65599,128,1
3501482,4214766,522,120,28046,0,28568,120,1
3396719,4211727,660,39,8141,0,8801,39,1
1603453,1666181,72,59,586,0,658,59,1
2681811,910291,284,4,6285,0,6569,4,1
3336522,1832783,36,65,2235,0,2271,65,1
3746611,1580508,69,720,1951,19611,2020,20331,1
91116,418485,239,83,2466,0,2705,83,1
474172,4497954,471,161,38713,0,39184,161,1
302204,1903588,366,135,3449,0,3815,135,1
2150273,3529061,649,9,6442,0,7091,9,1
3216427,3648271,262,38,6471,0,6733,38,1
1161189,796698,112,97,3964,0,4076,97,1
2195890,1736064,134,97,5208,0,5342,97,1
2107861,4730362,535,9,25743,0,26278,9,1
570984,776275,430,41,4607,0,5037,41,1
2590375,4549165,10,3,408,0,418,3,1
4417253,4482854,1130,16,68389,0,69519,16,1
522588,223026,496,104,20091,0,20587,104,1
4140279,1050633,337,1,49384,0,49721,1,1
1580988,2362981,2821,3,400133,0,402954,3,1
3764177,4541733,1036,54,64563,0,65599,54,1
364077,3292382,11,3,398,0,409,3,1
4013601,241332,653,446,14886,2086,15539,2532,1
129556,2866819,235,171,1685,613,1920,784,1
3676295,3902517,374,1,70881,0,71255,1,1
4416945,1645781,417,28,33228,0,33645,28,1
4507659,2257640,115,4,1270,0,1385,4,1
354904,4209834,3193,36,105780,0,108973,36,1
307250,1709239,919,2,35588,0,36507,2,1
2075015,4741067,2664,23,85781,0,88445,23,1
2772113,1050047,792,13,42907,0,43699,13,1
3509903,1287326,1530,1,509445,0,510975,1,1
1164306,1457506,463,127,671,0,1134,127,1
3280389,2089334,1101,1,411419,0,412520,1,1
3206499,2368874,1337,9,32033,0,33370,9,1
1438597,3876737,182,2951,1197,1921,1379,4872,1
3840026,3219388,278,9,468,0,746,9,1
3065808,2300139,1235,38,82317,0,83552,38,1
2950311,1908033,807,4,85116,0,85923,4,1
3676295,1349370,374,2,70881,0,71255,2,1
3361377,822424,4841,10,761793,0,766634,10,1
1580988,3532199,2821,2,400133,0,402954,2,1
3438576,4484985,3424,32,137753,0,141177,32,1
170530,2468638,34,269,273,0,307,269,1
2075015,1653213,2664,480,85781,229,88445,709,1
427805,4260566,483,1,156906,0,157389,1,1
4838376,1846739,606,119,26838,0,27444,119,1
2851109,190365,450,1,98552,0,99002,1,1
3824547,725254,1075,5,14337,0,15412,5,1
2662654,1446646,224,46,1542,0,1766,46,1
4505464,852111,99,24,2637,0,2736,24,1
2985933,1466698,663,170,1912,0,2575,170,1
2834992,4305163,69,14,1779,0,1848,14,1
2482338,2475518,712,166,24222,0,24934,166,1
1937293,1262947,434,15,16761,0,17195,15,1
2720781,2223435,251,10,170,0,421,10,1
2405789,527563,1010,91,93387,0,94397,91,1
4313572,1932389,930,50,16971,0,17901,50,1
532681,273451,433,148,35023,0,35456,148,1
3845119,2923946,461,41,28609,0,29070,41,1
905268,4738122,72,57,255,0,327,57,1
2345261,4753146,92,785,1694,0,1786,785,1
2021728,2946957,46,14,103,0,149,14,1
2261139,4303847,2014,43,42851,0,44865,43,1
1809305,34560,48,180,540,2748,588,2928,1
2664751,1702022,70,55,636,0,706,55,1
4045966,649089,167,655,1316,0,1483,655,1
2343253,455759,1882,28,86401,0,88283,28,1
2027839,2376732,213,4,2813,0,3026,4,1
4191727,2614615,463,142,26315,0,26778,142,1
4249983,830382,679,138,16076,0,16755,138,1
1539837,3666267,1127,46,62979,0,64106,46,1
522588,1802576,496,1,20091,0,20587,1,1
2998026,3315864,919,2,24182,0,25101,2,1
2886626,1838271,192,849,6077,0,6269,849,1
1545237,1943968,381,105,14327,0,14708,105,1
3320279,3978003,312,78,2691,0,3003,78,1
3509903,1871205,1530,2,509445,0,510975,2,1
3172610,4670865,34,134,2000,0,2034,134,1
544230,2427602,1532,8,60768,0,62300,8,1
60980,2636376,649,1,20708,0,21357,1,1
4460077,3542322,142,11,1071,0,1213,11,1
3128197,1138411,122,124,6176,0,6298,124,1
3449530,4438340,717,25,73648,0,74365,25,1
1353265,540737,128,32,6709,0,6837,32,1
2887240,4543630,1143,2,118405,0,119548,2,1
2407452,4685746,249,115,3937,0,4186,115,1
2788949,3217712,134,1,1950,0,2084,1,1
680923,677220,183,3,542,0,725,3,1
2343253,602345,1882,1,86401,0,88283,1,1
3549674,3506192,602,809,38542,0,39144,809,1
4856467,4122838,75,134,845,0,920,134,1
3997049,3182297,142,47,1189,0,1331,47,1
3235366,2567457,99,113,369,0,468,113,1
4505464,1285514,99,24,2637,0,2736,24,1
4289995,3734405,525,18,4959,0,5484,18,1
3361377,132951,4841,101,761793,0,766634,101,1
1355516,371188,315,112,2436,0,2751,112,1
4191410,2885151,1590,53,96434,0,98024,53,1
2883055,1172418,286,5,13198,0,13484,5,1
4345608,2050404,234,35,2526,0,2760,35,1
4423184,657111,384,21,29809,0,30193,21,1
4642569,4194018,872,432,27586,0,28458,432,1
3361377,121342,4841,17,761793,0,766634,17,1
4577918,994161,54,134,993,0,1047,134,1
4342519,1943104,138,4,11317,0,11455,4,1
3509903,2822466,1530,3,509445,0,510975,3,1
3764177,988416,1036,12,64563,0,65599,12,1
3228493,876294,19,1,2744,0,2763,1,1
725974,2335896,83,55,2505,0,2588,55,1
3481139,2306552,168,68,829,0,997,68,1
3361377,4351474,4841,2,761793,0,766634,2,1
3361377,1756467,4841,7,761793,0,766634,7,1
4738916,2303773,1165,3,34124,0,35289,3,1
3509903,1168812,1530,2,509445,0,510975,2,1
646699,3982871,51,3,864,0,915,3,1
253352,1415238,237,107,10413,0,10650,107,1
2713411,4820246,384,28,4637,0,5021,28,1
1790685,2531099,111,350,425,0,536,350,1
3509903,2046979,1530,8,509445,0,510975,8,1
466667,536598,442,67,4239,0,4681,67,1
22919,800046,28,73,1075,0,1103,73,1
837553,4151490,1249,205,61665,0,62914,205,1
2854332,4156608,21,1,168,0,189,1,1
974695,4720801,24,101,41,0,65,101,1
3361377,881297,4841,1,761793,0,766634,1,1
4750855,879107,355,166,18880,0,19235,166,1
4443577,2186885,509,5,11936,0,12445,5,1
530200,3591908,2035,163,62809,0,64844,163,1
153871,1653010,333,29,3892,0,4225,29,1
3756233,684117,40,18,1481,0,1521,18,1
687713,3386056,436,42,47160,0,47596,42,1
2851109,1147729,450,3,98552,0,99002,3,1
2031305,4102403,396,49,23435,0,23831,49,1
4272102,2002961,1608,1,104171,0,105779,1,1
4021290,1730280,5,111,199,0,204,111,1
60980,4609069,649,5,20708,0,21357,5,1
2187320,1990655,208,82,3143,0,3351,82,1
2209136,733063,620,96,33789,0,34409,96,1
4253538,2268005,1412,365,1533,307,2945,672,1
2110232,4330540,100,174,809,1509,909,1683,1
4360960,3596210,1642,151,110084,0,111726,151,1
2985909,3933402,706,41,43348,0,44054,41,1
1573878,3965141,99,2,489,0,588,2,1
228444,1896252,39,4,1802,0,1841,4,1
1140134,2323217,311,867,11111,0,11422,867,1
1455058,2393593,129,183,3856,0,3985,183,1
3395938,2770394,546,4,39878,0,40424,4,1
2358307,292024,46,44,1392,0,1438,44,1
439557,3281840,2090,15,61744,0,63834,15,1
2031305,2444754,396,2,23435,0,23831,2,1
855821,4166606,770,138,5493,553,6263,691,1
2711160,3060714,69,1783,313,6,382,1789,1
2948092,1594703,412,1,18486,0,18898,1,1
3361377,4294020,4841,2,761793,0,766634,2,1
3294702,4258397,991,49,68888,0,69879,49,1
932720,2956919,1411,20,111323,0,112734,20,1
60980,4701535,649,4,20708,0,21357,4,1
2981537,2873084,1252,15,118718,0,119970,15,1
3454057,1368516,216,130,2404,0,2620,130,1
427805,239413,483,1,156906,0,157389,1,1
439557,5400,2090,269,61744,0,63834,269,1
2281709,2938534,95,73,2301,0,2396,73,1
3294915,3950665,538,18,44,270,582,288,1
3758692,1583310,711,132,34731,0,35442,132,1
3891071,926122,69,1,272,0,341,1,1
4140279,1234411,337,6,49384,0,49721,6,1
2457029,2757131,77,2,10427,0,10504,2,1
4801471,755953,585,26,17979,0,18564,26,1
4731722,4686600,151,92,1196,0,1347,92,1
2147720,2130267,1608,157,78786,0,80394,157,1
2077019,3780189,38,3,1764,0,1802,3,1
3638272,4302149,2022,1,370904,0,372926,1,1
1234540,2709405,1071,81,75251,0,76322,81,1
3509903,2152188,1530,2,509445,0,510975,2,1
3633019,374902,746,24,32317,0,33063,24,1
1301815,3738477,752,31,48944,0,49696,31,1
4423184,2465419,384,36,29809,0,30193,36,1
1534362,3222336,1531,122,105859,0,107390,122,1
3361377,917811,4841,1,761793,0,766634,1,1
2893334,2483187,889,31,30148,0,31037,31,1
2025305,1603289,104,360,1007,873,1111,1233,1
4244384,1845201,45,13,1114,0,1159,13,1
1575009,1872284,429,27,37745,0,38174,27,1
2662809,1745051,303,25,10704,0,11007,25,1
1093081,612542,84,5,999,0,1083,5,1
2465641,1085365,383,2,2507,0,2890,2,1
681618,863619,75,8,8789,0,8864,8,1
3357903,4598435,268,1,1262,0,1530,1,1
3280389,2445274,1101,1,411419,0,412520,1,1
3361377,4718335,4841,19,761793,0,766634,19,1
3361377,3866183,4841,1,761793,0,766634,1,1
530200,4717779,2035,10,62809,0,64844,10,1
4179343,682477,119,5,9822,0,9941,5,1
3509903,4497140,1530,2,509445,0,510975,2,1
1839283,2037402,765,44,36658,0,37423,44,1
3638272,4661809,2022,1,370904,0,372926,1,1
2021745,292162,72,15,2948,0,3020,15,1
3361377,4389786,4841,2,761793,0,766634,2,1
3509903,4303247,1530,2,509445,0,510975,2,1
1063358,2593045,1350,17,63494,0,64844,17,1
203626,915390,41,1345,158,5262,199,6607,1
4569293,252865,191,261,5084,0,5275,261,1
2109919,671223,46,5,5772,0,5818,5,1
1919853,4269757,27,35,326,0,353,35,1
519175,1901285,173,9,7221,0,7394,9,1
2405789,2544962,1010,32,93387,0,94397,32,1
1563367,3861059,15,2,709,0,724,2,1
3361377,411311,4841,1,761793,0,766634,1,1
4560210,4859240,177,100,6565,0,6742,100,1
2973719,1250021,78,4637,324,85913,402,90550,1
3514277,2700138,1338,427,13269,0,14607,427,1
4220533,2641743,329,8,3527,0,3856,8,1
2827436,1220086,882,2,271525,0,272407,2,1
3509903,1555808,1530,1,509445,0,510975,1,1
1878924,1057868,85,10,2012,0,2097,10,1
2403192,343553,163,65,5302,0,5465,65,1
2827436,2626976,882,10,271525,0,272407,10,1
3438576,2976931,3424,4,137753,0,141177,4,1
2261139,2395801,2014,52,42851,0,44865,52,1
3930096,379354,21,74,319,0,340,74,1
4751453,2201221,520,9,27570,0,28090,9,1
1372535,872462,177,274,3150,0,3327,274,1
1534362,4119595,1531,115,105859,0,107390,115,1
3542719,919228,90,30,880,54,970,84,1
2934549,1891681,255,3,2836,0,3091,3,1
837553,1687328,1249,35,61665,0,62914,35,1
1966548,3151638,208,1,53149,0,53357,1,1
3066166,1815460,100,201,3914,0,4014,201,1
3632293,929623,570,183,21294,0,21864,183,1
4731849,4289447,455,190,10886,0,11341,190,1
2405789,2006777,1010,33,93387,0,94397,33,1
308334,1604785,27,139,65,1999,92,2138,1
4853234,1225545,1256,186,29554,0,30810,186,1
2379070,2487660,141,128,2560,0,2701,128,1
3323724,4866246,113,118,1695,0,1808,118,1
3791803,274259,28,62,247,0,275,62,1
2027108,3459778,1172,4,5587,0,6759,4,1
1580988,2622727,2821,2,400133,0,402954,2,1
3361377,3336730,4841,1,761793,0,766634,1,1
3561502,3065808,1144,1235,68800,82317,69944,83552,1
522588,3045635,496,6,20091,0,20587,6,1
3549674,4416254,602,72,38542,0,39144,72,1
3979822,2491731,14,42,145,0,159,42,1
3064348,3808061,17,294,222,1766,239,2060,1
2994391,3877087,315,8,6520,0,6835,8,1
4187681,1305331,192,17,2368,0,2560,17,1
1717922,861015,432,110,6340,0,6772,110,1
1031334,2160019,459,105,16840,0,17299,105,1
765601,2560153,1485,33,101510,0,102995,33,1
4738916,1469438,1165,56,34124,0,35289,56,1
781211,3951304,976,103,51781,0,52757,103,1
1580988,3233235,2821,6,400133,0,402954,6,1
4762204,1960030,2239,22,4518,0,6757,22,1
4360960,2170813,1642,31,110084,0,111726,31,1
3438576,322187,3424,2,137753,0,141177,2,1
3914135,1756160,2152,28,60084,0,62236,28,1
2603371,4160140,77,576,1928,0,2005,576,1
1161189,3342078,112,326,3964,0,4076,326,1
3231669,4795769,211,6,1017,0,1228,6,1
3271484,1649712,1507,14,34093,0,35600,14,1
1521082,4220092,766,15,6562,0,7328,15,1
3438576,3252503,3424,61,137753,0,141177,61,1
3765475,3101308,873,30,107914,0,108787,30,1
2529661,2997518,493,27,27309,0,27802,27,1
4574571,3309605,186,43,6965,0,7151,43,1
3361377,3120988,4841,8,761793,0,766634,8,1
4662055,1146757,155,12,2918,0,3073,12,1
1117046,3561502,188,1144,2115,68800,2303,69944,1
1580988,4394525,2821,2,400133,0,402954,2,1
3280389,2034267,1101,5,411419,0,412520,5,1
2850994,2887240,113,1143,2548,118405,2661,119548,1
752618,4358190,169,37,5929,0,6098,37,1
2096270,823602,970,8,26018,0,26988,8,1
1541866,2732333,542,295,16481,0,17023,295,1
3638272,4848524,2022,2,370904,0,372926,2,1
4015080,1407305,144,22,1337,0,1481,22,1
410952,529752,88,67,209,0,297,67,1
4328675,2278935,18,1769,191,0,209,1769,1
2446968,1142602,452,50,20110,0,20562,50,1
3981429,1785380,208,36,1911,0,2119,36,1
2022081,3152965,143,110,1466,0,1609,110,1
4527629,1990652,64,100,299,316,363,416,1
4272102,4478584,1608,69,104171,0,105779,69,1
1533546,589148,703,360,22095,0,22798,360,1
3414740,1537743,92,514,2484,0,2576,514,1
3703285,2082418,100,10,1682,0,1782,10,1
4705188,81614,336,4,8658,0,8994,4,1
1580988,3272833,2821,2,400133,0,402954,2,1
3509903,3761270,1530,1,509445,0,510975,1,1
1445380,97603,40,25,4396,0,4436,25,1
354904,4833343,3193,10,105780,0,108973,10,1
513747,383242,335,45,303,0,638,45,1
544230,1903981,1532,113,60768,2678,62300,2791,1
3593666,1898633,451,16,530,0,981,16,1
3676150,3567650,125,2,7579,0,7704,2,1
3509903,89850,1530,4,509445,0,510975,4,1
1102748,3581373,555,71,6504,0,7059,71,1
4479581,3387814,601,198,19545,1943,20146,2141,1
752618,2362228,169,12,5929,0,6098,12,1
1633022,50502,246,6,23530,0,23776,6,1
4624595,222129,722,5,53368,0,54090,5,1
3115867,1601515,1350,123,61232,0,62582,123,1
408965,2587191,903,69,38623,0,39526,69,1
4272102,1790090,1608,11,104171,0,105779,11,1
2260014,935062,2466,35,98622,0,101088,35,1
873241,3389117,616,48,22633,0,23249,48,1
2961801,3544707,1483,60,101962,0,103445,60,1
1276253,2446475,407,128,46534,0,46941,128,1
3765475,4239704,873,128,107914,0,108787,128,1
1633053,933357,533,17,8638,0,9171,17,1
943153,105133,77,15,1411,0,1488,15,1
3280389,1546674,1101,12,411419,0,412520,12,1
3268279,51133,33,8,684,0,717,8,1
1079005,2670535,6,34,286,0,292,34,1
846208,1372868,600,159,17288,0,17888,159,1
4272102,4339612,1608,13,104171,0,105779,13,1
3438576,3931569,3424,14,137753,0,141177,14,1
161276,611927,146,305,6548,8695,6694,9000,1
4100923,1190231,260,83,7743,0,8003,83,1
1337914,2099096,225,42,1526,0,1751,42,1
2542968,3621932,444,102,4728,0,5172,102,1
3438576,1660204,3424,7,137753,0,141177,7,1
3137900,1005670,357,185,6655,0,7012,185,1
380817,1201256,32,786,1035,0,1067,786,1
3361377,1222262,4841,1,761793,0,766634,1,1
3638272,1416659,2022,1,370904,0,372926,1,1
4534401,879327,103,181,4125,0,4228,181,1
3638272,417010,2022,2,370904,0,372926,2,1
2198488,4650478,37,27,2593,0,2630,27,1
2851109,1414382,450,7,98552,0,99002,7,1
462298,928691,414,8,10933,0,11347,8,1
3112136,683806,406,4,41366,0,41772,4,1
3638272,1547578,2022,1,370904,0,372926,1,1
4023687,2468198,69,5,7295,0,7364,5,1
3316620,117676,214,185,5083,0,5297,185,1
4001849,4779044,176,580,1826,0,2002,580,1
1580988,1817632,2821,2,400133,0,402954,2,1
4117726,4541087,136,6,751,0,887,6,1
3280389,943073,1101,1,411419,0,412520,1,1
593740,251584,1107,18,62807,0,63914,18,1
2985933,1709916,663,25,1912,0,2575,25,1
1063358,1373578,1350,167,63494,0,64844,167,1
1733957,2181765,554,844,15185,1019,15739,1863,1
2956248,468519,346,5,6702,0,7048,5,1
2961801,1078544,1483,15,101962,0,103445,15,1
3427146,3368608,54,190,86,976,140,1166,1
917130,363588,325,127,7017,0,7342,127,1
2950311,365845,807,21,85116,0,85923,21,1
3638272,4679184,2022,140,370904,0,372926,140,1
3567246,1861795,192,25,3712,0,3904,25,1
1545237,332723,381,11,14327,0,14708,11,1
1923198,2929542,531,113,3973,0,4504,113,1
3058068,4183908,124,93,12734,0,12858,93,1
1814709,368293,316,74,5746,0,6062,74,1
3387987,785646,268,180,19035,0,19303,180,1
3836080,4662110,1197,19,59457,0,60654,19,1
3361377,4177710,4841,1,761793,0,766634,1,1
3509903,208883,1530,2,509445,0,510975,2,1
1527543,4361671,22,2,170,0,192,2,1
3438576,740731,3424,18,137753,0,141177,18,1
3115867,2941248,1350,4,61232,0,62582,4,1
4191410,4709017,1590,159,96434,0,98024,159,1
781211,1755650,976,7,51781,0,52757,7,1
4416945,940996,417,93,33228,0,33645,93,1
1532003,82462,124,1,1671,0,1795,1,1
3844858,1442400,1591,114,28974,0,30565,114,1
4435816,207258,262,4,8391,0,8653,4,1
1357867,3396269,103,98,217,0,320,98,1
259575,1930860,260,4,13949,0,14209,4,1
3051212,1542700,957,1,8349,0,9306,1,1
3014139,3828009,75,3,1511,0,1586,3,1
3235479,1025586,999,22,66486,0,67485,22,1
1776136,1292274,49,421,129,63,178,484,1
1580988,3985271,2821,3,400133,0,402954,3,1
2981537,3999485,1252,5,118718,0,119970,5,1
3509903,379220,1530,2,509445,0,510975,2,1
2147720,4168956,1608,71,78786,0,80394,71,1
2502456,1792203,719,87,50725,0,51444,87,1
713934,4024299,753,19,796,0,1549,19,1
781211,2208126,976,39,51781,0,52757,39,1
1071267,4827702,106,132,1236,0,1342,132,1
4527056,1308199,11,1003,71,49,82,1052,1
3672238,4184561,518,87,12172,0,12690,87,1
670299,4287155,33,33,378,0,411,33,1
2281149,3694503,282,30,28082,0,28364,30,1
4352292,2651191,22,4,139,0,161,4,1
859039,3833076,70,47,665,0,735,47,1
2261139,701232,2014,18,42851,0,44865,18,1
3916976,101874,188,53,6098,0,6286,53,1
3206499,2697296,1337,8,32033,0,33370,8,1
2760655,2945434,403,7,2250,0,2653,7,1
519175,4032255,173,2,7221,0,7394,2,1
2516076,1093929,1455,73,77782,0,79237,73,1
1276253,3255582,407,1,46534,0,46941,1,1
3509903,3501118,1530,1,509445,0,510975,1,1
1053923,3046453,490,24,4567,0,5057,24,1
646587,464158,122,391,5819,0,5941,391,1
4705188,2321636,336,123,8658,0,8994,123,1
1884565,231454,39,56,416,0,455,56,1
4084861,3381720,128,60,160,70,288,130,1
3387987,2825998,268,2,19035,0,19303,2,1
1087655,4069278,451,6,3037,0,3488,6,1
1363220,3089930,37,39,1001,0,1038,39,1
2130979,2520220,452,71,4717,0,5169,71,1
1375041,4587951,62,109,495,0,557,109,1
142591,690706,549,86,964,0,1513,86,1
813400,2299930,71,30,696,0,767,30,1
1646418,1761517,9,18,549,0,558,18,1
3638272,2327230,2022,2,370904,0,372926,2,1
4738916,1378973,1165,4,34124,0,35289,4,1
2849738,3198489,61,4,3795,0,3856,4,1
3408985,1289485,205,41,6002,0,6207,41,1
2343253,4122564,1882,27,86401,0,88283,27,1
489584,2072556,421,6,12098,0,12519,6,1
3638272,3490458,2022,4,370904,0,372926,4,1
1637447,3336202,555,19,8549,0,9104,19,1
3590948,2011127,492,30,2943,0,3435,30,1
1924872,2721677,361,61,5715,0,6076,61,1
1533314,3648341,361,31,6007,0,6368,31,1
1196844,3651046,548,73,36289,0,36837,73,1
4295952,4553585,808,170,57369,0,58177,170,1
3280389,4863131,1101,1,411419,0,412520,1,1
2950311,4327317,807,46,85116,0,85923,46,1
1053923,1769696,490,459,4567,0,5057,459,1
354904,2927949,3193,83,105780,0,108973,83,1
4295952,4495902,808,43,57369,0,58177,43,1
3610598,2959619,380,51,17343,0,17723,51,1
1957566,2991143,63,3,760,0,823,3,1
2705227,3649412,7,37,948,0,955,37,1
1995984,3574413,167,145,3484,0,3651,145,1
496557,4653398,96,432,375,0,471,432,1
2075015,1762393,2664,58,85781,0,88445,58,1
4140279,4420420,337,1,49384,0,49721,1,1
4750855,2050346,355,11,18880,0,19235,11,1
4186367,4605041,52,182,454,0,506,182,1
282129,2727311,146,95,2112,0,2258,95,1
2569009,212791,424,19,13423,0,13847,19,1
4140279,3477304,337,317,49384,0,49721,317,1
781211,2671545,976,30,51781,0,52757,30,1
1615854,3015262,286,47,2590,0,2876,47,1
1873797,2887708,14,7,153,0,167,7,1
3361377,3075390,4841,1,761793,0,766634,1,1
814049,791866,229,639,2182,243,2411,882,1
4516604,3408790,314,501,13314,0,13628,501,1
3397281,2135960,743,3,15050,0,15793,3,1
3137585,1877097,1196,48,77354,0,78550,48,1
1276253,3820645,407,1,46534,0,46941,1,1
565240,3224629,50,13,442,0,492,13,1
2107861,3111376,535,3,25743,0,26278,3,1
4062558,4099624,173,129,887,734,1060,863,1
4513654,3269909,32,77,129,0,161,77,1
2260014,2523612,2466,121,98622,0,101088,121,1
4297498,4608486,55,6,1240,0,1295,6,1
21944,436299,317,204,9419,0,9736,204,1
1218330,4286372,9,44,264,0,273,44,1
4528103,1994800,268,1,14258,0,14526,1,1
3509903,971711,1530,1,509445,0,510975,1,1
1966548,3789824,208,4,53149,0,53357,4,1
3280389,166703,1101,1,411419,0,412520,1,1
1906776,3636991,63,6,1962,0,2025,6,1
4437948,1224516,63,3,64,0,127,3,1
4451122,968640,985,53,41669,0,42654,53,1
3873768,668819,449,88,35424,0,35873,88,1
2851109,4180925,450,3,98552,0,99002,3,1
4160129,3195582,30,8,453,0,483,8,1
4479581,4448090,601,161,19545,0,20146,161,1
593740,2596158,1107,21,62807,0,63914,21,1
57574,4009095,289,26,4616,57,4905,83,1
3361377,298699,4841,1,761793,0,766634,1,1
3802719,2172373,91,6,3170,0,3261,6,1
3361377,4125382,4841,2,761793,0,766634,2,1
3850447,3468840,37,22,224,0,261,22,1
2853969,4728735,1051,23,42591,0,43642,23,1
2849738,1586244,61,24,3795,0,3856,24,1
2482338,3125970,712,15,24222,0,24934,15,1
1233580,4038713,49,11,364,0,413,11,1
2950311,583289,807,42,85116,0,85923,42,1
3509903,3507589,1530,4,509445,0,510975,4,1
2502456,1151121,719,22,50725,0,51444,22,1
2827436,1372149,882,13,271525,0,272407,13,1
3323519,2206136,133,85,4787,0,4920,85,1
2887240,2254729,1143,3,118405,0,119548,3,1
2120140,1686155,453,22,6305,0,6758,22,1
2853969,4433885,1051,4,42591,0,43642,4,1
4649206,3788505,566,92,31367,0,31933,92,1
60980,3226489,649,5,20708,0,21357,5,1
3112136,4197957,406,18,41366,0,41772,18,1
3638272,2797994,2022,2,370904,0,372926,2,1
3992144,1274876,402,60,23683,0,24085,60,1
4301252,4007524,118,21,2905,0,3023,21,1
755739,1065142,1117,115,58043,0,59160,115,1
3280389,4512497,1101,1,411419,0,412520,1,1
2774493,618183,551,9,12712,0,13263,9,1
4540817,4144714,197,214,4499,0,4696,214,1
2922412,1824785,464,52,3629,0,4093,52,1
932720,2523060,1411,92,111323,0,112734,92,1
1843507,2118715,537,20,11729,0,12266,20,1
4727207,1146167,925,1,84581,0,85506,1,1
3063001,4268737,40,1,1110,0,1150,1,1
3881634,4360401,641,77,8471,0,9112,77,1
4411870,1794249,948,11,60517,0,61465,11,1
370130,4485929,30,4,1621,0,1651,4,1
4191727,2988795,463,21,26315,0,26778,21,1
3635468,4258263,3,1,130,0,133,1,1
2502456,563781,719,29,50725,0,51444,29,1
3065808,2599166,1235,656,82317,0,83552,656,1
1611386,1981640,187,152,10932,0,11119,152,1
2547306,950688,171,56,1899,0,2070,56,1
1580988,4841064,2821,1,400133,0,402954,1,1
3280389,117783,1101,16,411419,0,412520,16,1
171503,613338,159,1805,428,0,587,1805,1
427805,1691374,483,1,156906,0,157389,1,1
4727207,4565011,925,2,84581,0,85506,2,1
1221325,4521784,153,39,1819,0,1972,39,1
4723328,3853383,249,896,2273,0,2522,896,1
3514791,1691240,254,150,2148,0,2402,150,1
2961801,2165131,1483,25,101962,0,103445,25,1
1580988,459515,2821,8,400133,0,402954,8,1
1140134,3287609,311,1,11111,0,11422,1,1
1580988,64900,2821,3,400133,0,402954,3,1
3721550,4737784,188,19,14527,0,14715,19,1
4181760,4651520,359,65,7855,0,8214,65,1
2120733,3903182,819,182,20803,0,21622,182,1
3137585,1924950,1196,53,77354,0,78550,53,1
1847640,1440734,29,27,150,0,179,27,1
603234,2958655,82,66,504,0,586,66,1
1633022,1170202,246,1,23530,0,23776,1,1
2309618,1336627,980,201,5354,0,6334,201,1
1100354,3169241,163,1,24439,0,24602,1,1
3722259,2672348,284,45,1227,0,1511,45,1
1787075,3002585,894,125,28305,0,29199,125,1
3361377,1747650,4841,2,761793,0,766634,2,1
1521855,4714764,228,222,7649,0,7877,222,1
544230,2384966,1532,46,60768,0,62300,46,1
3509903,4321270,1530,1,509445,0,510975,1,1
1139873,252342,670,28,10236,0,10906,28,1
4527004,1891218,35,1376,410,0,445,1376,1
1652056,4415088,326,3,66845,0,67171,3,1
930244,892512,108,1505,1328,11757,1436,13262,1
1475591,2136899,178,6,3828,0,4006,6,1
4417253,1627472,1130,11,68389,0,69519,11,1
1278809,849332,24,4,1825,0,1849,4,1
2687552,4660297,238,72,25574,0,25812,72,1
4023687,326122,69,73,7295,0,7364,73,1
1436216,4810910,1068,2,68770,0,69838,2,1
1580988,2235212,2821,7,400133,0,402954,7,1
1861419,184346,26,119,268,537,294,656,1
2981537,220506,1252,3,118718,0,119970,3,1
670587,1031546,651,39,9779,110,10430,149,1
4154692,1267205,20,1,73,0,93,1,1
3288123,668723,56,445,1010,0,1066,445,1
3569179,1463608,1064,53,40015,0,41079,53,1
1984622,1128587,145,1,20659,0,20804,1,1
2405789,2540459,1010,26,93387,0,94397,26,1
3115867,165644,1350,29,61232,0,62582,29,1
1100354,1837018,163,1,24439,0,24602,1,1
1567043,3112136,40,406,1448,41366,1488,41772,1
4164822,1726939,43,58,124,0,167,58,1
522588,1978603,496,79,20091,0,20587,79,1
4518123,790748,300,188,6419,0,6719,188,1
3514277,2259164,1338,163,13269,0,14607,163,1
2890130,2005702,54,28,308,0,362,28,1
3449530,4769582,717,74,73648,0,74365,74,1
2981537,1701070,1252,1,118718,0,119970,1,1
3649398,2099187,6,1,1493,0,1499,1,1
3676295,1401722,374,1,70881,0,71255,1,1
3509903,4178781,1530,12,509445,0,510975,12,1
4838376,3210412,606,131,26838,0,27444,131,1
395249,2992123,59,173,702,56,761,229,1
3361377,4620419,4841,2,761793,0,766634,2,1
1966548,4070071,208,1,53149,0,53357,1,1
3419989,4167740,350,38,16316,0,16666,38,1
1471685,2387880,1681,103,25550,0,27231,103,1
3316576,1765139,669,2,7971,0,8640,2,1
2261139,2188426,2014,11,42851,0,44865,11,1
2306134,4004899,337,26,5153,0,5490,26,1
4172041,1912592,4,4,34,0,38,4,1
748019,2125525,675,125,18480,0,19155,125,1
4417253,3630829,1130,75,68389,0,69519,75,1
4411870,3185281,948,69,60517,0,61465,69,1
860473,2172854,751,239,20450,2000,21201,2239,1
3383083,4432730,96,1,1075,0,1171,1,1
4783353,4526419,18,11,138,0,156,11,1
1995984,1277693,167,177,3484,0,3651,177,1
588902,1001070,315,160,347,0,662,160,1
2749474,2499618,4,1,121,0,125,1,1
1843056,2658312,37,88,295,0,332,88,1
6618,2010903,892,46,68849,0,69741,46,1
3395938,4704375,546,4,39878,0,40424,4,1
1847461,4019551,1211,20,51149,0,52360,20,1
3633019,2904252,746,30,32317,0,33063,30,1
110522,4849508,107,256,339,0,446,256,1
2172854,926066,239,5,2000,0,2239,5,1
681618,1147896,75,28,8789,0,8864,28,1
3002200,3936176,637,207,510,283,1147,490,1
3936039,1049703,799,3,23884,0,24683,3,1
4519069,1010889,387,136,20799,0,21186,136,1
2445500,4805494,68,4,3239,0,3307,4,1
607449,2992127,380,2,19369,0,19749,2,1
2737233,4823437,30,1,1579,0,1609,1,1
3206499,1021288,1337,13,32033,0,33370,13,1
2394976,2508674,335,106,10973,0,11308,106,1
3720824,4425776,129,33,449,0,578,33,1
3235479,2530677,999,231,66486,0,67485,231,1
957197,737868,614,4,37109,0,37723,4,1
3338906,4197613,140,1,6745,0,6885,1,1
605874,4616740,145,35,3312,0,3457,35,1
374751,1150121,66,34,328,0,394,34,1
2827436,3192712,882,1,271525,0,272407,1,1
3509903,4347875,1530,1,509445,0,510975,1,1
4089181,2730336,76,234,2696,0,2772,234,1
4408813,3484383,288,253,10077,0,10365,253,1
1988347,1255282,205,516,3660,0,3865,516,1
3280389,69312,1101,1,411419,0,412520,1,1
3501482,3990802,522,15,28046,0,28568,15,1
781211,114319,976,34,51781,0,52757,34,1
4712099,4567106,89,102,1106,0,1195,102,1
838349,3150468,256,165,784,0,1040,165,1
959682,1190898,176,9,404,0,580,9,1
433459,3593924,435,46,821,86,1256,132,1
2041371,2560479,211,52,2804,0,3015,52,1
3522049,3860730,301,16,12347,0,12648,16,1
1313296,1521082,152,766,540,6562,692,7328,1
628258,1531332,155,7,4650,0,4805,7,1
1580988,3552107,2821,21,400133,0,402954,21,1
2255478,1079257,190,141,2000,193,2190,334,1
4653267,2507102,142,81,2557,0,2699,81,1
2514271,979827,387,56,19070,0,19457,56,1
3676295,3052663,374,2,70881,0,71255,2,1
1448515,4477055,28,15,53,0,81,15,1
3894811,727986,68,80,126,0,194,80,1
4680040,4653544,37,321,241,0,278,321,1
860473,688105,751,117,20450,0,21201,117,1
3361377,3704424,4841,1,761793,0,766634,1,1
2849738,3631698,61,2,3795,0,3856,2,1
1971223,2034384,338,4,5185,0,5523,4,1
3509903,3996879,1530,7,509445,0,510975,7,1
3235366,4725720,99,580,369,0,468,580,1
4333770,1189939,100,58,4077,0,4177,58,1
846208,1562653,600,418,17288,0,17888,418,1
2342664,4154700,1181,19,26502,0,27683,19,1
354904,1215509,3193,1,105780,0,108973,1,1
4013601,699103,653,24,14886,0,15539,24,1
1185954,2797560,125,59,1646,0,1771,59,1
1364723,2222777,6,5,196,0,202,5,1
3361377,4492013,4841,8,761793,0,766634,8,1
4570464,1605681,282,166,2968,0,3250,166,1
2321229,3827993,44,73,989,0,1033,73,1
1103332,868724,732,17,59415,0,60147,17,1
1533546,2407412,703,200,22095,0,22798,200,1
1839283,2116024,765,12,36658,0,37423,12,1
2707591,3540814,162,13,2360,0,2522,13,1
1847461,1503967,1211,212,51149,0,52360,212,1
3509903,1843254,1530,1,509445,0,510975,1,1
1580988,533068,2821,2,400133,0,402954,2,1
3059686,4704946,460,238,4530,0,4990,238,1
3509903,4183027,1530,2,509445,0,510975,2,1
471706,2227533,794,14,65616,0,66410,14,1
3449530,2327037,717,12,73648,0,74365,12,1
2281149,1251353,282,51,28082,0,28364,51,1
4209323,4316260,1630,122,89460,0,91090,122,1
3361377,3801657,4841,1,761793,0,766634,1,1
3438576,4149110,3424,56,137753,0,141177,56,1
41659,971509,76,54,802,0,878,54,1
1580988,2008309,2821,1,400133,0,402954,1,1
2869151,449969,395,46,1304,0,1699,46,1
1984622,213886,145,1,20659,0,20804,1,1
635909,307922,179,49,6949,0,7128,49,1
2147720,252897,1608,80,78786,0,80394,80,1
3866209,1551768,449,184,2902,0,3351,184,1
3294702,4356375,991,38,68888,0,69879,38,1
427805,3834101,483,34,156906,0,157389,34,1
657387,3612850,47,3,2455,0,2502,3,1
1534362,250787,1531,37,105859,0,107390,37,1
2446968,4247113,452,61,20110,0,20562,61,1
2281149,858601,282,94,28082,0,28364,94,1
1529434,274168,15,6,809,0,824,6,1
2156404,4551942,33,9,136,0,169,9,1
768957,3373998,202,2,7986,0,8188,2,1
2010948,4061112,166,113,871,0,1037,113,1
4360960,4777266,1642,47,110084,0,111726,47,1
3235479,492068,999,149,66486,0,67485,149,1
4721102,3222794,80,19,600,34,680,53,1
3361377,1320707,4841,4,761793,0,766634,4,1
4140279,918776,337,1,49384,0,49721,1,1
2950311,3786643,807,12,85116,0,85923,12,1
2405789,3487049,1010,58,93387,0,94397,58,1
3361377,1635778,4841,6,761793,0,766634,6,1
2897926,630593,565,8,25983,0,26548,8,1
4596817,2742232,160,32,1879,0,2039,32,1
3280389,4600875,1101,1,411419,0,412520,1,1
960415,959867,33,140,272,0,305,140,1
2457029,83637,77,22,10427,0,10504,22,1
259575,1212419,260,52,13949,695,14209,747,1
3254592,2356702,31,1,137,0,168,1,1
3361377,548664,4841,31,761793,0,766634,31,1
439557,192626,2090,35,61744,0,63834,35,1
1875,829382,656,54,61388,0,62044,54,1
409590,2579421,147,43,925,0,1072,43,1
3824547,1618916,1075,156,14337,391,15412,547,1
4731354,2686601,67,278,1999,0,2066,278,1
868693,203890,469,238,832,0,1301,238,1
3280389,3548921,1101,1,411419,0,412520,1,1
519175,2561949,173,314,7221,0,7394,314,1
3280389,440896,1101,3,411419,0,412520,3,1
2148937,136947,672,2,47361,0,48033,2,1
544230,517239,1532,1,60768,0,62300,1,1
3082645,1559783,932,204,1825,1917,2757,2121,1
2261139,3466641,2014,54,42851,0,44865,54,1
4807996,594101,90,8,1796,0,1886,8,1
735870,3550877,120,22,342,0,462,22,1
4401835,860736,204,67,1738,8,1942,75,1
411002,3551774,132,360,471,0,603,360,1
457909,2374176,59,272,264,327,323,599,1
918918,103481,130,442,1960,0,2090,442,1
1927211,3680175,1668,30,113322,0,114990,30,1
1858077,1012350,450,55,289,0,739,55,1
4011264,1054784,1360,6,116777,0,118137,6,1
1880135,1627230,810,58,71924,0,72734,58,1
3210349,4449674,46,60,3372,0,3418,60,1
3632293,3672268,570,1,21294,0,21864,1,1
2031305,4193640,396,42,23435,0,23831,42,1
1250021,3142629,4637,48,85913,0,90550,48,1
3906136,3319848,387,18,41169,0,41556,18,1
3671141,3281437,1444,127,48400,0,49844,127,1
2095514,1958592,45,2,997,0,1042,2,1
3633377,4856482,319,1,4662,0,4981,1,1
1580988,1449576,2821,22,400133,0,402954,22,1
1049185,2825387,20,4,152,0,172,4,1
2866819,3965191,171,484,613,313,784,797,1
1898822,565151,114,1,3885,0,3999,1,1
4372648,887217,275,387,3150,0,3425,387,1
2580348,723574,164,1515,1662,0,1826,1515,1
1751669,4547559,860,51,9825,0,10685,51,1
1250021,2901525,4637,29,85913,0,90550,29,1
3734245,2783963,915,75,34965,0,35880,75,1
2075015,992556,2664,2,85781,0,88445,2,1
3758019,1761778,189,5,2783,0,2972,5,1
3361377,4658709,4841,4,761793,0,766634,4,1
3502325,1055584,93,5,1096,0,1189,5,1
245479,1107925,473,141,4348,0,4821,141,1
2049062,3357903,199,268,1030,1262,1229,1530,1
4751453,3119032,520,34,27570,0,28090,34,1
781211,83822,976,182,51781,0,52757,182,1
3638272,271957,2022,1,370904,0,372926,1,1
2827436,3914283,882,1,271525,0,272407,1,1
1196844,104686,548,60,36289,0,36837,60,1
4167572,2864994,81,1,6924,0,7005,1,1
2893334,3287255,889,249,30148,0,31037,249,1
1092045,2055597,242,84,9359,0,9601,84,1
1382833,1522419,99,76,442,148,541,224,1
2464401,2840817,577,79,23681,0,24258,79,1
1652056,3059293,326,2,66845,0,67171,2,1
1659017,2130979,817,452,13055,4717,13872,5169,1
1937293,4434739,434,17,16761,0,17195,17,1
1479697,4401341,73,32,917,0,990,32,1
2887240,197444,1143,1,118405,0,119548,1,1
2763282,975194,321,5,10936,0,11257,5,1
4381553,4540686,218,1,1364,0,1582,1,1
2685897,1356934,38,24,4789,0,4827,24,1
1276253,856860,407,1,46534,0,46941,1,1
4023687,3298765,69,17,7295,0,7364,17,1
1534362,1478058,1531,92,105859,0,107390,92,1
4283503,258005,125,12,4904,0,5029,12,1
2950311,1317744,807,1,85116,0,85923,1,1
4023687,4530151,69,317,7295,0,7364,317,1
2024551,1806085,14,1,475,0,489,1,1
291591,4767240,101,8,796,0,897,8,1
1984622,1234947,145,1,20659,0,20804,1,1
3509903,2106753,1530,2,509445,0,510975,2,1
663168,2481548,190,61,420,0,610,61,1
1250021,2968015,4637,23,85913,0,90550,23,1
3091232,2404811,82,4,261,0,343,4,1
4560313,1239865,284,115,4566,0,4850,115,1
1281003,1952594,363,82,2000,0,2363,82,1
1652056,1625649,326,4,66845,0,67171,4,1
593740,4797463,1107,7,62807,0,63914,7,1
1539837,2565060,1127,42,62979,0,64106,42,1
573226,2916028,59,2,4431,0,4490,2,1
543226,1051801,46,50,1545,0,1591,50,1
2772113,2504983,792,192,42907,0,43699,192,1
3294702,2320313,991,35,68888,0,69879,35,1
3280389,2019933,1101,1,411419,0,412520,1,1
3248738,3055345,102,23,4433,0,4535,23,1
2631724,83703,16,3,4171,0,4187,3,1
765601,3000985,1485,2,101510,0,102995,2,1
1250021,301348,4637,19,85913,0,90550,19,1
932720,1471685,1411,1681,111323,25550,112734,27231,1
3982371,195736,59,19,637,0,696,19,1
3361377,1398281,4841,6,761793,0,766634,6,1
765601,945573,1485,45,101510,0,102995,45,1
1276253,4242680,407,1,46534,0,46941,1,1
805360,1352087,1514,35,119306,0,120820,35,1
1652056,3691413,326,4,66845,0,67171,4,1
3065808,4350441,1235,58,82317,0,83552,58,1
3288730,564112,117,164,4627,0,4744,164,1
1609659,2991140,523,8,29763,0,30286,8,1
2261999,2426430,25,137,282,0,307,137,1
354904,1441258,3193,3,105780,0,108973,3,1
3361377,4356688,4841,1,761793,0,766634,1,1
298564,1395740,662,14,6261,0,6923,14,1
611781,1354097,110,4,1404,0,1514,4,1
1989958,3214001,29,13,113,0,142,13,1
2772256,2512673,82,3,4404,0,4486,3,1
1092045,4254131,242,25,9359,0,9601,25,1
2307868,609583,1131,3,38777,0,39908,3,1
1799076,4081887,146,216,3750,0,3896,216,1
3280389,2346241,1101,1,411419,0,412520,1,1
3561502,896402,1144,12,68800,0,69944,12,1
680923,1294772,183,18,542,0,725,18,1
2961801,3664022,1483,15,101962,0,103445,15,1
3438576,3035709,3424,764,137753,0,141177,764,1
544230,1841659,1532,73,60768,0,62300,73,1
2343253,556271,1882,1,86401,0,88283,1,1
4416945,4764857,417,43,33228,0,33645,43,1
3844858,2645830,1591,8,28974,0,30565,8,1
611927,1169688,305,1,8695,0,9000,1,1
1580988,1606680,2821,24,400133,0,402954,24,1
2881604,2875954,7,1,37,0,44,1,1
978797,1085555,599,67,12421,0,13020,67,1
1880135,3080451,810,42,71924,0,72734,42,1
4077562,3189108,433,421,2723,6767,3156,7188,1
2981537,708636,1252,5,118718,0,119970,5,1
687713,4595761,436,3,47160,0,47596,3,1
3549674,2224014,602,23,38542,0,39144,23,1
3672238,3987633,518,425,12172,0,12690,425,1
2851109,2183367,450,1,98552,0,99002,1,1
2405789,3798730,1010,44,93387,0,94397,44,1
837553,3756151,1249,103,61665,0,62914,103,1
307250,3483839,919,2,35588,0,36507,2,1
2033650,1919559,177,17,533,0,710,17,1
92352,3664521,1138,6,20575,0,21713,6,1
1913445,34816,564,35,47943,0,48507,35,1
1534362,4620646,1531,6,105859,0,107390,6,1
380998,1244810,200,114,8943,0,9143,114,1
3988877,3947829,17,24,89,0,106,24,1
117040,2086372,87,3,504,0,591,3,1
1100354,3545529,163,303,24439,0,24602,303,1
765601,430517,1485,63,101510,0,102995,63,1
2853969,2965559,1051,9,42591,0,43642,9,1
2952826,423682,92,59,1299,0,1391,59,1
4204066,373107,78,3,780,0,858,3,1
3509903,3001010,1530,2,509445,0,510975,2,1
2883055,2386921,286,2,13198,0,13484,2,1
1029490,3072585,67,34,290,0,357,34,1
2887240,2610024,1143,1,118405,0,119548,1,1
896087,4209597,102,8,219,0,321,8,1
427805,1132081,483,1,156906,0,157389,1,1
1250021,2706655,4637,2,85913,0,90550,2,1
307250,3977306,919,48,35588,0,36507,48,1
877271,2963736,9,34,208,0,217,34,1
161276,3160445,146,2,6548,0,6694,2,1
1493489,4417736,523,23,17512,0,18035,23,1
2260014,561799,2466,67,98622,0,101088,67,1
2872979,3610042,341,232,28510,0,28851,232,1
2445252,778054,125,151,1491,0,1616,151,1
2938068,357891,112,112,4178,0,4290,112,1
3361377,1839629,4841,1,761793,0,766634,1,1
2428836,462970,56,67,1907,0,1963,67,1
395249,2181765,59,844,702,1019,761,1863,1
1879936,1846176,281,20,6786,0,7067,20,1
18762,2107861,82,535,1159,25743,1241,26278,1
940526,636310,475,3,20786,0,21261,3,1
4671746,4793571,512,83,4544,0,5056,83,1
1494665,3543993,668,7,37638,0,38306,7,1
1995204,3766604,119,16,1174,137,1293,153,1
3115867,2149305,1350,49,61232,0,62582,49,1
3509903,2165351,1530,1,509445,0,510975,1,1
3739473,894751,448,134,13226,0,13674,134,1
3638272,4249044,2022,1,370904,0,372926,1,1
2851109,2016705,450,3,98552,0,99002,3,1
2699054,343425,15,2,248,0,263,2,1
2075015,2452078,2664,130,85781,0,88445,130,1
592541,1809289,132,4,6913,0,7045,4,1
544230,3517670,1532,11,60768,0,62300,11,1
2514271,2219563,387,41,19070,0,19457,41,1
3836080,406658,1197,27,59457,0,60654,27,1
1436274,1246094,49,16,492,0,541,16,1
3150595,259685,78,18,2207,0,2285,18,1
4106313,4847335,161,131,3004,0,3165,131,1
2841828,2970827,106,33,2223,0,2329,33,1
779090,745649,92,15,817,0,909,15,1
3836080,108169,1197,47,59457,0,60654,47,1
4011264,1656500,1360,69,116777,0,118137,69,1
354904,1911284,3193,19,105780,0,108973,19,1
765601,654697,1485,98,101510,0,102995,98,1
3509903,3581594,1530,2,509445,0,510975,2,1
259575,1652277,260,4,13949,0,14209,4,1
3280389,1716262,1101,2,411419,0,412520,2,1
471706,2445775,794,16,65616,0,66410,16,1
3294702,1596251,991,77,68888,0,69879,77,1
2342664,3672253,1181,10,26502,0,27683,10,1
1788426,4289469,14,483,142,0,156,483,1
4360960,3370759,1642,117,110084,0,111726,117,1
4179343,2416627,119,104,9822,0,9941,104,1
4817410,3979356,31,6,1422,0,1453,6,1
2887240,2439471,1143,5,118405,0,119548,5,1
4678614,382235,452,144,16881,0,17333,144,1
2958239,4774482,101,1,3638,0,3739,1,1
1841651,1556337,74,1177,454,585,528,1762,1
932720,3549347,1411,282,111323,0,112734,282,1
1099273,1833046,6,6,66,0,72,6,1
2985909,640389,706,147,43348,0,44054,147,1
2492402,555471,336,126,1778,0,2114,126,1
4324896,1736710,31,163,362,0,393,163,1
2884705,331057,649,55,10233,0,10882,55,1
582276,3398265,298,23,10990,0,11288,23,1
3177626,3540344,26,201,98,0,124,201,1
1276253,3059012,407,1,46534,0,46941,1,1
3509903,873247,1530,74,509445,0,510975,74,1
2827436,861612,882,3,271525,0,272407,3,1
2981537,4713646,1252,2,118718,0,119970,2,1
3142714,4373897,35,13,1436,0,1471,13,1
1809661,4560552,19,38,274,0,293,38,1
1580988,2356984,2821,2,400133,0,402954,2,1
957197,2665193,614,5,37109,0,37723,5,1
1219168,3115867,36,1350,196,61232,232,62582,1
4492248,2043186,237,3,17127,0,17364,3,1
2631553,3026930,1,2,27,0,28,2,1
873006,3900311,375,54,33630,0,34005,54,1
907654,105791,798,36,24575,0,25373,36,1
3645402,4397068,153,80,7400,0,7553,80,1
3930096,3598982,21,24,319,0,340,24,1
4272102,2808028,1608,168,104171,0,105779,168,1
1652056,1431032,326,3,66845,0,67171,3,1
2762372,3026546,818,3,6089,0,6907,3,1
3509903,585995,1530,1,509445,0,510975,1,1
2572273,896500,240,1153,1587,0,1827,1153,1
1086912,1280329,907,35,33396,0,34303,35,1
354904,2069792,3193,133,105780,0,108973,133,1
680662,2319721,365,83,5393,0,5758,83,1
3721550,190306,188,50,14527,0,14715,50,1
3567246,1082041,192,15,3712,0,3904,15,1
1417425,3296103,640,5,2016,0,2656,5,1
4750424,785619,36,28,2464,0,2500,28,1
3980505,2713170,255,17,6464,0,6719,17,1
1370197,2579528,665,234,3306,0,3971,234,1
3501482,2717369,522,62,28046,0,28568,62,1
1293807,1544223,1837,3,30865,0,32702,3,1
2120733,2593461,819,27,20803,1262,21622,1289,1
2827436,3744459,882,2,271525,0,272407,2,1
1739906,3283837,15,26,44,52,59,78,1
2411667,1220760,23,1,229,0,252,1,1
3638272,3862806,2022,1,370904,0,372926,1,1
530200,3895451,2035,8,62809,0,64844,8,1
4383778,1320422,31,38,963,0,994,38,1
3271484,3057325,1507,4,34093,0,35600,4,1
1880135,2172112,810,23,71924,0,72734,23,1
2985909,3944907,706,109,43348,0,44054,109,1
2758918,511838,35,242,222,688,257,930,1
3883671,3041000,170,437,865,0,1035,437,1
1357867,1664495,103,134,217,543,320,677,1
1927211,3908961,1668,29,113322,0,114990,29,1
860473,2566357,751,19,20450,0,21201,19,1
813554,818636,252,58,17214,0,17466,58,1
1580988,4837511,2821,6,400133,0,402954,6,1
3361380,1277634,342,1,2750,0,3092,1,1
3873768,4005147,449,3,35424,0,35873,3,1
3383252,3067549,281,684,3966,1696,4247,2380,1
3914135,3004664,2152,10,60084,0,62236,10,1
2113984,4391395,49,34,505,0,554,34,1
4030529,3905912,299,23,3324,0,3623,23,1
4361636,1782721,186,1,1867,0,2053,1,1
2260014,990035,2466,84,98622,0,101088,84,1
2755798,3783446,494,25,24862,0,25356,25,1
1503116,3017894,415,34,37079,0,37494,34,1
582276,839182,298,89,10990,0,11288,89,1
1591435,1159479,387,81,31245,0,31632,81,1
4370819,3710287,403,46,6519,0,6922,46,1
4708835,4009848,190,179,7539,0,7729,179,1
4092627,644886,62,287,650,0,712,287,1
3561502,4127680,1144,34,68800,0,69944,34,1
3509903,1989524,1530,1,509445,0,510975,1,1
4440160,3999004,736,163,20522,0,21258,163,1
3676295,2576384,374,1,70881,0,71255,1,1
829561,1243397,49,33,2109,0,2158,33,1
3881566,2008093,781,6,14176,0,14957,6,1
1591435,2252100,387,5,31245,0,31632,5,1
1580988,4174231,2821,90,400133,1471,402954,1561,1
3454888,3334659,162,41,7886,0,8048,41,1
3638272,459256,2022,1,370904,0,372926,1,1
2260014,171133,2466,13,98622,0,101088,13,1
2985909,3392400,706,64,43348,0,44054,64,1
358023,1971223,151,338,1333,5185,1484,5523,1
4209323,4796280,1630,17,89460,0,91090,17,1
3140664,3676010,268,27,16099,0,16367,27,1
1262859,2404411,28,1841,306,15,334,1856,1
4058687,1138849,418,271,3486,0,3904,271,1
3676295,416623,374,2,70881,0,71255,2,1
4300088,2850435,438,247,76,145,514,392,1
1560049,3799712,1121,72,12468,0,13589,72,1
451191,1392977,132,83,1659,0,1791,83,1
4327096,3043532,234,5,2944,0,3178,5,1
3123201,1575752,126,3,5539,0,5665,3,1
860473,1339131,751,43,20450,0,21201,43,1
3785097,3933436,39,47,232,197,271,244,1
1573341,3391309,40,122,317,449,357,571,1
3361377,784878,4841,1,761793,0,766634,1,1
4849993,2109221,156,2,2873,0,3029,2,1
2147720,345988,1608,107,78786,0,80394,107,1
3509903,2643317,1530,5,509445,0,510975,5,1
837553,414608,1249,50,61665,5531,62914,5581,1
4392239,4657146,108,26,561,0,669,26,1
2950311,311298,807,107,85116,0,85923,107,1
4649206,1800879,566,36,31367,0,31933,36,1
3280389,839334,1101,1,411419,0,412520,1,1
1092806,1367688,53,101,215,557,268,658,1
2883055,92617,286,144,13198,0,13484,144,1
1652056,2136373,326,24,66845,0,67171,24,1
2529661,3000142,493,85,27309,0,27802,85,1
2827436,776025,882,2,271525,0,272407,2,1
4084861,2527114,128,225,160,409,288,634,1
4209323,2661129,1630,112,89460,0,91090,112,1
3144238,3951096,326,80,28455,0,28781,80,1
4360960,3890381,1642,17,110084,0,111726,17,1
2573230,3122659,9,6,127,0,136,6,1
4435816,1565864,262,102,8391,620,8653,722,1
708440,879011,302,12,9329,0,9631,12,1
1016317,1640100,83,98,572,0,655,98,1
91116,1539808,239,48,2466,190,2705,238,1
4049854,3018498,33,13,113,0,146,13,1
4360960,4319911,1642,428,110084,0,111726,428,1
2191846,3616797,51,84,1499,0,1550,84,1
3280389,3442973,1101,2,411419,0,412520,2,1
1445380,3095444,40,2,4396,0,4436,2,1
2761141,3421899,11,143,224,0,235,143,1
1515312,4820969,31,141,143,0,174,141,1
2260014,1217752,2466,4,98622,0,101088,4,1
3065808,2292951,1235,93,82317,0,83552,93,1
3189108,4237847,421,112,6767,0,7188,112,1
2781817,2444323,704,153,24613,0,25317,153,1
3881566,3533041,781,68,14176,0,14957,68,1
3517811,3677324,60,94,11929,0,11989,94,1
4496752,3216464,554,3,16258,0,16812,3,1
2861639,1722086,481,151,10848,0,11329,151,1
4730895,2076921,125,96,1911,0,2036,96,1
3065808,1335065,1235,3,82317,0,83552,3,1
1064989,1083574,140,115,1201,0,1341,115,1
4123758,3531698,216,90,4336,0,4552,90,1
60980,2742107,649,1,20708,0,21357,1,1
1601507,394204,129,17,6006,0,6135,17,1
1580988,1862014,2821,1,400133,0,402954,1,1
3549674,1280684,602,11,38542,0,39144,11,1
4710180,1030840,160,257,1348,0,1508,257,1
1604785,193736,139,274,1999,767,2138,1041,1
3361377,2177127,4841,8,761793,0,766634,8,1
3101239,4761825,125,5,1614,0,1739,5,1
1339664,638753,228,88,6682,1817,6910,1905,1
4689808,804938,280,25,14220,0,14500,25,1
3827240,4689348,356,3,7496,0,7852,3,1
2827436,3424669,882,5,271525,0,272407,5,1
1910777,4654593,477,22,1910,0,2387,22,1
2743659,352601,420,17,4277,0,4697,17,1
2915820,2294403,476,5,1811,0,2287,5,1
4744679,3845288,247,5,3462,0,3709,5,1
855821,869405,770,28,5493,0,6263,28,1
3361377,2662353,4841,1,761793,0,766634,1,1
1000106,1028819,972,4,2608,0,3580,4,1
2950311,1820819,807,46,85116,0,85923,46,1
429643,4457222,767,48,19668,0,20435,48,1
3509903,3952717,1530,5,509445,0,510975,5,1
273363,2571723,768,123,11045,0,11813,123,1
2260014,3660302,2466,1,98622,0,101088,1,1
4272102,4753288,1608,19,104171,0,105779,19,1
439557,981981,2090,21,61744,0,63834,21,1
3280389,1025158,1101,1,411419,0,412520,1,1
3765475,1940574,873,1,107914,0,108787,1,1
3361377,1889411,4841,1,761793,0,766634,1,1
1503116,4587224,415,57,37079,0,37494,57,1
2887240,1680298,1143,2,118405,0,119548,2,1
3753643,823413,247,25,2001,0,2248,25,1
2851109,564252,450,226,98552,0,99002,226,1
846208,2471389,600,103,17288,0,17888,103,1
4360960,1089502,1642,26,110084,0,111726,26,1
3120890,2123089,141,50,1294,0,1435,50,1
4208653,2732723,1820,556,21104,0,22924,556,1
1534362,2022885,1531,36,105859,0,107390,36,1
3438576,4783446,3424,1,137753,0,141177,1,1
2981537,2888338,1252,3,118718,0,119970,3,1
3065808,1962086,1235,141,82317,0,83552,141,1
2994391,4328869,315,315,6520,0,6835,315,1
1580988,4828089,2821,3,400133,0,402954,3,1
1436216,151737,1068,311,68770,0,69838,311,1
3630714,1360513,257,16,7929,0,8186,16,1
4656285,4383250,1446,467,35428,0,36874,467,1
3137585,4483882,1196,111,77354,0,78550,111,1
1993295,3717116,80,5,1466,0,1546,5,1
3881634,118994,641,6,8471,0,9112,6,1
710313,307648,101,42,696,0,797,42,1
2743659,897181,420,2,4277,0,4697,2,1
4045699,2786455,126,9,1522,0,1648,9,1
2498087,4807420,1630,33,32582,0,34212,33,1
3189108,338412,421,190,6767,0,7188,190,1
829561,3539363,49,53,2109,0,2158,53,1
670587,3255838,651,13,9779,0,10430,13,1
2343253,2023683,1882,1,86401,0,88283,1,1
2164178,3008995,574,45,6134,0,6708,45,1
2348093,4329402,335,44,12064,0,12399,44,1
4011264,2165264,1360,6,116777,0,118137,6,1
1062967,1109271,260,1,15276,0,15536,1,1
1301815,1013828,752,32,48944,0,49696,32,1
745032,364665,510,903,3189,0,3699,903,1
3984303,927494,133,2,4489,0,4622,2,1
60980,3645036,649,7,20708,0,21357,7,1
611927,2973645,305,147,8695,0,9000,147,1
471706,4672063,794,2,65616,0,66410,2,1
2887240,4539133,1143,1,118405,0,119548,1,1
708290,1406206,317,324,5975,0,6292,324,1
2343253,2918467,1882,2,86401,0,88283,2,1
3065808,1422696,1235,53,82317,0,83552,53,1
3845119,887684,461,106,28609,0,29070,106,1
431086,3931890,619,149,14910,0,15529,149,1
2527654,2014031,39,5,1740,0,1779,5,1
2348182,3844843,469,112,4747,0,5216,112,1
1887669,2024980,733,33,23145,0,23878,33,1
3059686,1525030,460,12,4530,0,4990,12,1
3361377,4860474,4841,3,761793,0,766634,3,1
1480314,3254749,35,104,267,0,302,104,1
3671141,4094568,1444,14,48400,0,49844,14,1
1051852,3267585,253,234,1195,0,1448,234,1
1219739,4733778,27,265,90,99,117,364,1
3907996,1244531,485,153,18964,0,19449,153,1
4087774,1612361,578,21,10107,0,10685,21,1
1428477,1769696,255,459,15459,0,15714,459,1
3140664,3015457,268,137,16099,0,16367,137,1
3271484,4326504,1507,188,34093,0,35600,188,1
3112136,4532591,406,63,41366,0,41772,63,1
2950311,1386082,807,20,85116,0,85923,20,1
1652056,1681734,326,25,66845,0,67171,25,1
957197,3611619,614,14,37109,0,37723,14,1
1717922,3150468,432,165,6340,0,6772,165,1
3913751,4862920,229,30,5248,0,5477,30,1
1880135,2027002,810,674,71924,0,72734,674,1
4619326,4437137,539,109,22721,0,23260,109,1
1580988,54997,2821,1,400133,0,402954,1,1
703809,4464086,340,89,84,0,424,89,1
3361377,988472,4841,1,761793,0,766634,1,1
249932,2511837,93,17,981,0,1074,17,1
3280389,287874,1101,2,411419,0,412520,2,1
652714,1154665,64,33,1815,0,1879,33,1
3361377,2119557,4841,11,761793,0,766634,11,1
3137900,2792086,357,221,6655,0,7012,221,1
1973082,3750558,1036,7,18915,0,19951,7,1
2726187,1141755,162,101,1230,0,1392,101,1
3605448,3425338,202,1,2022,0,2224,1,1
3361377,1803917,4841,1,761793,0,766634,1,1
3509903,2571100,1530,10,509445,0,510975,10,1
3361377,1148126,4841,7,761793,0,766634,7,1
3873768,3410221,449,72,35424,0,35873,72,1
3549674,1237524,602,56,38542,0,39144,56,1
1966548,931245,208,2,53149,0,53357,2,1
1887669,1403562,733,42,23145,0,23878,42,1
1011595,3825191,45,64,206,126,251,190,1
427805,4269159,483,1,156906,0,157389,1,1
2198120,4391778,21,24,3083,0,3104,24,1
427805,2162884,483,1,156906,0,157389,1,1
1580988,2021231,2821,1,400133,0,402954,1,1
957197,667604,614,17,37109,0,37723,17,1
4435816,418685,262,33,8391,179,8653,212,1
3992144,1378986,402,4,23683,0,24085,4,1
3910135,741697,298,44,14348,0,14646,44,1
1503116,4645038,415,20,37079,0,37494,20,1
1880135,2050840,810,83,71924,0,72734,83,1
2774493,1036734,551,71,12712,0,13263,71,1
3452706,1125432,245,298,2116,2434,2361,2732,1
3988690,1063893,10,138,148,0,158,138,1
1927211,2918160,1668,7,113322,0,114990,7,1
2381712,218837,82,18,1479,0,1561,18,1
2542968,2809667,444,16,4728,0,5172,16,1
2553405,141067,568,432,12913,2002,13481,2434,1
802229,22278,168,20,3140,0,3308,20,1
1302093,1538552,48,1,1219,0,1267,1,1
2119841,1478080,272,593,1846,7009,2118,7602,1
1575009,861971,429,68,37745,0,38174,68,1
1486758,1081103,337,10,11346,0,11683,10,1
2685897,1546662,38,20,4789,0,4827,20,1
515290,949839,285,173,34080,0,34365,173,1
2092359,4276928,421,8,26936,0,27357,8,1
779090,1957026,92,43,817,0,909,43,1
932720,1431318,1411,75,111323,0,112734,75,1
2755798,157424,494,5,24862,0,25356,5,1
4492248,1655054,237,4,17127,0,17364,4,1
948768,3469146,587,351,14768,0,15355,351,1
4011264,4110576,1360,85,116777,0,118137,85,1
543226,4363437,46,2,1545,0,1591,2,1
1927211,2363870,1668,19,113322,0,114990,19,1
1723506,2917203,733,98,21835,0,22568,98,1
1534362,1008020,1531,170,105859,0,107390,170,1
2553405,3623646,568,71,12913,0,13481,71,1
873006,3892986,375,64,33630,0,34005,64,1
3845119,4853713,461,131,28609,0,29070,131,1
613207,1025192,2,50,52,13,54,63,1
1497278,2973842,1869,65,35111,0,36980,65,1
805360,2835888,1514,16,119306,0,120820,16,1
2536472,3881981,344,375,9725,0,10069,375,1
2854744,2251618,92,1,1158,0,1250,1,1
4801471,3108914,585,301,17979,0,18564,301,1
1856926,1252354,25,3,219,0,244,3,1
961349,1181820,154,259,5849,0,6003,259,1
2148937,4250221,672,4,47361,0,48033,4,1
3509903,1358133,1530,2,509445,0,510975,2,1
3361377,3881179,4841,1,761793,0,766634,1,1
4252367,4811444,70,23,655,0,725,23,1
3676295,2687149,374,10,70881,0,71255,10,1
3509903,1292515,1530,1,509445,0,510975,1,1
2911269,1964006,740,45,20606,0,21346,45,1
858791,86328,110,267,2663,0,2773,267,1
2214458,1516101,41,1529,604,71,645,1600,1
3361377,2129901,4841,2,761793,0,766634,2,1
932720,2406804,1411,28,111323,0,112734,28,1
3501482,2641141,522,222,28046,0,28568,222,1
3863202,4653941,137,951,785,45883,922,46834,1
713414,4325229,106,6,213,0,319,6,1
3361377,3595880,4841,1,761793,0,766634,1,1
3509903,1903924,1530,4,509445,0,510975,4,1
2096270,4639762,970,183,26018,0,26988,183,1
2804074,4596781,115,53,2343,0,2458,53,1
4130310,1026386,7,3,221,0,228,3,1
1644171,2813541,1071,3,3690,0,4761,3,1
3235479,1758318,999,14,66486,0,67485,14,1
1591435,4737701,387,10,31245,0,31632,10,1
3514277,143900,1338,175,13269,0,14607,175,1
929454,23673,75,10,1399,0,1474,10,1
1513384,1865361,163,23,517,0,680,23,1
573101,726196,781,48,12750,0,13531,48,1
3141828,2695852,38,18,343,0,381,18,1
1580988,271437,2821,1,400133,0,402954,1,1
1875,4782536,656,1,61388,0,62044,1,1
354904,4857310,3193,35,105780,0,108973,35,1
2981537,4130694,1252,4,118718,0,119970,4,1
3837347,2175373,169,95,2761,0,2930,95,1
2405789,2651513,1010,20,93387,0,94397,20,1
3509903,4008700,1530,1,509445,0,510975,1,1
2985909,1639651,706,61,43348,0,44054,61,1
3658026,1120442,223,48,1451,0,1674,48,1
1219267,1842356,238,32,1605,0,1843,32,1
3280389,4714201,1101,3,411419,0,412520,3,1
3438576,4042205,3424,3,137753,0,141177,3,1
3112136,965178,406,72,41366,0,41772,72,1
1994281,3016084,139,35,2492,0,2631,35,1
196521,2686172,1176,16,11269,0,12445,16,1
1580988,3656510,2821,6,400133,0,402954,6,1
1370363,1211062,115,119,704,0,819,119,1
3361377,2169718,4841,2,761793,0,766634,2,1
596012,2243542,192,10,3561,0,3753,10,1
4853234,3325901,1256,5,29554,0,30810,5,1
873006,264350,375,6,33630,0,34005,6,1
3115867,3944872,1350,1,61232,0,62582,1,1
3638272,799642,2022,1,370904,0,372926,1,1
1541866,861735,542,16,16481,0,17023,16,1
1735116,2958945,503,60,16146,0,16649,60,1
4208653,4060710,1820,31,21104,0,22924,31,1
173493,2823167,46,58,1959,0,2005,58,1
1966548,3658668,208,27,53149,0,53357,27,1
4220190,4406724,320,92,15994,0,16314,92,1
4011264,341282,1360,163,116777,0,118137,163,1
2314038,3501052,456,23,16347,0,16803,23,1
3280389,1457424,1101,2,411419,0,412520,2,1
2647342,1875674,68,50,1550,0,1618,50,1
2377682,264488,33,415,453,0,486,415,1
3280389,3797109,1101,2,411419,0,412520,2,1
1503116,3625189,415,195,37079,0,37494,195,1
4750855,4663094,355,254,18880,0,19235,254,1
2112194,337652,35,19,1281,0,1316,19,1
4826918,4785112,190,84,36,79,226,163,1
1051108,1353440,262,125,7542,0,7804,125,1
2023979,4510168,192,78,3227,0,3419,78,1
3278135,1190527,358,78,7252,0,7610,78,1
2260014,3908154,2466,1,98622,0,101088,1,1
1432079,2619031,118,36,2194,0,2312,36,1
3718020,3099422,305,202,6132,0,6437,202,1
2107861,4369854,535,4,25743,0,26278,4,1
4416945,3723597,417,37,33228,0,33645,37,1
2827436,4356277,882,4,271525,0,272407,4,1
3638272,2040555,2022,1,370904,0,372926,1,1
1634906,2789932,37,1,356,0,393,1,1
2785529,1097340,57,2,728,0,785,2,1
2260014,3984302,2466,85,98622,0,101088,85,1
1397278,2781702,185,870,2295,0,2480,870,1
4209323,1461343,1630,9,89460,0,91090,9,1
1328699,4228143,83,713,1943,0,2026,713,1
3765475,1739797,873,1,107914,0,108787,1,1
1966548,2886031,208,1,53149,0,53357,1,1
1086912,3354855,907,122,33396,0,34303,122,1
1192608,845884,41,1,360,0,401,1,1
1250021,697711,4637,5,85913,0,90550,5,1
439557,4758904,2090,219,61744,0,63834,219,1
499414,307250,316,919,3543,35588,3859,36507,1
268844,64373,422,60,5070,0,5492,60,1
2887240,4224089,1143,2,118405,0,119548,2,1
2662809,4112383,303,3,10704,0,11007,3,1
4656285,2615643,1446,24,35428,0,36874,24,1
3509903,2414832,1530,1,509445,0,510975,1,1
4547438,627076,1291,72,25237,0,26528,72,1
1539837,1199301,1127,1,62979,0,64106,1,1
2754920,3642719,22,5,580,0,602,5,1
497049,3323310,29,22,497,0,526,22,1
1031334,3264386,459,53,16840,0,17299,53,1
2260014,837529,2466,3,98622,0,101088,3,1
2804506,4373070,6,25,1303,0,1309,25,1
439557,2949168,2090,37,61744,0,63834,37,1
2206348,1073598,16,14,139,0,155,14,1
1012816,4158997,15,3,302,0,317,3,1
4492248,2516219,237,3,17127,0,17364,3,1
3280389,3801137,1101,1,411419,0,412520,1,1
3768176,3553125,167,5,1980,0,2147,5,1
2981537,2721966,1252,2,118718,0,119970,2,1
4209323,3434788,1630,24,89460,0,91090,24,1
3361377,1024214,4841,1,761793,0,766634,1,1
2981537,2735607,1252,1,118718,0,119970,1,1
1436216,89833,1068,295,68770,0,69838,295,1
4705188,2301472,336,14,8658,0,8994,14,1
1219267,3398713,238,3,1605,0,1843,3,1
4408153,2268526,58,29,1129,0,1187,29,1
2074294,2709175,29,55,335,0,364,55,1
2980603,3109303,30,3,544,0,574,3,1
3606650,2092855,6,3,295,0,301,3,1
3873768,4068680,449,84,35424,0,35873,84,1
3764177,3498868,1036,50,64563,0,65599,50,1
3361377,4838083,4841,5,761793,0,766634,5,1
3750582,1537829,183,70,393,0,576,70,1
3907996,1589759,485,39,18964,0,19449,39,1
439557,1514277,2090,65,61744,0,63834,65,1
1894807,3344390,128,309,1819,4274,1947,4583,1
4631961,2141068,42,184,214,0,256,184,1
3235479,2026665,999,44,66486,0,67485,44,1
2694929,4121930,186,100,4613,0,4799,100,1
941212,173672,184,8,6404,0,6588,8,1
2431217,3084091,15,65,98,0,113,65,1
3983436,73377,376,87,3267,717,3643,804,1
3430614,1901677,95,172,2668,0,2763,172,1
1250021,3940495,4637,29,85913,0,90550,29,1
2498087,2120418,1630,70,32582,0,34212,70,1
3361377,51551,4841,3,761793,0,766634,3,1
3234025,2071721,127,130,3830,0,3957,130,1
3063070,2260014,29,2466,121,98622,150,101088,1
3294702,1855892,991,5,68888,0,69879,5,1
1554762,984405,24,6,184,0,208,6,1
1333761,159170,193,94,5573,0,5766,94,1
2722942,1224393,240,182,8655,0,8895,182,1
3632293,2283648,570,39,21294,0,21864,39,1
3768601,2385216,263,41,1680,0,1943,41,1
1400646,4238384,80,3,1995,0,2075,3,1
3509903,2117154,1530,1,509445,0,510975,1,1
2851109,2238334,450,6,98552,0,99002,6,1
3883671,3557680,170,5,865,0,1035,5,1
4209323,3386955,1630,58,89460,0,91090,58,1
1609659,745838,523,60,29763,0,30286,60,1
354904,1086309,3193,17,105780,0,108973,17,1
2101710,1621532,152,15,6934,0,7086,15,1
932720,2953849,1411,37,111323,0,112734,37,1
3257465,1496036,541,165,27614,0,28155,165,1
1880135,4561531,810,58,71924,0,72734,58,1
4625755,2916918,130,462,1609,89,1739,551,1
1621606,3637687,559,11,4228,0,4787,11,1
1302472,2294283,164,7,3470,0,3634,7,1
1659017,2287991,817,87,13055,0,13872,87,1
1763353,3853777,126,2,10072,0,10198,2,1
1831198,3082042,450,101,5884,0,6334,101,1
3361377,4311164,4841,1,761793,0,766634,1,1
3633377,181821,319,22,4662,0,4981,22,1
4751453,134886,520,188,27570,0,28090,188,1
3361377,3337471,4841,1,761793,0,766634,1,1
597648,4171190,29,35,1880,0,1909,35,1
1789632,1809926,46,2452,2029,130,2075,2582,1
1103332,2211033,732,54,59415,0,60147,54,1
3206499,892722,1337,3,32033,0,33370,3,1
3137585,1541160,1196,22,77354,0,78550,22,1
4358855,3367268,36,2,2475,0,2511,2,1
3759853,1996796,451,17,16330,0,16781,17,1
1616819,709337,20,47,116,0,136,47,1
4525011,1488337,172,46,6076,0,6248,46,1
4621719,3937434,306,527,4102,0,4408,527,1
2261139,3019577,2014,188,42851,0,44865,188,1
3509903,790394,1530,1,509445,0,510975,1,1
4552666,2438520,341,14,9279,0,9620,14,1
2075015,3712439,2664,5,85781,0,88445,5,1
4313572,3219167,930,1,16971,0,17901,1,1
3301352,333103,33,9,3948,0,3981,9,1
4473438,4576837,37,1,196,0,233,1,1
1759782,2525006,173,25,862,81,1035,106,1
2633981,2583017,83,4,836,0,919,4,1
1302472,930330,164,274,3470,0,3634,274,1
3242275,4285292,551,104,17400,0,17951,104,1
4162259,2365306,345,146,2433,0,2778,146,1
4574571,3195005,186,28,6965,0,7151,28,1
681618,3904989,75,1,8789,0,8864,1,1
3638272,1629501,2022,1,370904,0,372926,1,1
2191194,653795,21,54,2190,0,2211,54,1
1580988,3608866,2821,8,400133,0,402954,8,1
3871554,155709,947,21,16042,0,16989,21,1
1913445,1457506,564,127,47943,0,48507,127,1
135360,1161383,333,57,2006,0,2339,57,1
2950311,1448186,807,30,85116,0,85923,30,1
805360,4178716,1514,45,119306,0,120820,45,1
3137585,4396184,1196,21,77354,0,78550,21,1
2950311,3686134,807,14,85116,0,85923,14,1
4060234,3596995,69,9,1200,0,1269,9,1
2148937,3728779,672,1,47361,0,48033,1,1
92352,4741015,1138,139,20575,0,21713,139,1
3214893,348726,1087,73,6553,0,7640,73,1
4789203,2780031,355,10,11315,0,11670,10,1
3294702,2270881,991,14,68888,0,69879,14,1
1839529,3585479,88,9,1985,0,2073,9,1
105414,2599166,201,656,2136,0,2337,656,1
2644133,2021851,53,19,1100,0,1153,19,1
1250021,36076,4637,41,85913,0,90550,41,1
3549674,1991506,602,267,38542,0,39144,267,1
2281149,2254865,282,128,28082,0,28364,128,1
2464401,351324,577,62,23681,0,24258,62,1
3438576,1675847,3424,10,137753,0,141177,10,1
4197224,64448,253,309,708,54,961,363,1
907654,3920146,798,66,24575,0,25373,66,1
1913445,439524,564,15,47943,0,48507,15,1
2326007,1916254,94,2,3295,0,3389,2,1
1327933,609941,866,97,4229,0,5095,97,1
4416945,4387227,417,61,33228,0,33645,61,1
1927211,1342056,1668,14,113322,0,114990,14,1
3384074,2007528,72,171,1677,696,1749,867,1
4496752,2973151,554,53,16258,0,16812,53,1
4850593,134963,169,251,4365,0,4534,251,1
2494800,425223,752,287,5329,0,6081,287,1
4209323,1734319,1630,156,89460,0,91090,156,1
1453862,434888,112,335,498,102,610,437,1
3449530,4231563,717,5,73648,0,74365,5,1
1923830,4790087,181,72,2733,0,2914,72,1
1234540,3321393,1071,43,75251,0,76322,43,1
3137585,2499066,1196,106,77354,0,78550,106,1
3633019,1169216,746,20,32317,0,33063,20,1
3488762,3379643,145,41,4916,0,5061,41,1
2981537,1500478,1252,3,118718,0,119970,3,1
1580988,2237044,2821,2,400133,0,402954,2,1
3002746,4653859,286,19,3847,0,4133,19,1
787474,2764060,71,18,142,0,213,18,1
1717922,1950470,432,504,6340,0,6772,504,1
1575009,3751944,429,14,37745,0,38174,14,1
4208653,1471900,1820,257,21104,0,22924,257,1
4220190,2911779,320,1,15994,0,16314,1,1
1055530,612907,415,320,14969,0,15384,320,1
18228,1377120,122,161,3947,0,4069,161,1
1548879,3088957,21,146,108,366,129,512,1
88059,1324612,33,25,1099,0,1132,25,1
1539837,900391,1127,2,62979,0,64106,2,1
4272102,4224244,1608,22,104171,0,105779,22,1
36074,2910192,66,170,2609,0,2675,170,1
593740,2783343,1107,171,62807,0,63914,171,1
3438576,4453968,3424,19,137753,0,141177,19,1
2278719,2544357,107,1,786,0,893,1,1
1139873,1385246,670,146,10236,0,10906,146,1
3361377,4739700,4841,1,761793,0,766634,1,1
2861639,4699105,481,16,10848,0,11329,16,1
1537245,1153765,26,1,215,0,241,1,1
882750,2327541,27,122,344,0,371,122,1
1125432,4222270,298,206,2434,0,2732,206,1
4052496,885874,107,40,4222,0,4329,40,1
530200,2186320,2035,67,62809,0,64844,67,1
2405789,2001718,1010,42,93387,0,94397,42,1
1534362,638879,1531,157,105859,0,107390,157,1
4406088,3457782,21,2,1106,0,1127,2,1
593740,2897415,1107,90,62807,0,63914,90,1
3137585,1919194,1196,171,77354,0,78550,171,1
1698800,2450641,28,20,87,0,115,20,1
2547306,2419664,171,385,1899,0,2070,385,1
4193534,4404864,82,10,6961,0,7043,10,1
1110514,3264687,68,3,3569,0,3637,3,1
3638272,309535,2022,10,370904,0,372926,10,1
3280389,4328243,1101,1,411419,0,412520,1,1
4745784,694513,49,65,1839,0,1888,65,1
525570,115745,470,321,3665,0,4135,321,1
4120770,4836494,58,4,150,0,208,4,1
4330391,130259,773,193,32759,0,33532,193,1
2050190,2186406,153,6,9156,0,9309,6,1
1575009,392836,429,141,37745,0,38174,141,1
3638272,424923,2022,1,370904,0,372926,1,1
2961801,4229571,1483,110,101962,0,103445,110,1
3387987,4391920,268,7,19035,0,19303,7,1
3271484,4742574,1507,26,34093,0,35600,26,1
1541866,2132409,542,30,16481,0,17023,30,1
4710933,997639,126,149,1331,136,1457,285,1
354904,1742923,3193,11,105780,0,108973,11,1
171490,1272068,5,21,71,0,76,21,1
3633019,4349,746,21,32317,0,33063,21,1
896754,116563,39,65,298,0,337,65,1
4467395,2229062,2084,340,14574,0,16658,340,1
3291396,3037056,195,49,11502,0,11697,49,1
3633019,1540740,746,45,32317,0,33063,45,1
1927211,3383827,1668,23,113322,0,114990,23,1
1301815,510011,752,11,48944,0,49696,11,1
4449089,2000752,17,1592,718,162,735,1754,1
1164238,2293561,179,297,2363,0,2542,297,1
1251567,1753310,71,123,387,0,458,123,1
3509903,4188260,1530,1,509445,0,510975,1,1
1086912,1113348,907,142,33396,1417,34303,1559,1
2847192,4221618,105,96,3937,0,4042,96,1
3638272,4175917,2022,2,370904,0,372926,2,1
20836,4862996,38,7,446,0,484,7,1
886382,2222190,131,19,243,0,374,19,1
3582351,856892,115,1,1268,0,1383,1,1
1792932,3260109,153,542,901,176,1054,718,1
4649206,248417,566,85,31367,0,31933,85,1
837459,946038,82,300,882,301,964,601,1
941640,985712,336,84,677,0,1013,84,1
3361377,2438836,4841,2,761793,0,766634,2,1
4030529,3848879,299,73,3324,0,3623,73,1
4183784,632826,931,24,59894,0,60825,24,1
4702756,4341548,327,10,2851,0,3178,10,1
1341178,3856816,899,66,16829,0,17728,66,1
3979972,1326549,407,4,2364,0,2771,4,1
2148937,4302244,672,160,47361,0,48033,160,1
1503116,2792243,415,34,37079,0,37494,34,1
765601,328839,1485,128,101510,0,102995,128,1
4267540,2169589,209,1,2240,0,2449,1,1
636814,1393855,116,25,9387,0,9503,25,1
2950311,2270938,807,34,85116,0,85923,34,1
3361377,943759,4841,75,761793,0,766634,75,1
414608,3252586,50,1,5531,0,5581,1,1
3906136,4646206,387,31,41169,0,41556,31,1
3683258,2109857,130,32,1772,0,1902,32,1
4621719,268800,306,567,4102,0,4408,567,1
4596817,1961838,160,2,1879,0,2039,2,1
4209323,4774686,1630,30,89460,0,91090,30,1
4547438,4648384,1291,37,25237,0,26528,37,1
4360960,882484,1642,20,110084,0,111726,20,1
2306134,3484176,337,44,5153,0,5490,44,1
504676,3396269,921,98,2940,0,3861,98,1
805360,2635915,1514,10,119306,0,120820,10,1
2827436,1302880,882,1,271525,0,272407,1,1
866357,1096820,825,3,18479,0,19304,3,1
1024246,3845119,52,461,1084,28609,1136,29070,1
2443764,3932787,260,366,6836,0,7096,366,1
3906136,1274061,387,5,41169,0,41556,5,1
4528103,119729,268,52,14258,0,14526,52,1
2147720,398123,1608,48,78786,0,80394,48,1
1534362,1242665,1531,11,105859,0,107390,11,1
3260961,2881425,288,102,7637,5272,7925,5374,1
3509903,2813440,1530,2,509445,0,510975,2,1
2827436,1474546,882,2,271525,0,272407,2,1
648163,3837197,238,251,1998,0,2236,251,1
3280389,3923210,1101,1,411419,0,412520,1,1
3419989,581569,350,94,16316,0,16666,94,1
69534,1519597,60,1,4328,0,4388,1,1
2772113,2186492,792,324,42907,0,43699,324,1
3002200,1030056,637,27,510,0,1147,27,1
2950311,3302358,807,3,85116,0,85923,3,1
92352,2283376,1138,248,20575,0,21713,248,1
1580988,4803883,2821,1,400133,0,402954,1,1
285124,4618831,135,105,4250,1754,4385,1859,1
3271484,2105629,1507,31,34093,0,35600,31,1
892512,3432767,1505,187,11757,0,13262,187,1
1875,1530370,656,4,61388,0,62044,4,1
3705965,3661404,190,125,1950,0,2140,125,1
1575009,3215304,429,20,37745,0,38174,20,1
1633022,4766284,246,6,23530,0,23776,6,1
2147720,59168,1608,40,78786,0,80394,40,1
3569179,2665868,1064,708,40015,0,41079,708,1
161276,3314841,146,10,6548,0,6694,10,1
2887240,2651679,1143,1,118405,0,119548,1,1
805360,2432280,1514,34,119306,0,120820,34,1
987626,4485557,238,165,1743,0,1981,165,1
1988347,1609389,205,248,3660,0,3865,248,1
774221,436369,335,19,1862,0,2197,19,1
3263148,3791175,174,164,2060,0,2234,164,1
1332516,660584,19,31,69,0,88,31,1
1029490,3951178,67,56,290,0,357,56,1
2516076,1273651,1455,56,77782,0,79237,56,1
1079363,3198742,75,551,586,5252,661,5803,1
489584,1463210,421,1,12098,0,12519,1,1
3395938,421671,546,61,39878,0,40424,61,1
4624595,2490126,722,37,53368,0,54090,37,1
1467796,1851924,118,72,1660,0,1778,72,1
4062175,232825,248,252,8522,0,8770,252,1
2285283,3031906,279,17,6799,0,7078,17,1
3214323,2872979,147,341,12543,28510,12690,28851,1
4411870,820430,948,69,60517,0,61465,69,1
4191727,1254511,463,17,26315,0,26778,17,1
298564,4725720,662,580,6261,0,6923,580,1
427805,722676,483,187,156906,0,157389,187,1
957197,911765,614,233,37109,0,37723,233,1
1679056,3438278,13,3,227,0,240,3,1
2345261,2094402,92,189,1694,2,1786,191,1
4488849,4726799,136,19,4704,0,4840,19,1
2482338,3829709,712,32,24222,0,24934,32,1
3906136,4287291,387,26,41169,0,41556,26,1
3118623,2998026,46,919,76,24182,122,25101,1
2379070,2732333,141,295,2560,0,2701,295,1
3509903,106015,1530,1,509445,0,510975,1,1
2096270,2024753,970,172,26018,1901,26988,2073,1
1966548,4687230,208,2,53149,0,53357,2,1
427805,3330453,483,1,156906,0,157389,1,1
4629176,2447525,2058,19,9211,0,11269,19,1
550866,1105040,79,33,1089,0,1168,33,1
3845119,2501976,461,1,28609,0,29070,1,1
1927143,1261286,12,136,61,0,73,136,1
1733957,1708467,554,3,15185,0,15739,3,1
2827436,1349706,882,1,271525,0,272407,1,1
1092261,4168310,273,16,2825,0,3098,16,1
1241159,2838905,165,137,133,263,298,400,1
3561502,3646,1144,43,68800,0,69944,43,1
3579221,3118169,31,354,179,0,210,354,1
2209136,3229878,620,48,33789,0,34409,48,1
428287,3150083,81,20,209,0,290,20,1
3452706,4629176,245,2058,2116,9211,2361,11269,1
2498087,3490722,1630,59,32582,0,34212,59,1
3914135,2092359,2152,421,60084,26936,62236,27357,1
3164098,2981537,87,1252,404,118718,491,119970,1
2935790,3530873,72,91,258,0,330,91,1
1580988,450983,2821,1,400133,0,402954,1,1
3742930,3888131,410,69,22242,0,22652,69,1
1321779,813400,320,71,2517,696,2837,767,1
4611670,1048636,59,720,1152,0,1211,720,1
1100354,713284,163,2,24439,0,24602,2,1
6618,3979046,892,142,68849,0,69741,142,1
2950311,1888088,807,102,85116,0,85923,102,1
2877633,436616,152,223,5044,0,5196,223,1
515290,4087774,285,578,34080,10107,34365,10685,1
47194,4710604,148,664,4662,0,4810,664,1
544230,3844980,1532,3,60768,0,62300,3,1
3638272,3683161,2022,2,370904,0,372926,2,1
1927211,4386387,1668,5,113322,0,114990,5,1
3836080,4214179,1197,202,59457,0,60654,202,1
1293807,4488963,1837,362,30865,1762,32702,2124,1
4738916,409736,1165,111,34124,0,35289,111,1
3992144,779689,402,1,23683,0,24085,1,1
3549674,504495,602,43,38542,0,39144,43,1
1539837,2393339,1127,1266,62979,0,64106,1266,1
157339,82466,54,33,198,0,252,33,1
1580988,3417024,2821,1,400133,0,402954,1,1
4272102,1100111,1608,35,104171,0,105779,35,1
2784572,2009666,69,34,3478,0,3547,34,1
4140279,3799626,337,1,49384,0,49721,1,1
907654,3614448,798,49,24575,0,25373,49,1
3638272,1722795,2022,12,370904,0,372926,12,1
4272102,882089,1608,24,104171,0,105779,24,1
2851109,4687516,450,679,98552,0,99002,679,1
3291396,1164969,195,22,11502,0,11697,22,1
3835618,4260952,694,41,25433,0,26127,41,1
1436216,1527046,1068,20,68770,0,69838,20,1
1063358,409496,1350,14,63494,0,64844,14,1
1386493,2393525,111,10,1396,0,1507,10,1
4140279,896057,337,2,49384,0,49721,2,1
2031305,2240961,396,199,23435,0,23831,199,1
1613202,1181047,566,80,8639,0,9205,80,1
1486758,2393654,337,13,11346,0,11683,13,1
3116031,2308770,94,652,875,435,969,1087,1
4272102,982387,1608,31,104171,0,105779,31,1
876080,1031596,1,4,19,0,20,4,1
1293807,4484074,1837,4,30865,0,32702,4,1
3584617,2141873,88,23,469,0,557,23,1
2851109,3149619,450,5,98552,0,99002,5,1
2516076,2187957,1455,17,77782,0,79237,17,1
687713,1261638,436,102,47160,0,47596,102,1
3428306,1367462,103,5,2173,0,2276,5,1
3765475,316095,873,5,107914,0,108787,5,1
3671141,4265626,1444,140,48400,0,49844,140,1
4527016,2618218,187,51,1921,0,2108,51,1
1276425,1129016,102,5,8318,0,8420,5,1
4515355,1071492,21,2,8176,0,8197,2,1
462205,4772821,788,21,589,0,1377,21,1
2827436,4069538,882,1,271525,0,272407,1,1
1110514,3538375,68,36,3569,0,3637,36,1
4208044,4027773,247,17,3919,0,4166,17,1
2851109,4048870,450,13,98552,0,99002,13,1
226540,1591451,463,21,10650,0,11113,21,1
4180995,4327302,219,1,4470,0,4689,1,1
3127862,63465,86,15,2046,0,2132,15,1
3849126,413774,10,7,227,0,237,7,1
1580988,185611,2821,2,400133,0,402954,2,1
4208653,3481141,1820,9,21104,0,22924,9,1
2477256,2346762,1124,26,7025,0,8149,26,1
1661134,1916060,18,4,317,0,335,4,1
2950311,4705949,807,54,85116,0,85923,54,1
1279417,1850456,166,171,776,135,942,306,1
3835618,3188782,694,65,25433,0,26127,65,1
2150273,299618,649,26,6442,0,7091,26,1
4653941,2908328,951,3,45883,0,46834,3,1
2260014,79083,2466,15,98622,0,101088,15,1
154421,4696650,11,2,56,0,67,2,1
522588,3090305,496,60,20091,0,20587,60,1
4272102,1135380,1608,322,104171,0,105779,322,1
3836080,1083126,1197,22,59457,0,60654,22,1
2893334,3489344,889,127,30148,0,31037,127,1
4751453,1467751,520,26,27570,0,28090,26,1
1148474,1269938,214,31,2785,0,2999,31,1
3396408,2119314,118,2,2302,0,2420,2,1
2375878,1176820,248,24,14925,0,15173,24,1
3943091,615868,53,3,10283,0,10336,3,1
3361377,3813664,4841,1,761793,0,766634,1,1
3555504,4306337,65,1,508,0,573,1,1
232059,4832239,9,6,90,0,99,6,1
2872979,4195942,341,21,28510,0,28851,21,1
4528103,2383290,268,4,14258,0,14526,4,1
4266665,1364206,91,249,1894,0,1985,249,1
3152261,1657508,12,137,110,0,122,137,1
1218125,963651,16,5,101,0,117,5,1
3361377,4125099,4841,6,761793,0,766634,6,1
2069064,994705,48,23,716,0,764,23,1
1288771,1043698,73,20,5367,0,5440,20,1
1196844,926800,548,41,36289,0,36837,41,1
4121239,3695765,64,114,5330,0,5394,114,1
755739,4767175,1117,80,58043,0,59160,80,1
1321779,120151,320,2,2517,0,2837,2,1
4846817,4781805,76,20,5055,0,5131,20,1
4209323,3080075,1630,51,89460,0,91090,51,1
3595335,4848931,33,38,44,63,77,101,1
3566847,1932389,155,50,1106,0,1261,50,1
1900620,1708240,59,5,1163,0,1222,5,1
3270646,3906438,390,58,3571,0,3961,58,1
1927211,3530456,1668,47,113322,0,114990,47,1
3872736,2273793,258,132,12660,0,12918,132,1
1929410,4394124,71,29,824,88,895,117,1
3683235,3911515,311,43,23110,0,23421,43,1
1580988,2415536,2821,3,400133,0,402954,3,1
507060,1020789,191,7,6141,0,6332,7,1
2677334,1102698,377,12,6774,0,7151,12,1
1591435,2771145,387,3,31245,0,31632,3,1
3112136,334794,406,11,41366,0,41772,11,1
3280389,4282653,1101,2,411419,0,412520,2,1
2631724,2859255,16,4,4171,0,4187,4,1
3814892,740546,60,766,3420,0,3480,766,1
471706,511154,794,1,65616,0,66410,1,1
1367871,1365969,104,1,6433,0,6537,1,1
3881566,3588630,781,351,14176,7803,14957,8154,1
4708835,2189103,190,1,7539,0,7729,1,1
829561,61959,49,48,2109,368,2158,416,1
1927211,2041729,1668,91,113322,0,114990,91,1
765601,976602,1485,23,101510,0,102995,23,1
1539837,3530444,1127,32,62979,0,64106,32,1
1734954,257958,369,17,5786,0,6155,17,1
1321472,1201638,68,25,1770,0,1838,25,1
765601,4059222,1485,27,101510,0,102995,27,1
2498087,363860,1630,101,32582,0,34212,101,1
4174231,2097685,90,933,1471,0,1561,933,1
2434218,4534954,70,17,243,0,313,17,1
1589020,1432560,163,10,1586,0,1749,10,1
3742930,463164,410,27,22242,0,22652,27,1
2281149,506700,282,12,28082,0,28364,12,1
3209359,914948,72,6,898,0,970,6,1
2271380,2159151,51,97,129,199,180,296,1
3509903,3361963,1530,2,509445,0,510975,2,1
3195188,4254988,5,55,126,1215,131,1270,1
3509903,3615245,1530,4,509445,0,510975,4,1
1103332,3833400,732,3,59415,0,60147,3,1
4183784,2909067,931,153,59894,0,60825,153,1
4330391,1335573,773,140,32759,0,33532,140,1
4385783,1920155,290,14,10995,0,11285,14,1
3112136,2089311,406,36,41366,0,41772,36,1
2762372,4575844,818,1,6089,0,6907,1,1
3765475,4126549,873,1,107914,0,108787,1,1
3294702,1064567,991,19,68888,0,69879,19,1
2107861,4550027,535,3,25743,0,26278,3,1
4443577,526798,509,929,11936,0,12445,929,1
846208,4482044,600,412,17288,0,17888,412,1
3438576,3143757,3424,385,137753,0,141177,385,1
3271484,680600,1507,188,34093,0,35600,188,1
4516604,1393277,314,364,13314,0,13628,364,1
2827436,1375955,882,1,271525,0,272407,1,1
1847461,1397057,1211,4,51149,0,52360,4,1
2182964,3803287,214,1,6975,0,7189,1,1
530200,1374852,2035,49,62809,427,64844,476,1
4735218,2494065,252,2,5309,0,5561,2,1
4360960,1010824,1642,7,110084,0,111726,7,1
3676295,28751,374,1,70881,0,71255,1,1
1711479,4558329,116,18,1032,0,1148,18,1
1847461,56051,1211,7,51149,0,52360,7,1
1250021,407169,4637,20,85913,0,90550,20,1
4843360,1237306,355,64,7866,0,8221,64,1
3509214,1444300,263,39,14139,0,14402,39,1
3361377,3777019,4841,2,761793,0,766634,2,1
4209323,2427880,1630,161,89460,0,91090,161,1
4838376,4423337,606,52,26838,0,27444,52,1
2209136,925399,620,31,33789,0,34409,31,1
2882060,1726918,163,162,1992,0,2155,162,1
3338906,4067020,140,27,6745,0,6885,27,1
3845119,3288216,461,12,28609,0,29070,12,1
4621719,593725,306,191,4102,0,4408,191,1
427805,3726547,483,2,156906,0,157389,2,1
3214031,2389960,33,4,204,0,237,4,1
318045,4252921,107,350,758,0,865,350,1
3509903,946799,1530,2,509445,0,510975,2,1
2737233,1728645,30,25,1579,0,1609,25,1
4656799,1799925,187,371,2411,0,2598,371,1
1534362,2663923,1531,2,105859,0,107390,2,1
2860911,176013,35,795,134,2,169,797,1
4201715,4679513,276,70,1109,983,1385,1053,1
917130,2708572,325,44,7017,0,7342,44,1
3980505,553954,255,67,6464,0,6719,67,1
1847461,3428671,1211,10,51149,0,52360,10,1
2092359,3845086,421,1,26936,0,27357,1,1
3636190,3771531,119,114,4195,0,4314,114,1
3638272,2796524,2022,1,370904,0,372926,1,1
3645402,4195322,153,2,7400,0,7553,2,1
3849054,1354242,417,39,13259,0,13676,39,1
4721617,1629321,307,66,12885,0,13192,66,1
1588330,687204,694,136,10280,0,10974,136,1
932720,3851301,1411,49,111323,0,112734,49,1
2854573,4160586,99,1,5019,0,5118,1,1
749984,2543800,17,56,384,0,401,56,1
2244243,2268707,290,635,878,0,1168,635,1
474172,748905,471,3,38713,0,39184,3,1
1580988,1531878,2821,5,400133,0,402954,5,1
3137585,426867,1196,2,77354,0,78550,2,1
1580988,488543,2821,3,400133,0,402954,3,1
3470299,2656939,44,24,412,0,456,24,1
2662809,2238335,303,8,10704,0,11007,8,1
427805,4502440,483,1,156906,0,157389,1,1
354904,1033317,3193,47,105780,0,108973,47,1
4589966,3156454,82,256,2845,0,2927,256,1
1591435,698900,387,7,31245,0,31632,7,1
2077019,4773043,38,7,1764,0,1802,7,1
4417253,3644733,1130,10,68389,0,69519,10,1
4624595,3707473,722,72,53368,0,54090,72,1
4295952,676389,808,16,57369,0,58177,16,1
3361377,242822,4841,2,761793,0,766634,2,1
1889641,1467044,33,99,1381,870,1414,969,1
1580988,3184503,2821,33,400133,0,402954,33,1
1927211,1294869,1668,71,113322,0,114990,71,1
2721412,4139976,273,1,2733,0,3006,1,1
3881566,876756,781,91,14176,0,14957,91,1
4635332,3550394,90,2,2326,0,2416,2,1
3509903,1433108,1530,6,509445,0,510975,6,1
2405789,597842,1010,24,93387,0,94397,24,1
3795221,2112849,332,54,5749,0,6081,54,1
3509903,4197067,1530,2,509445,0,510975,2,1
3449530,1541689,717,32,73648,0,74365,32,1
1534526,3382255,51,1,1638,0,1689,1,1
1534362,4745878,1531,19,105859,0,107390,19,1
130004,2474688,8,3,923,0,931,3,1
1560049,1862134,1121,3,12468,0,13589,3,1
3509903,2936586,1530,2,509445,0,510975,2,1
3112136,1362590,406,1,41366,0,41772,1,1
2147720,4410329,1608,38,78786,0,80394,38,1
1436216,2147674,1068,32,68770,0,69838,32,1
4218365,1073696,58,7,1087,0,1145,7,1
2405789,4682234,1010,50,93387,0,94397,50,1
2827436,981486,882,2,271525,0,272407,2,1
671026,2332577,421,15,8079,0,8500,15,1
3361377,1010579,4841,6,761793,0,766634,6,1
3509903,4187418,1530,2,509445,0,510975,2,1
837553,3262576,1249,1,61665,0,62914,1,1
1260168,3305786,103,67,381,0,484,67,1
805360,2070835,1514,38,119306,0,120820,38,1
553041,234812,455,49,5962,0,6417,49,1
2706645,71863,193,2,1037,0,1230,2,1
3793936,4202576,258,600,2342,10697,2600,11297,1
1927211,4068439,1668,107,113322,0,114990,107,1
151693,1464138,436,331,12181,0,12617,331,1
4258870,3600499,336,84,4963,0,5299,84,1
1027486,455224,782,101,383,0,1165,101,1
4642569,2729087,872,277,27586,0,28458,277,1
957197,2559898,614,17,37109,0,37723,17,1
3041258,3634750,131,60,1570,0,1701,60,1
1633022,4776800,246,2,23530,0,23776,2,1
1973082,1352702,1036,205,18915,0,19951,205,1
2001244,4850593,38,169,2115,4365,2153,4534,1
4360960,1572308,1642,17,110084,0,111726,17,1
2886330,1998636,415,235,10154,0,10569,235,1
2405789,4401580,1010,8,93387,0,94397,8,1
4417253,2068209,1130,17,68389,0,69519,17,1
1657157,3931903,11,4,812,0,823,4,1
522588,517910,496,299,20091,0,20587,299,1
380817,209049,32,10,1035,0,1067,10,1
597648,1082499,29,9,1880,0,1909,9,1
1120955,1720011,13,1,989,0,1002,1,1
2536096,400094,26,1,164,0,190,1,1
2056892,1770930,250,248,4216,0,4466,248,1
4417253,2655453,1130,41,68389,0,69519,41,1
577580,2951271,187,290,3831,0,4018,290,1
2502456,217878,719,71,50725,0,51444,71,1
3361377,2337254,4841,1,761793,0,766634,1,1
4330391,685148,773,6,32759,0,33532,6,1
2755798,3345197,494,1,24862,0,25356,1,1
47928,4651595,120,89,3814,0,3934,89,1
3984303,2217913,133,16,4489,0,4622,16,1
2498087,1882622,1630,43,32582,0,34212,43,1
2981537,145707,1252,3,118718,0,119970,3,1
765601,3776754,1485,47,101510,0,102995,47,1
2134036,2778637,30,108,88,0,118,108,1
4649206,4245373,566,79,31367,0,31933,79,1
3257465,2648724,541,207,27614,0,28155,207,1
1493489,3783152,523,7,17512,0,18035,7,1
3943316,4401406,64,381,255,2141,319,2522,1
1079363,1288382,75,1,586,0,661,1,1
544230,4058559,1532,24,60768,0,62300,24,1
1063358,2968184,1350,332,63494,0,64844,332,1
687713,3099657,436,26,47160,0,47596,26,1
4302921,3218219,509,37,13289,0,13798,37,1
954784,3430136,567,7,14450,0,15017,7,1
2751572,3433839,481,36,44036,0,44517,36,1
1196403,3799165,363,3,2062,0,2425,3,1
4738916,2505039,1165,1,34124,0,35289,1,1
3509903,3534734,1530,2,509445,0,510975,2,1
3836080,4202601,1197,35,59457,0,60654,35,1
2441425,3914122,803,191,18561,0,19364,191,1
288324,3413134,90,873,1983,501,2073,1374,1
522588,4381855,496,9,20091,0,20587,9,1
671026,377357,421,2,8079,0,8500,2,1
3262988,3182684,39,54,846,0,885,54,1
3509903,593082,1530,2,509445,0,510975,2,1
346443,255044,24,32,241,0,265,32,1
3509903,919459,1530,2,509445,0,510975,2,1
1923198,776778,531,34,3973,0,4504,34,1
2529661,3327985,493,45,27309,0,27802,45,1
3836080,4062505,1197,6,59457,0,60654,6,1
3438576,4036214,3424,51,137753,0,141177,51,1
427805,3748154,483,4,156906,0,157389,4,1
3463741,2723921,82,15,3948,0,4030,15,1
4629569,3726775,152,325,1698,0,1850,325,1
2210915,1131760,325,58,1678,0,2003,58,1
354904,2227770,3193,1,105780,0,108973,1,1
1922155,1235945,49,325,182,0,231,325,1
4256261,763970,177,168,2001,0,2178,168,1
866888,790724,391,692,2049,258,2440,950,1
957197,3561380,614,148,37109,0,37723,148,1
4649206,3713758,566,145,31367,0,31933,145,1
3509903,4782026,1530,13,509445,0,510975,13,1
752618,4720854,169,261,5929,0,6098,261,1
2261139,2935389,2014,3,42851,0,44865,3,1
3361377,3719446,4841,3,761793,0,766634,3,1
4192206,2427290,468,30,18229,0,18697,30,1
1207753,1499615,533,19,9348,0,9881,19,1
1250021,4346850,4637,15,85913,0,90550,15,1
1331940,3641600,802,751,32617,9269,33419,10020,1
1580988,1859415,2821,2,400133,0,402954,2,1
4479403,2726006,52,70,2699,0,2751,70,1
3294702,2034402,991,25,68888,0,69879,25,1
4411870,1899892,948,284,60517,0,61465,284,1
4480352,3561058,88,147,622,0,710,147,1
1847461,4709297,1211,165,51149,813,52360,978,1
2755750,2497635,57,93,794,0,851,93,1
2886626,1178709,192,582,6077,0,6269,582,1
958099,4630049,63,38,2391,0,2454,38,1
1615854,4754713,286,529,2590,0,2876,529,1
2650412,382100,931,173,29038,0,29969,173,1
1250021,486526,4637,56,85913,0,90550,56,1
4023687,4609875,69,19,7295,0,7364,19,1
408965,1129877,903,242,38623,0,39526,242,1
2055544,2745854,141,23,2577,0,2718,23,1
4705188,3296753,336,47,8658,0,8994,47,1
1148487,1809327,40,1,483,0,523,1,1
3115867,1240575,1350,4,61232,0,62582,4,1
2446968,1651996,452,13,20110,0,20562,13,1
3509903,2678343,1530,2,509445,0,510975,2,1
646587,2594633,122,12,5819,0,5941,12,1
2854307,1345777,95,187,220,1667,315,1854,1
1276253,983669,407,3,46534,0,46941,3,1
2398402,681366,84,7,851,0,935,7,1
3317795,3373723,22,2,1850,0,1872,2,1
3835618,3568779,694,1,25433,0,26127,1,1
3764177,755624,1036,40,64563,0,65599,40,1
3140664,4799664,268,3,16099,0,16367,3,1
1163500,374160,398,27,9540,0,9938,27,1
2650412,190499,931,119,29038,0,29969,119,1
3280389,266694,1101,1,411419,0,412520,1,1
3764177,2651654,1036,83,64563,0,65599,83,1
4106142,1858999,306,70,3436,0,3742,70,1
4170143,4606472,202,25,2900,0,3102,25,1
932720,1463433,1411,23,111323,0,112734,23,1
3387987,4783061,268,416,19035,0,19303,416,1
873006,4089835,375,68,33630,0,34005,68,1
1148799,3863020,275,92,1325,0,1600,92,1
4624595,4443706,722,33,53368,0,54090,33,1
3361377,3204624,4841,1,761793,0,766634,1,1
596012,500507,192,11,3561,0,3753,11,1
1580988,3339148,2821,4,400133,0,402954,4,1
2564052,4437239,102,76,1292,0,1394,76,1
1580988,3267578,2821,89,400133,0,402954,89,1
1775944,185896,49,622,692,117,741,739,1
3509903,165905,1530,1,509445,0,510975,1,1
445996,936479,1175,26,12828,0,14003,26,1
611927,4218527,305,1,8695,0,9000,1,1
2569009,3151057,424,55,13423,0,13847,55,1
1606469,276034,96,475,5210,0,5306,475,1
3438576,3150929,3424,258,137753,0,141177,258,1
3349661,3571937,166,80,937,0,1103,80,1
3765475,232311,873,1,107914,0,108787,1,1
3137585,4568230,1196,32,77354,0,78550,32,1
1792987,4855353,97,71,3867,0,3964,71,1
2428341,3641600,826,751,10151,9269,10977,10020,1
781211,4609649,976,76,51781,0,52757,76,1
3361377,4252511,4841,5,761793,0,766634,5,1
4701417,783217,305,3,3855,0,4160,3,1
521586,2803584,782,24,18489,0,19271,24,1
4552666,1858059,341,75,9279,0,9620,75,1
1103332,2907801,732,217,59415,0,60147,217,1
4140279,4590556,337,2,49384,0,49721,2,1
1723506,784848,733,18,21835,0,22568,18,1
2562720,4383889,52,45,3640,0,3692,45,1
3438576,3353815,3424,151,137753,0,141177,151,1
2617350,2477753,256,59,6547,0,6803,59,1
4100923,892835,260,1,7743,0,8003,1,1
2261139,1488584,2014,83,42851,0,44865,83,1
3206499,286517,1337,4,32033,0,33370,4,1
821089,2640498,394,195,4820,0,5214,195,1
2854573,2759472,99,132,5019,0,5118,132,1
1243110,3798439,13,145,48,812,61,957,1
4710933,1847461,126,1211,1331,51149,1457,52360,1
276216,2365070,312,90,12600,0,12912,90,1
1037361,2039849,232,81,2017,0,2249,81,1
2961801,738953,1483,78,101962,0,103445,78,1
3280389,4270344,1101,1,411419,0,412520,1,1
3361377,291595,4841,26,761793,0,766634,26,1
4238001,2300046,869,2,61161,0,62030,2,1
2260014,617775,2466,253,98622,0,101088,253,1
4011264,1576177,1360,362,116777,0,118137,362,1
2827436,2876922,882,1,271525,0,272407,1,1
1927211,786737,1668,32,113322,0,114990,32,1
775837,4280512,196,2,1396,0,1592,2,1
2827436,989597,882,1,271525,0,272407,1,1
1497278,258143,1869,102,35111,0,36980,102,1
401947,1225533,367,215,7890,0,8257,215,1
3509214,1189051,263,15,14139,0,14402,15,1
3082104,828896,47,6,4343,0,4390,6,1
2195890,1682327,134,90,5208,0,5342,90,1
3514277,4403756,1338,67,13269,0,14607,67,1
4100923,1342638,260,4,7743,0,8003,4,1
1497278,3721611,1869,12,35111,0,36980,12,1
1127093,4010131,554,41,6014,0,6568,41,1
3734245,3488992,915,2,34965,0,35880,2,1
3943091,2288762,53,3,10283,0,10336,3,1
2998026,4375568,919,1,24182,0,25101,1,1
3430861,2599124,21,25,488,0,509,25,1
3271484,529680,1507,31,34093,0,35600,31,1
1190435,802633,432,99,3922,0,4354,99,1
4337603,3621538,333,6,9909,0,10242,6,1
2688113,676630,32,2,377,0,409,2,1
2261139,4170979,2014,15,42851,0,44865,15,1
3280389,704386,1101,1,411419,0,412520,1,1
3676295,1842382,374,1,70881,0,71255,1,1
2881425,1896792,102,13,5272,0,5374,13,1
1512714,2956105,253,26,6663,0,6916,26,1
4087774,2722475,578,82,10107,0,10685,82,1
1163180,59769,606,1,5885,0,6491,1,1
1103332,3238578,732,337,59415,0,60147,337,1
2055544,4423149,141,51,2577,0,2718,51,1
3517820,995662,50,16,1345,0,1395,16,1
3873768,2050398,449,39,35424,512,35873,551,1
2827836,2571833,32,37,447,0,479,37,1
4117427,3120633,329,10,9639,0,9968,10,1
331680,3033271,60,54,243,0,303,54,1
2722942,1186354,240,3,8655,0,8895,3,1
3361377,1475146,4841,2,761793,0,766634,2,1
3633019,920482,746,1,32317,0,33063,1,1
3118804,3611021,315,120,6025,0,6340,120,1
1875,3335904,656,87,61388,0,62044,87,1
3849054,922879,417,143,13259,1546,13676,1689,1
2209136,99914,620,36,33789,0,34409,36,1
3509903,1087448,1530,1,509445,0,510975,1,1
3092943,557943,352,89,2435,0,2787,89,1
1654099,2545216,1180,1197,26347,0,27527,1197,1
1163180,3276528,606,16,5885,0,6491,16,1
837553,2282292,1249,45,61665,0,62914,45,1
2853969,2117605,1051,2,42591,0,43642,2,1
730177,4486335,59,3,823,0,882,3,1
941622,2671123,124,148,315,2053,439,2201,1
2261139,3582688,2014,1,42851,0,44865,1,1
596012,1569332,192,50,3561,0,3753,50,1
837553,1974884,1249,338,61665,0,62914,338,1
2827436,1827701,882,1,271525,0,272407,1,1
3280389,3575048,1101,1,411419,0,412520,1,1
3280389,3195109,1101,1,411419,0,412520,1,1
3043130,74795,285,7,1773,0,2058,7,1
2600253,4628961,148,124,652,0,800,124,1
3768176,2978806,167,2,1980,0,2147,2,1
4505464,958151,99,29,2637,0,2736,29,1
2075015,532213,2664,20,85781,0,88445,20,1
1847461,1308081,1211,39,51149,0,52360,39,1
1733957,4517704,554,39,15185,0,15739,39,1
2985909,2887095,706,34,43348,0,44054,34,1
2961801,3291083,1483,32,101962,0,103445,32,1
3361377,4758158,4841,2,761793,0,766634,2,1
1348342,2744204,241,191,1456,0,1697,191,1
309382,2008487,135,1,4536,0,4671,1,1
1927211,2380259,1668,6,113322,0,114990,6,1
4171214,4713391,358,387,4601,0,4959,387,1
3509903,2861604,1530,1,509445,0,510975,1,1
4621719,4617896,306,1,4102,0,4408,1,1
4423184,4586491,384,28,29809,0,30193,28,1
3384159,2441425,415,803,6659,18561,7074,19364,1
4649206,2509266,566,131,31367,0,31933,131,1
3137585,337336,1196,72,77354,0,78550,72,1
1733957,2523109,554,1,15185,0,15739,1,1
3065808,1925598,1235,21,82317,0,83552,21,1
419362,500553,314,10,5584,0,5898,10,1
259575,4111148,260,1,13949,0,14209,1,1
657387,4432606,47,4,2455,0,2502,4,1
4088169,1434485,142,219,1347,0,1489,219,1
3188415,690261,189,12,1078,0,1267,12,1
4519069,205926,387,82,20799,0,21186,82,1
4041286,2737729,29,3,199,0,228,3,1
1580988,2258565,2821,1,400133,0,402954,1,1
1671376,2860361,64,4,2451,0,2515,4,1
3509903,1908031,1530,1,509445,0,510975,1,1
2870711,4080851,87,80,2239,0,2326,80,1
1202593,1956718,93,22,5131,0,5224,22,1
4191410,27311,1590,35,96434,0,98024,35,1
2790006,2275714,367,51,14747,0,15114,51,1
1192480,3191103,397,1,20737,0,21134,1,1
3509903,1056175,1530,1,509445,0,510975,1,1
837553,2337640,1249,9,61665,0,62914,9,1
1580988,1822021,2821,3,400133,0,402954,3,1
2650412,3606957,931,38,29038,0,29969,38,1
4314280,1759614,568,13,9552,0,10120,13,1
3765475,4793223,873,2,107914,0,108787,2,1
4209323,793907,1630,38,89460,0,91090,38,1
4117427,2222104,329,41,9639,0,9968,41,1
3294702,4556739,991,32,68888,0,69879,32,1
3898535,1700887,59,32,9303,0,9362,32,1
2464401,4484502,577,41,23681,0,24258,41,1
605874,2908944,145,4,3312,0,3457,4,1
4520863,2596485,3432,42,908,0,4340,42,1
579164,4851934,28,1,596,0,624,1,1
2897926,1903826,565,54,25983,0,26548,54,1
787416,1085046,115,2,9954,0,10069,2,1
3561502,2517129,1144,29,68800,0,69944,29,1
4496449,765601,174,1485,4260,101510,4434,102995,1
4189654,3208038,256,73,927,0,1183,73,1
2687552,2290241,238,280,25574,0,25812,280,1
2612638,2830651,125,4,347,0,472,4,1
2584298,2336594,193,152,2105,0,2298,152,1
2950311,3357155,807,82,85116,0,85923,82,1
1580988,4128022,2821,136,400133,0,402954,136,1
1903752,3395881,506,149,10494,0,11000,149,1
4051394,3450256,69,1,430,0,499,1,1
2724971,3238481,35,1,955,0,990,1,1
781211,2992815,976,6,51781,0,52757,6,1
1803208,361354,101,122,906,0,1007,122,1
1887709,4528994,217,3,28983,0,29200,3,1
853849,2589082,40,4,131,0,171,4,1
4191410,580800,1590,113,96434,0,98024,113,1
4798192,1860174,816,189,20426,0,21242,189,1
3362545,970047,297,21,947,0,1244,21,1
4411870,2896389,948,42,60517,0,61465,42,1
4272102,2143465,1608,213,104171,0,105779,213,1
2075015,299540,2664,24,85781,0,88445,24,1
4853234,4040349,1256,2,29554,0,30810,2,1
2451482,3328605,218,233,1711,1945,1929,2178,1
354904,2201293,3193,22,105780,0,108973,22,1
95543,1554708,55,1,213,0,268,1,1
2853969,3184949,1051,1,42591,0,43642,1,1
4649206,2304043,566,61,31367,0,31933,61,1
3906136,1461846,387,39,41169,0,41556,39,1
3220141,1026952,259,45,3705,0,3964,45,1
2075015,1235992,2664,54,85781,0,88445,54,1
3842148,2617020,719,2,11430,0,12149,2,1
4416945,2664891,417,22,33228,0,33645,22,1
1879936,4498158,281,56,6786,0,7067,56,1
3588630,1962529,351,13,7803,0,8154,13,1
2827436,839084,882,1,271525,0,272407,1,1
1710474,3452097,154,106,1649,0,1803,106,1
3181246,542991,125,45,1755,0,1880,45,1
663168,1441868,190,22,420,0,610,22,1
1486758,1951448,337,98,11346,0,11683,98,1
2042569,3147840,358,52,1959,0,2317,52,1
4337603,1034785,333,44,9909,0,10242,44,1
441667,3635296,198,1,14727,0,14925,1,1
3361377,4536591,4841,3,761793,0,766634,3,1
3043130,3095594,285,22,1773,0,2058,22,1
4131836,93796,162,2,1933,0,2095,2,1
2110156,1737732,51,79,415,0,466,79,1
1580988,4076416,2821,1,400133,0,402954,1,1
1822719,675780,285,85,22351,0,22636,85,1
1471685,3538688,1681,55,25550,0,27231,55,1
3907996,4004354,485,123,18964,0,19449,123,1
1887709,4074138,217,1,28983,0,29200,1,1
3509903,805026,1530,1,509445,0,510975,1,1
1163500,4417549,398,14,9540,0,9938,14,1
3257465,3724622,541,8,27614,0,28155,8,1
4664525,2369849,59,298,300,371,359,669,1
2093911,2765056,121,1555,1212,574,1333,2129,1
3638272,1367691,2022,1,370904,0,372926,1,1
3906136,2649001,387,1,41169,0,41556,1,1
1776854,515763,16,1,107,0,123,1,1
4394985,92916,22,1,175,0,197,1,1
842476,4793147,898,133,12479,0,13377,133,1
212421,2319861,11,315,433,1517,444,1832,1
765601,4095022,1485,43,101510,0,102995,43,1
3587014,4235452,215,237,1983,0,2198,237,1
3764177,760609,1036,29,64563,0,65599,29,1
2075015,296919,2664,23,85781,0,88445,23,1
1603899,3331810,497,32,5551,0,6048,32,1
4479581,4844189,601,1,19545,0,20146,1,1
111729,3132873,134,1,584,0,718,1,1
3549674,1739028,602,48,38542,0,39144,48,1
2490914,4517001,570,63,22965,0,23535,63,1
4838376,3573589,606,21,26838,0,27444,21,1
3280389,4612759,1101,2,411419,0,412520,2,1
978341,4053628,604,102,10065,0,10669,102,1
3438576,1661577,3424,1,137753,0,141177,1,1
1580988,4455856,2821,16,400133,0,402954,16,1
3361377,1479263,4841,3,761793,0,766634,3,1
183132,3633377,370,319,2556,4662,2926,4981,1
408965,3040101,903,1,38623,0,39526,1,1
588533,4077192,84,75,2858,0,2942,75,1
3509903,277768,1530,1,509445,0,510975,1,1
4104022,3079813,126,76,2390,0,2516,76,1
1654099,963002,1180,79,26347,0,27527,79,1
354904,314506,3193,112,105780,0,108973,112,1
2844498,1645652,36,4,1483,0,1519,4,1
1103332,2212467,732,2,59415,0,60147,2,1
1069846,4531935,183,492,702,0,885,492,1
4519069,1012090,387,148,20799,0,21186,148,1
1086912,4495107,907,164,33396,0,34303,164,1
3929270,1930501,257,23,2972,0,3229,23,1
1549334,2472346,81,3,6693,0,6774,3,1
3115867,2775958,1350,13,61232,0,62582,13,1
3153925,4162259,242,345,1315,2433,1557,2778,1
2445364,2840522,422,76,265,0,687,76,1
3638272,3046163,2022,2,370904,0,372926,2,1
3638272,215491,2022,5,370904,0,372926,5,1
471706,451414,794,14,65616,0,66410,14,1
2266491,3681348,81,157,1909,0,1990,157,1
4004339,1376689,153,15,6086,0,6239,15,1
3734245,3073965,915,56,34965,0,35880,56,1
1817799,4151490,402,205,15932,0,16334,205,1
4374509,3998331,770,208,9940,0,10710,208,1
805360,3810572,1514,16,119306,0,120820,16,1
3610598,151277,380,156,17343,0,17723,156,1
2187094,19486,75,143,725,0,800,143,1
4370819,1996594,403,148,6519,0,6922,148,1
4727207,79712,925,1,84581,0,85506,1,1
1589020,2989110,163,1042,1586,19283,1749,20325,1
289355,879134,17,13,117,0,134,13,1
6618,1003916,892,19,68849,0,69741,19,1
513799,391076,75,79,164,0,239,79,1
2793437,659911,582,4,25447,0,26029,4,1
2893334,1153095,889,32,30148,0,31037,32,1
3638272,767436,2022,1,370904,0,372926,1,1
3115867,4480126,1350,2,61232,0,62582,2,1
4777191,2431366,86,15,3938,0,4024,15,1
3214227,2565320,27,19,1890,0,1917,19,1
1966548,88960,208,1,53149,0,53357,1,1
1539837,1934836,1127,284,62979,2471,64106,2755,1
1493489,3761875,523,44,17512,0,18035,44,1
36074,3503400,66,616,2609,166,2675,782,1
3268279,2592022,33,12,684,0,717,12,1
1079053,1955716,53,13,345,0,398,13,1
1148474,2250560,214,10,2785,0,2999,10,1
3758692,2944368,711,131,34731,0,35442,131,1
3115867,2684099,1350,1,61232,0,62582,1,1
3509903,3205391,1530,2,509445,0,510975,2,1
1295981,3324340,47,56,353,0,400,56,1
1412630,1639434,217,587,2179,8053,2396,8640,1
2050190,2474559,153,1,9156,0,9309,1,1
1606969,2792428,40,14,1953,0,1993,14,1
4417253,4244058,1130,14,68389,0,69519,14,1
1311397,3896044,164,36,984,502,1148,538,1
3638272,4171441,2022,1,370904,0,372926,1,1
3088808,2939399,227,880,7820,0,8047,880,1
765601,1778312,1485,47,101510,0,102995,47,1
866357,2040477,825,44,18479,0,19304,44,1
2498087,2336098,1630,14,32582,0,34212,14,1
2961801,1649070,1483,65,101962,0,103445,65,1
3438576,3883295,3424,70,137753,0,141177,70,1
2441425,1057057,803,71,18561,0,19364,71,1
4411870,227226,948,46,60517,0,61465,46,1
3280389,4127158,1101,1,411419,0,412520,1,1
3560284,1710771,154,52,1129,0,1283,52,1
532681,3338741,433,42,35023,0,35456,42,1
1822719,4802322,285,47,22351,0,22636,47,1
17330,3160057,154,2358,972,187,1126,2545,1
1937293,2701074,434,6,16761,0,17195,6,1
4689808,2544567,280,11,14220,0,14500,11,1
4314280,2824014,568,16,9552,0,10120,16,1
4219479,3033593,158,133,4945,0,5103,133,1
903537,3598752,288,299,574,174,862,473,1
3298299,726954,181,34,4843,0,5024,34,1
92352,1625781,1138,58,20575,0,21713,58,1
3509903,2927519,1530,4,509445,0,510975,4,1
711824,3397411,113,158,3107,0,3220,158,1
3361377,784840,4841,44,761793,0,766634,44,1
3137585,333145,1196,167,77354,0,78550,167,1
3765475,88627,873,1,107914,0,108787,1,1
596012,1463457,192,4,3561,0,3753,4,1
1534362,3776644,1531,62,105859,0,107390,62,1
1455058,4436423,129,17,3856,0,3985,17,1
1192480,2669850,397,1,20737,0,21134,1,1
3316620,3637516,214,26,5083,0,5297,26,1
427805,54852,483,1,156906,0,157389,1,1
1654099,1416200,1180,55,26347,0,27527,55,1
3752160,4721148,1327,32,4229,0,5556,32,1
1249967,3872280,207,56,11933,0,12140,56,1
750901,2385058,161,55,1960,0,2121,55,1
4191410,4521118,1590,19,96434,0,98024,19,1
3137585,4340032,1196,46,77354,0,78550,46,1
2961801,1691281,1483,168,101962,0,103445,168,1
3758692,2001585,711,28,34731,0,35442,28,1
4115120,1720514,33,100,828,0,861,100,1
820093,2152590,13,167,28,0,41,167,1
2031305,3202449,396,172,23435,0,23831,172,1
1875,180856,656,41,61388,0,62044,41,1
2781817,3040663,704,5,24613,0,25317,5,1
940526,1907143,475,33,20786,0,21261,33,1
2985909,2871597,706,36,43348,0,44054,36,1
1527599,2903982,176,1039,3575,0,3751,1039,1
4771452,3833978,411,31,8072,0,8483,31,1
4451122,3204350,985,84,41669,0,42654,84,1
1787075,4461551,894,89,28305,0,29199,89,1
253352,2744776,237,87,10413,0,10650,87,1
1539837,3163511,1127,154,62979,0,64106,154,1
502360,573101,162,781,2164,12750,2326,13531,1
370461,3261332,103,35,1991,0,2094,35,1
196521,2300637,1176,44,11269,0,12445,44,1
1503116,3424202,415,144,37079,0,37494,144,1
4848648,1557183,45,3,640,0,685,3,1
2481553,2436941,84,9,141,0,225,9,1
4777191,3830123,86,7,3938,0,4024,7,1
4319972,2848314,640,23,35279,0,35919,23,1
2428341,200642,826,55,10151,0,10977,55,1
3023958,2899044,72,124,694,0,766,124,1
3361377,2495180,4841,1,761793,0,766634,1,1
299865,1375965,409,297,1612,451,2021,748,1
3638272,64769,2022,1,370904,0,372926,1,1
1560049,991736,1121,26,12468,0,13589,26,1
842476,2836705,898,2,12479,0,13377,2,1
687713,4010652,436,4,47160,0,47596,4,1
2887240,1681673,1143,12,118405,0,119548,12,1
3638272,1109505,2022,2,370904,0,372926,2,1
4055608,1155709,126,9,1936,0,2062,9,1
4360960,1848107,1642,1,110084,0,111726,1,1
522588,2072134,496,52,20091,0,20587,52,1
2827436,4338189,882,2,271525,0,272407,2,1
3545321,4155107,239,1,4366,0,4605,1,1
687713,3807119,436,1,47160,0,47596,1,1
4074044,640965,247,16,2547,0,2794,16,1
3419989,3299409,350,36,16316,0,16666,36,1
1110514,4733859,68,3,3569,0,3637,3,1
4668622,3998455,32,170,318,0,350,170,1
2031305,3984302,396,85,23435,0,23831,85,1
1207753,3152274,533,22,9348,0,9881,22,1
2075015,268518,2664,23,85781,0,88445,23,1
3379164,3627558,74,328,889,0,963,328,1
1639434,3820384,587,98,8053,0,8640,98,1
3280389,4594643,1101,3,411419,0,412520,3,1
4183784,1344340,931,54,59894,0,60825,54,1
1815739,4376369,248,105,6590,0,6838,105,1
4828511,2042167,113,22,2641,0,2754,22,1
3683235,2419073,311,37,23110,0,23421,37,1
873006,2861113,375,18,33630,0,34005,18,1
765601,4304210,1485,60,101510,0,102995,60,1
1847461,3852022,1211,15,51149,0,52360,15,1
448517,2496403,625,9,12450,0,13075,9,1
517497,2044689,117,62,2068,0,2185,62,1
4258870,4109738,336,38,4963,0,5299,38,1
1580988,898047,2821,2,400133,0,402954,2,1
3225310,1048608,320,71,10537,0,10857,71,1
3361377,2505303,4841,2,761793,0,766634,2,1
4058889,1281392,118,100,1543,0,1661,100,1
3638272,4814797,2022,6,370904,0,372926,6,1
1767687,2304561,148,7,291,0,439,7,1
1063358,2042847,1350,64,63494,0,64844,64,1
3509903,4525442,1530,2,509445,0,510975,2,1
2482338,1296488,712,200,24222,0,24934,200,1
3687762,2299065,627,4,3168,0,3795,4,1
2148937,4724834,672,2,47361,0,48033,2,1
3070849,121896,83,69,2913,0,2996,69,1
3638272,296118,2022,1,370904,0,372926,1,1
4258805,2005454,62,7,1527,0,1589,7,1
3638272,3204108,2022,1,370904,0,372926,1,1
268844,1189286,422,6,5070,0,5492,6,1
915390,3622018,1345,16,5262,0,6607,16,1
4417253,3133909,1130,50,68389,0,69519,50,1
1550672,2911942,18,1,2328,0,2346,1,1
1225988,968886,157,78,8881,1821,9038,1899,1
47928,4395685,120,157,3814,0,3934,157,1
2174130,2236661,86,3,1368,0,1454,3,1
471706,2242832,794,160,65616,0,66410,160,1
1221325,981849,153,79,1819,0,1972,79,1
307250,3555201,919,127,35588,0,36507,127,1
3638272,2239377,2022,4,370904,0,372926,4,1
3454888,4558077,162,10,7886,0,8048,10,1
2309618,923395,980,223,5354,0,6334,223,1
429643,247398,767,191,19668,0,20435,191,1
4272102,120578,1608,83,104171,0,105779,83,1
3914135,760763,2152,12,60084,0,62236,12,1
3873768,675293,449,178,35424,0,35873,178,1
1580988,1460105,2821,3,400133,0,402954,3,1
660008,1184414,139,51,2004,0,2143,51,1
1580988,71911,2821,1,400133,0,402954,1,1
3509903,1931931,1530,1,509445,0,510975,1,1
755739,3579460,1117,763,58043,0,59160,763,1
2702724,3980685,566,73,10448,0,11014,73,1
3509903,1752054,1530,1,509445,0,510975,1,1
4440160,2867505,736,2,20522,0,21258,2,1
978797,1713142,599,5,12421,0,13020,5,1
1580988,833,2821,3,400133,0,402954,3,1
3260961,995808,288,58,7637,0,7925,58,1
3208244,2919207,72,2,1962,0,2034,2,1
2150273,418716,649,17,6442,0,7091,17,1
2102747,1299287,12,135,94,0,106,135,1
3112136,3150606,406,2,41366,0,41772,2,1
3671141,613147,1444,542,48400,0,49844,542,1
878715,4563180,100,151,1976,799,2076,950,1
4654551,1370169,94,223,525,1452,619,1675,1
4011264,3443270,1360,74,116777,0,118137,74,1
4191410,926581,1590,4,96434,0,98024,4,1
521586,3531316,782,20,18489,0,19271,20,1
3638272,3880371,2022,2,370904,0,372926,2,1
3509903,687548,1530,7,509445,0,510975,7,1
805360,3253091,1514,19,119306,0,120820,19,1
1701884,4621952,13,922,254,5245,267,6167,1
4485028,190499,445,119,14565,0,15010,119,1
4202576,3860727,600,52,10697,0,11297,52,1
1276253,2934927,407,1,46534,0,46941,1,1
3462300,4866864,342,35,2917,0,3259,35,1
4191410,2575939,1590,37,96434,0,98024,37,1
2516076,871548,1455,26,77782,0,79237,26,1
932720,1629321,1411,66,111323,0,112734,66,1
1115799,1228608,93,294,1515,0,1608,294,1
3361377,3081001,4841,1,761793,0,766634,1,1
1063358,711537,1350,166,63494,0,64844,166,1
3914135,778,2152,511,60084,0,62236,511,1
4540953,409438,9,131,151,0,160,131,1
3509903,546454,1530,7,509445,0,510975,7,1
1751669,2437272,860,83,9825,0,10685,83,1
2696500,1554105,267,59,4128,0,4395,59,1
4416945,4087728,417,82,33228,0,33645,82,1
3108385,1785162,29,710,107,50,136,760,1
837553,2189117,1249,13,61665,0,62914,13,1
4220190,3716008,320,1,15994,0,16314,1,1
4423184,3160614,384,50,29809,0,30193,50,1
1961226,26366,33,170,2215,0,2248,170,1
3933095,3252779,304,550,2162,0,2466,550,1
1636597,3593874,6,5,106,0,112,5,1
3137585,3350389,1196,66,77354,0,78550,66,1
3294702,3932055,991,45,68888,0,69879,45,1
807139,2237982,43,28,221,0,264,28,1
3314938,310842,133,28,268,0,401,28,1
2342664,3606660,1181,13,26502,0,27683,13,1
1710474,3916837,154,7,1649,0,1803,7,1
4209323,2909376,1630,74,89460,0,91090,74,1
1235227,2310512,15,40,19,66,34,106,1
4321895,4270480,515,39,91,80,606,119,1
350406,4111609,33,689,173,538,206,1227,1
1815739,3841223,248,5,6590,0,6838,5,1
2164178,3791101,574,902,6134,0,6708,902,1
6618,1102971,892,54,68849,0,69741,54,1
3914135,3595780,2152,46,60084,0,62236,46,1
173493,3580772,46,18,1959,0,2005,18,1
217385,2820513,14,130,722,0,736,130,1
307250,2149474,919,57,35588,0,36507,57,1
4708541,1192924,981,102,15678,0,16659,102,1
3438576,4408647,3424,18,137753,0,141177,18,1
3836080,4456093,1197,125,59457,0,60654,125,1
3638037,3018939,8,13,35,0,43,13,1
3137585,4251599,1196,62,77354,0,78550,62,1
4297315,4043676,195,52,7446,0,7641,52,1
1544168,3948152,114,5,3348,0,3462,5,1
1036207,2162907,140,99,2198,0,2338,99,1
2994391,863883,315,36,6520,0,6835,36,1
927772,4164154,26,2,320,0,346,2,1
3671141,2080390,1444,63,48400,0,49844,63,1
1927211,4139517,1668,36,113322,0,114990,36,1
2985933,2226214,663,6,1912,0,2575,6,1
1580988,4798612,2821,1,400133,0,402954,1,1
1227855,355614,157,105,4545,0,4702,105,1
1350290,2554394,49,17,1273,0,1322,17,1
3438576,2922358,3424,116,137753,0,141177,116,1
3118804,4416945,315,417,6025,33228,6340,33645,1
4797841,2913485,61,25,2111,0,2172,25,1
3638272,3721099,2022,2,370904,0,372926,2,1
3280389,133961,1101,4,411419,0,412520,4,1
103101,1382374,116,10,522,0,638,10,1
1063358,906151,1350,118,63494,0,64844,118,1
3140664,2764865,268,29,16099,0,16367,29,1
3140664,744240,268,12,16099,0,16367,12,1
2851109,2325886,450,6,98552,0,99002,6,1
1103332,272510,732,7,59415,0,60147,7,1
2686363,234905,9,13,148,0,157,13,1
3361377,331306,4841,6,761793,0,766634,6,1
144465,802229,204,168,1758,3140,1962,3308,1
4624595,4057284,722,38,53368,0,54090,38,1
2887240,1919454,1143,164,118405,0,119548,164,1
2833090,1193208,22,5,654,0,676,5,1
3280389,2838938,1101,1,411419,0,412520,1,1
3380826,2823343,271,29,665,0,936,29,1
4219266,4000399,85,5,3252,0,3337,5,1
3361377,851228,4841,1,761793,0,766634,1,1
735870,970752,120,215,342,825,462,1040,1
2107861,4817376,535,2,25743,0,26278,2,1
4653941,3133,951,4,45883,0,46834,4,1
1250021,3889529,4637,51,85913,277,90550,328,1
621115,2320279,66,47,6250,0,6316,47,1
3676295,4317228,374,2,70881,0,71255,2,1
4114692,3193489,113,68,1885,0,1998,68,1
892466,378953,17,37,59,0,76,37,1
2187094,897064,75,6,725,0,800,6,1
4103612,589718,932,87,5655,0,6587,87,1
2938005,4423369,85,45,500,0,585,45,1
363750,403301,1001,55,10994,0,11995,55,1
4485028,150997,445,6,14565,0,15010,6,1
4604311,2716322,29,1,7472,0,7501,1,1
3514277,2941190,1338,6,13269,0,14607,6,1
1751669,1202510,860,277,9825,0,10685,277,1
2318498,4520863,5,3432,98,908,103,4340,1
3280389,4627479,1101,1,411419,0,412520,1,1
1467796,772366,118,28,1660,0,1778,28,1
3294702,2924737,991,545,68888,0,69879,545,1
4220533,4753961,329,490,3527,0,3856,490,1
1192480,1938455,397,1,20737,0,21134,1,1
2343253,1567127,1882,8,86401,0,88283,8,1
1875,3594449,656,146,61388,0,62044,146,1
532681,3514147,433,137,35023,0,35456,137,1
3734245,195371,915,64,34965,0,35880,64,1
2851109,3724686,450,1,98552,0,99002,1,1
4755384,1509966,27,1,83,0,110,1,1
4104158,138844,128,21,1909,0,2037,21,1
2956248,188865,346,73,6702,0,7048,73,1
1062967,1823831,260,4,15276,0,15536,4,1
2950311,2299880,807,16,85116,0,85923,16,1
3671141,61085,1444,159,48400,1809,49844,1968,1
4212637,4311524,35,6,2517,0,2552,6,1
2261139,4180183,2014,2,42851,0,44865,2,1
4429751,1390356,150,79,6616,0,6766,79,1
4419133,2148937,38,672,163,47361,201,48033,1
1580988,1246505,2821,6,400133,0,402954,6,1
3065345,4828134,13,221,89,115,102,336,1
3794146,2886403,16,61,281,0,297,61,1
1829442,956648,62,384,543,0,605,384,1
3764177,718590,1036,33,64563,0,65599,33,1
2951982,3999921,56,1,499,0,555,1,1
820381,3571271,85,20,2091,98,2176,118,1
3280389,1532747,1101,8,411419,0,412520,8,1
78836,97431,86,61,3525,0,3611,61,1
2343253,4492117,1882,2,86401,0,88283,2,1
2827436,4185352,882,399,271525,0,272407,399,1
3509903,352910,1530,3,509445,0,510975,3,1
1301815,1910015,752,33,48944,0,49696,33,1
2297625,3773990,512,64,6498,0,7010,64,1
92352,3208851,1138,35,20575,0,21713,35,1
843445,3733514,302,12,1763,0,2065,12,1
4688495,1846315,70,56,1522,0,1592,56,1
805360,1760684,1514,8,119306,0,120820,8,1
4209323,61310,1630,53,89460,0,91090,53,1
2248686,4615060,168,10,1937,0,2105,10,1
2784572,3703456,69,1,3478,0,3547,1,1
521586,1830732,782,1,18489,0,19271,1,1
1875,4618429,656,37,61388,0,62044,37,1
2751572,1592137,481,115,44036,0,44517,115,1
253352,148627,237,79,10413,0,10650,79,1
1063857,4635637,248,92,15849,0,16097,92,1
1533546,4439475,703,19,22095,0,22798,19,1
159285,2840606,240,37,4650,0,4890,37,1
575638,3227358,363,5,3219,0,3582,5,1
2355092,4722453,30,57,2544,0,2574,57,1
1787075,2031426,894,63,28305,0,29199,63,1
426136,1659656,21,90,187,0,208,90,1
3685001,2000752,37,1592,1779,162,1816,1754,1
1063358,751321,1350,20,63494,0,64844,20,1
6618,1168366,892,55,68849,0,69741,55,1
3280389,4328594,1101,2,411419,0,412520,2,1
3509903,4081687,1530,16,509445,0,510975,16,1
78836,4831598,86,106,3525,0,3611,106,1
2059990,369385,69,144,342,0,411,144,1
948768,1098011,587,68,14768,0,15355,68,1
835513,3457655,67,7,644,0,711,7,1
3449530,1082554,717,82,73648,0,74365,82,1
3361377,4395333,4841,1,761793,0,766634,1,1
2827436,4281340,882,1,271525,0,272407,1,1
941212,1886637,184,7,6404,0,6588,7,1
845876,1522419,15,76,124,148,139,224,1
2713819,348913,6,32,108,966,114,998,1
2762372,3823411,818,234,6089,0,6907,234,1
3509903,1230400,1530,1,509445,0,510975,1,1
3824547,3600210,1075,10,14337,0,15412,10,1
3936039,3650283,799,4,23884,0,24683,4,1
2209136,2187024,620,67,33789,0,34409,67,1
755739,3347784,1117,106,58043,0,59160,106,1
907654,2078367,798,26,24575,0,25373,26,1
4295952,4277479,808,104,57369,0,58177,104,1
2068128,2230220,76,145,2000,0,2076,145,1
1887709,2083266,217,80,28983,153,29200,233,1
3220336,4285348,34,5,175,0,209,5,1
3255990,4650955,170,211,583,0,753,211,1
3037644,3368745,71,898,2219,0,2290,898,1
3361377,3560507,4841,1,761793,0,766634,1,1
1676127,2563846,39,2,1494,0,1533,2,1
4803701,914975,333,177,6414,0,6747,177,1
1697778,1379983,125,117,3760,0,3885,117,1
2389799,565730,59,365,135,151,194,516,1
932720,3224053,1411,124,111323,0,112734,124,1
2861639,2827271,481,79,10848,0,11329,79,1
3028424,1633866,83,1,330,0,413,1,1
4675629,2725609,41,12,850,0,891,12,1
3294702,2444149,991,118,68888,0,69879,118,1
1580988,3857324,2821,1,400133,0,402954,1,1
3707352,3522148,144,88,5112,0,5256,88,1
3676714,2925373,78,79,157,0,235,79,1
2981537,1699035,1252,56,118718,0,119970,56,1
687713,4140264,436,1,47160,0,47596,1,1
2464401,3698748,577,102,23681,0,24258,102,1
3629404,4745431,185,17,6681,0,6866,17,1
1580988,1715637,2821,31,400133,0,402954,31,1
4749087,733261,38,15,443,0,481,15,1
4360960,3558262,1642,3,110084,0,111726,3,1
2107861,2518360,535,4,25743,0,26278,4,1
2117160,2968121,18,3,521,0,539,3,1
4708541,2561202,981,106,15678,0,16659,106,1
1250021,235931,4637,10,85913,0,90550,10,1
1533546,3806743,703,14,22095,0,22798,14,1
2514271,2487883,387,210,19070,0,19457,210,1
4313572,925265,930,6,16971,0,17901,6,1
4361636,3157183,186,601,1867,0,2053,601,1
2841394,4373700,159,11,3045,0,3204,11,1
2961801,1853692,1483,27,101962,0,103445,27,1
3228493,3794054,19,1,2744,0,2763,1,1
3034670,435540,12,4,420,0,432,4,1
1875,397263,656,62,61388,0,62044,62,1
3658026,4546264,223,1,1451,0,1674,1,1
2895033,215641,164,139,2870,0,3034,139,1
3280389,2273646,1101,3,411419,0,412520,3,1
2754478,2716388,86,12,1994,0,2080,12,1
3438576,1165625,3424,2,137753,0,141177,2,1
2202905,1557086,42,156,203,571,245,727,1
352669,2133845,51,1,1151,0,1202,1,1
3566847,133392,155,413,1106,19,1261,432,1
607449,765532,380,59,19369,0,19749,59,1
4074044,4554821,247,41,2547,0,2794,41,1
3501482,2017824,522,71,28046,0,28568,71,1
439374,2828690,233,12,1673,0,1906,12,1
4708537,3279194,119,28,885,0,1004,28,1
1015986,2303859,604,466,14201,0,14805,466,1
3764177,279547,1036,62,64563,0,65599,62,1
1464680,2465230,43,88,189,663,232,751,1
3509903,4239806,1530,69,509445,0,510975,69,1
1250021,2979123,4637,65,85913,808,90550,873,1
3438576,38374,3424,27,137753,0,141177,27,1
837658,2711439,3,81,11,40,14,121,1
2981537,234473,1252,20,118718,0,119970,20,1
2950311,410931,807,317,85116,0,85923,317,1
1083370,4207650,36,39,9,59,45,98,1
4330391,4278860,773,151,32759,0,33532,151,1
1493154,313072,17,1,224,0,241,1,1
2961801,268788,1483,63,101962,0,103445,63,1
3361377,3897901,4841,3,761793,0,766634,3,1
2553405,1541127,568,82,12913,0,13481,82,1
1580508,3080873,720,119,19611,0,20331,119,1
455037,3846114,61,98,973,0,1034,98,1
1689502,4657998,63,12,3676,0,3739,12,1
1534362,3589681,1531,25,105859,0,107390,25,1
4309630,4049767,105,324,476,848,581,1172,1
3632293,581565,570,2,21294,0,21864,2,1
3438576,3881825,3424,7,137753,0,141177,7,1
3065808,3209267,1235,18,82317,0,83552,18,1
2981537,2026480,1252,2,118718,0,119970,2,1
2148937,1181738,672,2,47361,0,48033,2,1
4157321,2713411,146,384,181,4637,327,5021,1
4525011,409432,172,2,6076,0,6248,2,1
4233503,4616764,224,27,7867,0,8091,27,1
813554,590589,252,6,17214,0,17466,6,1
4192206,56246,468,1,18229,0,18697,1,1
2164178,4251828,574,163,6134,0,6708,163,1
3525425,138908,81,148,2773,0,2854,148,1
1292661,2713599,57,12,889,0,946,12,1
4411870,3694528,948,551,60517,0,61465,551,1
3137585,3291849,1196,95,77354,0,78550,95,1
1445380,4776879,40,40,4396,0,4436,40,1
4140279,3513149,337,1,49384,0,49721,1,1
2723351,3023881,135,1035,149,996,284,2031,1
3638272,2121867,2022,1,370904,0,372926,1,1
427805,1071300,483,1,156906,0,157389,1,1
4754275,3808186,75,291,2058,0,2133,291,1
2343253,2307348,1882,1,86401,0,88283,1,1
1212191,4381750,58,798,218,153,276,951,1
3361377,2149677,4841,7,761793,0,766634,7,1
4272102,4000385,1608,1,104171,0,105779,1,1
516562,1050990,70,21,812,0,882,21,1
2320698,3322658,29,1,80,0,109,1,1
4838376,3034350,606,54,26838,0,27444,54,1
4714344,3590727,54,8,631,0,685,8,1
4747898,1682643,61,6,1067,0,1128,6,1
1383571,663340,91,83,1112,378,1203,461,1
2261139,618104,2014,29,42851,0,44865,29,1
3395938,3210412,546,131,39878,0,40424,131,1
4191410,158088,1590,77,96434,0,98024,77,1
4860485,1770977,89,134,3655,0,3744,134,1
855051,3737616,26,11,357,0,383,11,1
941726,3268923,45,52,402,0,447,52,1
240570,415521,138,175,1079,2013,1217,2188,1
4140279,4490069,337,13,49384,0,49721,13,1
3671141,3663749,1444,53,48400,0,49844,53,1
1086912,4301534,907,7,33396,0,34303,7,1
4198771,3653360,207,426,8543,0,8750,426,1
813554,3332060,252,14,17214,0,17466,14,1
3361377,1707803,4841,3,761793,0,766634,3,1
1880135,1459227,810,67,71924,0,72734,67,1
2851109,2760531,450,4,98552,0,99002,4,1
3638272,705108,2022,3,370904,0,372926,3,1
1727159,1048687,64,76,723,0,787,76,1
4689808,1043410,280,72,14220,0,14500,72,1
4174231,3274420,90,3,1471,0,1561,3,1
4587866,510272,507,249,2074,0,2581,249,1
2489315,3229514,200,44,812,0,1012,44,1
3167388,4297651,203,18,9760,0,9963,18,1
1455058,4262824,129,3,3856,0,3985,3,1
2157608,3975442,50,6,528,0,578,6,1
791866,3047816,639,40,243,0,882,40,1
2854573,420323,99,191,5019,0,5118,191,1
1913445,919478,564,83,47943,0,48507,83,1
829561,73000,49,25,2109,15,2158,40,1
3438576,3036111,3424,4,137753,0,141177,4,1
1533546,1380431,703,6,22095,0,22798,6,1
3438576,3352301,3424,1,137753,0,141177,1,1
276216,2122487,312,14,12600,0,12912,14,1
1331570,2046182,103,169,2386,0,2489,169,1
957197,1984145,614,7,37109,0,37723,7,1
3361377,4186626,4841,1,761793,0,766634,1,1
3280389,4627413,1101,1,411419,0,412520,1,1
2358233,3741941,46,1,665,0,711,1,1
4257751,4762781,109,515,8420,0,8529,515,1
4360960,4246279,1642,57,110084,0,111726,57,1
781211,3008149,976,55,51781,0,52757,55,1
4060074,2163370,178,109,7305,0,7483,109,1
4656285,4383112,1446,1,35428,0,36874,1,1
3881634,785590,641,27,8471,1203,9112,1230,1
2851109,4831158,450,12,98552,0,99002,12,1
2464401,1696012,577,87,23681,0,24258,87,1
607449,1731902,380,124,19369,0,19749,124,1
1512714,4776548,253,90,6663,0,6916,90,1
837553,1720091,1249,10,61665,0,62914,10,1
1218807,1665528,75,2,1283,0,1358,2,1
4483216,2024404,39,21,241,0,280,21,1
4721617,3772588,307,71,12885,0,13192,71,1
439557,157042,2090,21,61744,0,63834,21,1
805360,3431776,1514,115,119306,0,120820,115,1
2980603,3249563,30,70,544,0,574,70,1
2872979,1525484,341,34,28510,0,28851,34,1
781211,2621002,976,211,51781,0,52757,211,1
2956957,1321629,79,18,655,0,734,18,1
2861639,70583,481,90,10848,0,11329,90,1
3871554,479393,947,29,16042,0,16989,29,1
2950311,4162811,807,27,85116,0,85923,27,1
813554,770525,252,16,17214,0,17466,16,1
4236325,1483204,372,394,6103,0,6475,394,1
837553,3303247,1249,143,61665,0,62914,143,1
47928,1972277,120,95,3814,0,3934,95,1
3361377,2909237,4841,3,761793,0,766634,3,1
259575,3640855,260,2,13949,0,14209,2,1
3567246,4510217,192,101,3712,0,3904,101,1
3522049,608444,301,765,12347,0,12648,765,1
3569179,415768,1064,49,40015,0,41079,49,1
4631265,1562340,120,75,908,0,1028,75,1
3385095,4592122,63,1748,344,8,407,1756,1
3336522,2925094,36,18,2235,0,2271,18,1
781211,364625,976,187,51781,0,52757,187,1
3538667,4663210,67,130,2251,0,2318,130,1
1276253,109242,407,4,46534,0,46941,4,1
781211,1760631,976,5,51781,0,52757,5,1
1533314,2123951,361,128,6007,0,6368,128,1
2999986,4459978,120,11,1369,0,1489,11,1
2662809,2568834,303,7,10704,0,11007,7,1
4618437,1778132,372,8,743,0,1115,8,1
3870941,1264439,177,2,447,0,624,2,1
2405789,3866835,1010,34,93387,0,94397,34,1
3542727,2281962,21,208,341,0,362,208,1
1873970,1941242,39,66,197,0,236,66,1
1243539,3978988,104,32,741,0,845,32,1
3734245,3639079,915,8,34965,0,35880,8,1
2494800,1943567,752,52,5329,0,6081,52,1
3509903,3813603,1530,1,509445,0,510975,1,1
4624595,2559700,722,58,53368,0,54090,58,1
2096270,2726801,970,166,26018,0,26988,166,1
2950311,1965652,807,86,85116,0,85923,86,1
2827436,4375863,882,2,271525,0,272407,2,1
471868,1826029,120,3,1029,0,1149,3,1
2528239,1499829,196,3,1630,0,1826,3,1
441667,4733926,198,143,14727,0,14925,143,1
1633053,2239590,533,30,8638,0,9171,30,1
2446968,2640439,452,6,20110,0,20562,6,1
1777808,4141211,211,56,3413,245,3624,301,1
932720,853812,1411,69,111323,0,112734,69,1
932720,3534304,1411,17,111323,0,112734,17,1
2343253,927589,1882,2,86401,0,88283,2,1
1609659,3470308,523,150,29763,0,30286,150,1
3280389,1776072,1101,3,411419,0,412520,3,1
276216,3201609,312,89,12600,0,12912,89,1
680015,3836288,485,129,9502,0,9987,129,1
2209136,44699,620,4,33789,0,34409,4,1
592541,2553649,132,16,6913,0,7045,16,1
2307868,4144843,1131,4,38777,0,39908,4,1
3438446,4499653,783,224,923,289,1706,513,1
268844,444557,422,39,5070,0,5492,39,1
3361377,11761,4841,2,761793,0,766634,2,1
4853234,2762893,1256,29,29554,0,30810,29,1
1913445,2172435,564,33,47943,0,48507,33,1
2722942,2139555,240,170,8655,0,8895,170,1
3509903,4228347,1530,2,509445,0,510975,2,1
3518048,413262,66,24,1817,0,1883,24,1
1810692,1504506,24,551,214,1317,238,1868,1
2982458,4294126,66,434,295,0,361,434,1
1276253,1141788,407,2,46534,0,46941,2,1
842615,4241387,510,100,12316,0,12826,100,1
532681,3663130,433,100,35023,0,35456,100,1
2247657,2707775,306,99,7138,0,7444,99,1
3936039,339441,799,6,23884,0,24683,6,1
1250021,1607308,4637,19,85913,0,90550,19,1
3845148,66458,44,13,3928,0,3972,13,1
2516076,331223,1455,227,77782,0,79237,227,1
4249983,3609636,679,390,16076,0,16755,390,1
1230288,1038341,37,100,1909,0,1946,100,1
3280389,4503047,1101,2,411419,0,412520,2,1
4417253,945074,1130,64,68389,0,69519,64,1
3361377,4158001,4841,7,761793,0,766634,7,1
129556,2191295,235,79,1685,0,1920,79,1
2097416,1560049,24,1121,90,12468,114,13589,1
3478545,4416971,72,66,572,0,644,66,1
4209323,203399,1630,87,89460,0,91090,87,1
3742930,3319687,410,187,22242,0,22652,187,1
3280389,3870737,1101,1,411419,0,412520,1,1
381300,4715085,114,1,1986,0,2100,1,1
3509903,4492723,1530,1,509445,0,510975,1,1
544584,624781,51,4,535,0,586,4,1
4007870,1623906,15,207,126,0,141,207,1
4619326,4788993,539,177,22721,0,23260,177,1
209437,2454127,267,2,1876,0,2143,2,1
3873768,2870183,449,55,35424,0,35873,55,1
1378976,1083940,136,59,230,0,366,59,1
4689808,1387418,280,15,14220,0,14500,15,1
4116537,2187834,55,31,2863,0,2918,31,1
709509,4737279,359,157,2719,573,3078,730,1
1777808,2908247,211,32,3413,0,3624,32,1
4451122,408803,985,201,41669,0,42654,201,1
3765475,2094136,873,3,107914,0,108787,3,1
4547539,3995,206,142,3195,0,3401,142,1
2031699,1415096,54,252,1081,0,1135,252,1
3863202,114865,137,2,785,0,922,2,1
1789499,72159,120,161,649,2037,769,2198,1
3959546,25871,233,214,2002,1848,2235,2062,1
2887240,1989678,1143,7,118405,0,119548,7,1
3132419,4728723,72,28,387,0,459,28,1
2961801,882992,1483,87,101962,0,103445,87,1
1839283,1959552,765,8,36658,0,37423,8,1
1494665,3879472,668,4,37638,0,38306,4,1
2827436,2405978,882,2,271525,0,272407,2,1
3605448,921520,202,39,2022,0,2224,39,1
1575009,4481602,429,90,37745,0,38174,90,1
4782707,3868251,513,152,31665,0,32178,152,1
3438576,3029886,3424,13,137753,0,141177,13,1
515290,1667814,285,38,34080,0,34365,38,1
1580988,236845,2821,2,400133,0,402954,2,1
2204426,409438,86,131,438,0,524,131,1
347798,2464312,328,110,1624,0,1952,110,1
4254737,3708550,574,139,1945,1251,2519,1390,1
907654,2578780,798,52,24575,0,25373,52,1
3169539,3086408,58,12,452,0,510,12,1
3877282,2204385,154,44,1097,155,1251,199,1
1580988,658377,2821,1,400133,0,402954,1,1
860473,3847695,751,16,20450,0,21201,16,1
3811953,4690944,105,109,2037,0,2142,109,1
1534362,1765400,1531,69,105859,0,107390,69,1
3438576,1598479,3424,94,137753,0,141177,94,1
1053177,2680149,293,12,3060,0,3353,12,1
4055608,3199676,126,3,1936,0,2062,3,1
2998026,151017,919,2,24182,0,25101,2,1
2502456,3626901,719,68,50725,0,51444,68,1
2529661,1816722,493,7,27309,0,27802,7,1
4370819,869024,403,113,6519,0,6922,113,1
1923198,349319,531,147,3973,0,4504,147,1
3065808,3117310,1235,237,82317,0,83552,237,1
805360,2470570,1514,86,119306,0,120820,86,1
815493,4424034,152,444,444,0,596,444,1
1428477,3804553,255,52,15459,0,15714,52,1
3844858,4076721,1591,14,28974,0,30565,14,1
1927211,1374570,1668,3,113322,0,114990,3,1
4411870,1641866,948,25,60517,0,61465,25,1
3567371,1351290,64,66,600,0,664,66,1
1577010,651779,373,9,2746,0,3119,9,1
3179820,1996342,65,114,295,0,360,114,1
2308819,360511,141,269,5491,0,5632,269,1
4075786,320439,34,2,522,0,556,2,1
3509903,851243,1530,1,509445,0,510975,1,1
4712782,2549554,171,79,4681,0,4852,79,1
439557,868820,2090,3,61744,0,63834,3,1
1966548,4444287,208,21,53149,0,53357,21,1
1317294,2945180,89,7,7800,0,7889,7,1
3361377,4543824,4841,2,761793,0,766634,2,1
2092359,846208,421,600,26936,17288,27357,17888,1
230289,748948,138,45,335,0,473,45,1
1062967,3922925,260,58,15276,0,15536,58,1
3875114,1966416,233,29,3154,0,3387,29,1
592541,2182311,132,3,6913,0,7045,3,1
2877907,3984512,508,151,16021,0,16529,151,1
4170143,4155825,202,336,2900,0,3102,336,1
4801471,4424051,585,3,17979,0,18564,3,1
3811953,444711,105,89,2037,0,2142,89,1
4578619,2208610,4,186,21,109,25,295,1
1192480,3705334,397,3,20737,0,21134,3,1
2405789,763714,1010,29,93387,0,94397,29,1
3070589,2058253,280,2,4483,0,4763,2,1
3206499,2387581,1337,22,32033,0,33370,22,1
2381592,2147466,47,38,360,0,407,38,1
2906370,3909653,271,12,4802,0,5073,12,1
1053177,67887,293,113,3060,0,3353,113,1
4727207,4526048,925,3,84581,0,85506,3,1
4672319,861624,483,28,9652,0,10135,28,1
3142714,3348762,35,21,1436,0,1471,21,1
3509903,3770578,1530,1,509445,0,510975,1,1
628258,3880150,155,387,4650,0,4805,387,1
2831341,1598425,100,11,283,0,383,11,1
371432,184011,90,13,228,0,318,13,1
3524073,1170967,157,74,3319,0,3476,74,1
212421,1750879,11,2,433,0,444,2,1
4423184,4212547,384,2,29809,0,30193,2,1
1497278,4795898,1869,149,35111,0,36980,149,1
4219479,1142669,158,4,4945,0,5103,4,1
3102873,809823,341,166,15098,0,15439,166,1
3509214,2084251,263,2,14139,0,14402,2,1
427805,4413838,483,2,156906,0,157389,2,1
3743349,2066419,84,12,886,0,970,12,1
1537492,13908,175,4,6621,0,6796,4,1
2636315,411170,46,57,254,893,300,950,1
3505068,4020914,167,12,2673,0,2840,12,1
185020,1622353,32,10,123,0,155,10,1
2386801,4467395,29,2084,26,14574,55,16658,1
2961801,4822355,1483,50,101962,0,103445,50,1
3509903,1187500,1530,3,509445,0,510975,3,1
2260014,847887,2466,3,98622,0,101088,3,1
813400,4127624,71,5,696,0,767,5,1
635715,3695619,149,118,389,0,538,118,1
4191410,1286498,1590,63,96434,0,98024,63,1
4518121,1631385,29,280,99,0,128,280,1
2802492,3545576,215,126,1064,0,1279,126,1
4603935,2657935,72,27,244,0,316,27,1
3038385,1048604,73,18,636,0,709,18,1
2092359,1459684,421,1,26936,0,27357,1,1
2516076,3097788,1455,51,77782,0,79237,51,1
4696238,1724932,93,153,1714,0,1807,153,1
474172,3465925,471,18,38713,0,39184,18,1
2092359,76499,421,5,26936,0,27357,5,1
1249967,2229419,207,2,11933,0,12140,2,1
4411870,3808186,948,291,60517,0,61465,291,1
3914135,2986834,2152,94,60084,0,62236,94,1
2887240,830626,1143,4,118405,0,119548,4,1
2343253,3925741,1882,3,86401,0,88283,3,1
1256917,142591,77,549,575,964,652,1513,1
1375875,268961,440,61,1950,0,2390,61,1
378666,605626,84,45,584,0,668,45,1
2529661,3615001,493,80,27309,0,27802,80,1
3246688,2815872,429,45,3462,0,3891,45,1
792179,2365732,30,24,163,0,193,24,1
3638272,1250165,2022,3,370904,0,372926,3,1
2651023,48968,140,11,2189,0,2329,11,1
4229482,3077045,182,69,1285,0,1467,69,1
1880135,3409072,810,128,71924,0,72734,128,1
1839283,1067367,765,399,36658,0,37423,399,1
3845119,1503662,461,78,28609,0,29070,78,1
889330,4014826,148,244,1591,288,1739,532,1
470424,1333243,16,8,315,0,331,8,1
4334842,4077622,85,104,4749,0,4834,104,1
3857537,1647948,1008,5,5225,0,6233,5,1
2994391,1738661,315,2,6520,0,6835,2,1
628351,644502,333,35,4229,0,4562,35,1
2649946,840666,30,2,371,0,401,2,1
941212,2196244,184,1,6404,0,6588,1,1
1330432,315397,12,4,1926,0,1938,4,1
873006,4460719,375,31,33630,0,34005,31,1
3361377,2568114,4841,3,761793,0,766634,3,1
339563,3689324,1999,11,7561,0,9560,11,1
1927211,4082710,1668,72,113322,0,114990,72,1
4451122,3768869,985,47,41669,0,42654,47,1
21944,651141,317,6,9419,0,9736,6,1
1913445,1558652,564,202,47943,0,48507,202,1
2989110,1998636,1042,235,19283,0,20325,235,1
3383083,604097,96,2,1075,0,1171,2,1
4751453,964104,520,74,27570,0,28090,74,1
3509903,4653178,1530,3,509445,0,510975,3,1
3291396,1474363,195,8,11502,0,11697,8,1
3449530,856247,717,9,73648,0,74365,9,1
618355,3151498,32,38,62,0,94,38,1
2851109,676315,450,1,98552,0,99002,1,1
3638272,1559001,2022,3,370904,0,372926,3,1
1534362,840089,1531,94,105859,0,107390,94,1
1494665,1898507,668,3,37638,0,38306,3,1
4191410,2978162,1590,121,96434,0,98024,121,1
2516076,2494943,1455,89,77782,0,79237,89,1
1652056,3205160,326,1,66845,0,67171,1,1
2591791,3797960,8,614,171,0,179,614,1
1936447,40634,167,101,2268,0,2435,101,1
1580988,1725911,2821,1,400133,0,402954,1,1
2702447,1289554,37,1,201,0,238,1,1
2341838,2822575,75,58,3932,0,4007,58,1
4209323,2966245,1630,12,89460,0,91090,12,1
4843360,620893,355,3,7866,0,8221,3,1
826026,2563068,33,96,119,0,152,96,1
3538667,4308510,67,3,2251,0,2318,3,1
957197,2828238,614,9,37109,0,37723,9,1
3561502,532323,1144,88,68800,0,69944,88,1
4112632,4640100,138,74,452,171,590,245,1
544230,3958044,1532,16,60768,0,62300,16,1
4011264,1493176,1360,19,116777,0,118137,19,1
2343253,1540331,1882,22,86401,0,88283,22,1
4738916,265635,1165,3,34124,0,35289,3,1
3632641,3138961,17,221,112,0,129,221,1
593740,3695693,1107,112,62807,0,63914,112,1
2314038,4466895,456,109,16347,0,16803,109,1
4621952,809977,922,12,5245,0,6167,12,1
813554,4624407,252,57,17214,0,17466,57,1
932720,1143770,1411,22,111323,0,112734,22,1
2418923,2827436,4,882,137,271525,141,272407,1
1702465,2678796,173,2,6319,0,6492,2,1
2851109,4643,450,2,98552,0,99002,2,1
46697,2206798,363,68,3359,0,3722,68,1
4179343,831831,119,9,9822,0,9941,9,1
4209323,2051198,1630,6,89460,0,91090,6,1
321701,4621265,100,13,541,0,641,13,1
6618,3450336,892,82,68849,0,69741,82,1
1550672,1666599,18,1,2328,0,2346,1,1
1373486,2063750,20,3,145,0,165,3,1
302204,3387613,366,75,3449,0,3815,75,1
3525869,3431315,63,161,212,374,275,535,1
4864489,907892,12,1,359,0,371,1,1
2212117,2859483,43,2,6252,0,6295,2,1
1603899,810286,497,267,5551,0,6048,267,1
2148937,4602736,672,49,47361,0,48033,49,1
1928928,4665308,169,57,5084,0,5253,57,1
3509903,3786162,1530,3,509445,0,510975,3,1
611927,2599860,305,44,8695,0,9000,44,1
1387569,3765475,37,873,232,107914,269,108787,1
1731071,1205030,72,121,948,0,1020,121,1
77213,4453811,214,14,1656,0,1870,14,1
471706,2345852,794,1,65616,0,66410,1,1
1153522,3627430,78,409,911,0,989,409,1
3058068,2471428,124,4,12734,0,12858,4,1
3509903,776156,1530,1,509445,0,510975,1,1
1262549,754584,40,73,1220,0,1260,73,1
818304,1975845,75,42,536,406,611,448,1
4035124,4762368,77,32,1496,0,1573,32,1
4710933,2098014,126,758,1331,223,1457,981,1
3509903,1782032,1530,4,509445,0,510975,4,1
1963389,772264,152,292,955,0,1107,292,1
4112891,1821035,426,1794,3572,60,3998,1854,1
3074145,4184750,205,25,5623,0,5828,25,1
2735016,2020001,53,1,1112,0,1165,1,1
3438576,1260656,3424,47,137753,0,141177,47,1
4360960,3951433,1642,42,110084,0,111726,42,1
1638032,4751946,91,57,3942,0,4033,57,1
2492402,3791101,336,902,1778,0,2114,902,1
4731849,758147,455,101,10886,0,11341,101,1
1164238,559095,179,317,2363,0,2542,317,1
765601,4423924,1485,162,101510,0,102995,162,1
2144660,358481,427,167,3108,0,3535,167,1
2187320,1588330,208,694,3143,10280,3351,10974,1
53878,1112090,284,3,2344,0,2628,3,1
3577332,3963879,108,1,582,0,690,1,1
3930937,1606898,225,53,8777,0,9002,53,1
3987684,275513,286,3,17372,0,17658,3,1
1301815,4583353,752,137,48944,0,49696,137,1
3280389,3037772,1101,1,411419,0,412520,1,1
431709,1548014,205,343,5602,0,5807,343,1
3059686,97253,460,25,4530,0,4990,25,1
2209891,4279467,204,96,4060,0,4264,96,1
3435785,1049681,220,10,1519,0,1739,10,1
3288730,893319,117,51,4627,0,4744,51,1
4708250,1952568,122,72,1075,0,1197,72,1
3616842,4091548,317,298,3201,0,3518,298,1
4653941,1281015,951,59,45883,0,46834,59,1
4069373,2620077,97,136,3470,491,3567,627,1
1212079,1587018,61,2,1208,0,1269,2,1
26269,1177458,57,8,936,0,993,8,1
607449,700672,380,13,19369,0,19749,13,1
3361377,24712,4841,6,761793,0,766634,6,1
3910135,3237332,298,31,14348,0,14646,31,1
4133484,341281,15,41,123,0,138,41,1
4653941,2930317,951,26,45883,0,46834,26,1
1927211,2281149,1668,282,113322,28082,114990,28364,1
2887240,126433,1143,2,118405,0,119548,2,1
2096270,3656517,970,99,26018,0,26988,99,1
2681811,661313,284,13,6285,0,6569,13,1
3676295,3310420,374,2,70881,0,71255,2,1
4070413,3043048,175,421,363,0,538,421,1
2729885,2476585,79,77,1096,0,1175,77,1
3280389,389440,1101,1,411419,0,412520,1,1
2827436,3599779,882,1,271525,0,272407,1,1
3638272,4319277,2022,1,370904,0,372926,1,1
2989110,2747176,1042,268,19283,0,20325,268,1
3971219,2079499,304,143,1726,0,2030,143,1
4451491,2909602,817,215,8836,0,9653,215,1
6618,654863,892,63,68849,0,69741,63,1
1580988,1133400,2821,1,400133,0,402954,1,1
3638272,1082995,2022,1,370904,0,372926,1,1
1787075,693305,894,51,28305,0,29199,51,1
2687552,1643457,238,205,25574,0,25812,205,1
3845119,1013024,461,1,28609,0,29070,1,1
2827436,2388999,882,1,271525,0,272407,1,1
60980,1893817,649,3,20708,0,21357,3,1
250102,2997453,189,6,4350,0,4539,6,1
3561502,1108415,1144,99,68800,0,69944,99,1
1878924,3551871,85,176,2012,0,2097,176,1
62950,4806888,137,14,1590,0,1727,14,1
3179820,2439375,65,403,295,218,360,621,1
1539837,313885,1127,28,62979,0,64106,28,1
3115867,2068424,1350,24,61232,0,62582,24,1
1324035,594647,165,192,534,0,699,192,1
4727207,3910284,925,34,84581,0,85506,34,1
805360,458412,1514,38,119306,0,120820,38,1
2343253,1840280,1882,755,86401,333,88283,1088,1
1077073,1190327,7,2,118,0,125,2,1
2260014,1048453,2466,106,98622,0,101088,106,1
2138219,4663037,110,3,600,0,710,3,1
765601,4823514,1485,58,101510,0,102995,58,1
4656285,177057,1446,8,35428,0,36874,8,1
4295952,1439583,808,19,57369,0,58177,19,1
2827436,249715,882,1,271525,0,272407,1,1
3316620,2936226,214,13,5083,0,5297,13,1
3361377,2494233,4841,38,761793,0,766634,38,1
4552182,2122003,372,14,1146,0,1518,14,1
1440373,1618616,55,931,315,5417,370,6348,1
3638272,2940810,2022,155,370904,0,372926,155,1
3458198,470171,60,9,4425,0,4485,9,1
2436781,2455561,689,867,9972,0,10661,867,1
2853969,3390899,1051,5,42591,0,43642,5,1
1937293,486068,434,505,16761,0,17195,505,1
3361377,28805,4841,2,761793,0,766634,2,1
3118804,550106,315,46,6025,0,6340,46,1
3361377,4133161,4841,1,761793,0,766634,1,1
4435816,3518558,262,2,8391,0,8653,2,1
648163,4249983,238,679,1998,16076,2236,16755,1
508396,2211352,29,1,125,0,154,1,1
2785706,139525,130,17,1838,0,1968,17,1
2790006,4310711,367,88,14747,0,15114,88,1
408043,4200738,77,101,2899,0,2976,101,1
4013601,709918,653,5,14886,0,15539,5,1
480106,1054482,8,12,77,0,85,12,1
3280389,2113603,1101,1,411419,0,412520,1,1
3063973,1983892,202,96,635,0,837,96,1
1633022,665248,246,80,23530,0,23776,80,1
1501241,903496,121,87,880,0,1001,87,1
1927211,1773888,1668,34,113322,0,114990,34,1
4180345,2013320,83,4,868,0,951,4,1
3294702,569172,991,27,68888,0,69879,27,1
1966548,283646,208,7,53149,0,53357,7,1
2342664,3673915,1181,13,26502,0,27683,13,1
2453598,3799446,100,14,1097,0,1197,14,1
1232882,2670231,75,4,6386,0,6461,4,1
2667980,1909351,80,134,1609,0,1689,134,1
3361377,4609715,4841,1,761793,0,766634,1,1
3638272,3529469,2022,1,370904,0,372926,1,1
3835618,3202076,694,133,25433,0,26127,133,1
3946789,853024,261,1,5606,0,5867,1,1
135188,3743319,51,33,5860,0,5911,33,1
3509903,3113668,1530,1,509445,0,510975,1,1
1886780,3770607,183,120,2578,0,2761,120,1
361783,4486163,54,27,516,0,570,27,1
441667,2621724,198,132,14727,0,14925,132,1
3438576,4748369,3424,37,137753,0,141177,37,1
3898535,4503569,59,22,9303,0,9362,22,1
1659017,1969970,817,213,13055,0,13872,213,1
2961801,2584291,1483,11,101962,0,103445,11,1
4642569,1359473,872,38,27586,0,28458,38,1
2827436,2487701,882,2,271525,0,272407,2,1
4505464,1804064,99,2,2637,0,2736,2,1
4052496,3767765,107,115,4222,0,4329,115,1
3569179,4360148,1064,3,40015,0,41079,3,1
4515355,1228515,21,2,8176,0,8197,2,1
3638272,2353281,2022,1,370904,0,372926,1,1
448517,1529762,625,8,12450,0,13075,8,1
429643,2696127,767,174,19668,0,20435,174,1
2056790,395024,24,37,1587,0,1611,37,1
593740,2970797,1107,51,62807,0,63914,51,1
354904,3538025,3193,27,105780,0,108973,27,1
1301815,4037289,752,7,48944,0,49696,7,1
3099326,4211907,176,18,1952,0,2128,18,1
4676944,1919069,35,6,1314,0,1349,6,1
4345608,3728343,234,82,2526,0,2760,82,1
4129777,1911268,35,1,62,0,97,1,1
3525425,1225533,81,215,2773,0,2854,215,1
3607310,3998016,318,30,3879,0,4197,30,1
3280389,1237293,1101,3,411419,0,412520,3,1
1092700,346554,44,28,382,0,426,28,1
3509903,4189731,1530,2,509445,0,510975,2,1
4108836,4273072,97,110,4234,0,4331,110,1
2650412,4744270,931,6,29038,0,29969,6,1
4619326,2449495,539,115,22721,0,23260,115,1
1031334,2229400,459,28,16840,0,17299,28,1
4209323,1833470,1630,33,89460,0,91090,33,1
752551,765601,460,1485,3526,101510,3986,102995,1
2627841,1591988,418,168,12342,0,12760,168,1
2581956,1034454,41,56,2268,0,2309,56,1
3509903,1843150,1530,1,509445,0,510975,1,1
713934,2213501,753,9,796,0,1549,9,1
445996,1001693,1175,8,12828,0,14003,8,1
2998026,1016009,919,6,24182,0,25101,6,1
2169730,2915820,6,476,66,1811,72,2287,1
3509903,758117,1530,2,509445,0,510975,2,1
3137585,2526874,1196,3,77354,0,78550,3,1
2709652,482933,335,31,3238,0,3573,31,1
2090342,1083911,155,101,2211,490,2366,591,1
1633022,1138427,246,1,23530,0,23776,1,1
708290,4287422,317,128,5975,0,6292,128,1
2827436,1827899,882,2,271525,0,272407,2,1
4090288,2577006,48,189,216,206,264,395,1
4101514,3196588,511,212,1676,669,2187,881,1
2662809,508913,303,64,10704,0,11007,64,1
3630714,3671649,257,8,7929,0,8186,8,1
544230,4703070,1532,45,60768,0,62300,45,1
3280389,2058933,1101,1,411419,0,412520,1,1
3280389,3603469,1101,1,411419,0,412520,1,1
1436216,2765131,1068,1,68770,0,69838,1,1
4397923,3354892,16,9,1228,0,1244,9,1
4711909,1813732,440,85,2933,0,3373,85,1
2153788,3786635,61,32,187,0,248,32,1
1418987,236310,15,81,45,322,60,403,1
3633019,1010679,746,177,32317,0,33063,177,1
3883912,4676145,109,168,802,0,911,168,1
2436781,3455900,689,100,9972,0,10661,100,1
2274892,2470504,24,50,579,0,603,50,1
3361377,1840280,4841,755,761793,333,766634,1088,1
957197,4799284,614,35,37109,0,37723,35,1
3914135,4203208,2152,19,60084,0,62236,19,1
3361377,3409804,4841,49,761793,0,766634,49,1
1629019,1546524,351,19,5823,0,6174,19,1
515537,1111201,74,13,1883,0,1957,13,1
4649206,3873768,566,449,31367,35424,31933,35873,1
4496449,2898986,174,34,4260,0,4434,34,1
4011264,2686601,1360,278,116777,0,118137,278,1
1023198,1327376,64,1291,539,818,603,2109,1
454454,1320967,61,352,1406,0,1467,352,1
4282517,1239811,103,127,855,0,958,127,1
1580988,592681,2821,2,400133,0,402954,2,1
1341178,2207383,899,4,16829,0,17728,4,1
151693,3083077,436,96,12181,0,12617,96,1
4191410,3487483,1590,76,96434,0,98024,76,1
2939325,429643,54,767,263,19668,317,20435,1
2962038,822903,495,6,14236,0,14731,6,1
1234540,3378938,1071,12,75251,0,76322,12,1
2075015,3343211,2664,45,85781,0,88445,45,1
912467,530842,51,5,1317,0,1368,5,1
3115867,2478806,1350,17,61232,0,62582,17,1
1353449,1086462,101,66,920,0,1021,66,1
2981537,3673389,1252,2,118718,0,119970,2,1
1814709,4112370,316,59,5746,0,6062,59,1
3509903,2341318,1530,1,509445,0,510975,1,1
4238001,3537924,869,41,61161,0,62030,41,1
873006,4428619,375,103,33630,0,34005,103,1
3969321,1773896,108,669,1939,109,2047,778,1
4011264,3844349,1360,20,116777,0,118137,20,1
1062967,4047328,260,11,15276,0,15536,11,1
3768176,1109092,167,58,1980,0,2147,58,1
2851109,2122468,450,3,98552,0,99002,3,1
2887240,1943192,1143,10,118405,0,119548,10,1
4333770,4753961,100,490,4077,0,4177,490,1
3294702,4750066,991,33,68888,0,69879,33,1
2206250,2118158,153,38,4857,0,5010,38,1
1913445,3979191,564,61,47943,0,48507,61,1
680015,820497,485,296,9502,0,9987,296,1
4649206,3508860,566,69,31367,0,31933,69,1
3567927,1396391,190,131,1980,1453,2170,1584,1
1652056,2881237,326,2,66845,0,67171,2,1
3361377,1656500,4841,69,761793,0,766634,69,1
4183784,1246916,931,94,59894,0,60825,94,1
2989110,1091112,1042,50,19283,0,20325,50,1
184346,2854737,119,751,537,637,656,1388,1
583280,837309,60,13,2234,0,2294,13,1
455994,888094,95,84,2615,0,2710,84,1
3361377,1528748,4841,3,761793,0,766634,3,1
4496449,3454756,174,128,4260,0,4434,128,1
1196844,1607076,548,125,36289,0,36837,125,1
4624595,4547594,722,88,53368,0,54090,88,1
1629019,2823657,351,1,5823,0,6174,1,1
4302921,3956670,509,84,13289,0,13798,84,1
1052336,4708537,93,119,1721,885,1814,1004,1
1697778,795343,125,1,3760,0,3885,1,1
4727207,737204,925,2,84581,0,85506,2,1
4272102,618422,1608,402,104171,0,105779,402,1
3914135,1015986,2152,604,60084,14201,62236,14805,1
1142005,3934801,42,69,358,0,400,69,1
2502456,1419302,719,10,50725,0,51444,10,1
3638272,237448,2022,31,370904,0,372926,31,1
3137585,2488519,1196,66,77354,0,78550,66,1
3280389,1871391,1101,1,411419,0,412520,1,1
4322182,4149033,83,16,3535,0,3618,16,1
1588705,1231003,1000,94,11879,0,12879,94,1
3513900,1307181,280,14,1809,0,2089,14,1
867959,1133758,30,1,193,0,223,1,1
842476,3971288,898,84,12479,0,13377,84,1
2772113,752417,792,65,42907,0,43699,65,1
487430,1929416,72,414,516,0,588,414,1
4656285,1672829,1446,1,35428,0,36874,1,1
2260014,4022178,2466,6,98622,0,101088,6,1
4492248,2232283,237,3,17127,0,17364,3,1
3624002,3888666,12,21,315,0,327,21,1
2950311,506980,807,23,85116,0,85923,23,1
932720,4482787,1411,108,111323,0,112734,108,1
3872736,3294702,258,991,12660,68888,12918,69879,1
4333770,4716154,100,100,4077,0,4177,100,1
1734954,4175221,369,10,5786,0,6155,10,1
1063857,2584515,248,203,15849,0,16097,203,1
1880135,4270281,810,9,71924,0,72734,9,1
3638272,2919209,2022,1,370904,0,372926,1,1
515537,872378,74,4,1883,0,1957,4,1
3638272,2871569,2022,121,370904,0,372926,121,1
4360960,2867718,1642,91,110084,0,111726,91,1
2827436,2893334,882,889,271525,30148,272407,31037,1
2956957,2691609,79,130,655,0,734,130,1
1436216,4663101,1068,19,68770,0,69838,19,1
3438576,1056509,3424,2,137753,0,141177,2,1
2108636,4334937,20,300,137,0,157,300,1
2348093,4812279,335,326,12064,0,12399,326,1
2551530,1506726,145,8,2250,0,2395,8,1
3387987,1207192,268,107,19035,0,19303,107,1
2057864,1000349,307,106,3995,0,4302,106,1
2702447,4189412,37,11,201,0,238,11,1
1580988,3826916,2821,2,400133,0,402954,2,1
3676295,844768,374,1,70881,0,71255,1,1
471706,1711343,794,10,65616,0,66410,10,1
4411870,706248,948,29,60517,0,61465,29,1
1794526,4467599,169,53,1730,0,1899,53,1
3654276,393269,153,12,3512,0,3665,12,1
2075015,3732275,2664,125,85781,0,88445,125,1
1580988,840343,2821,2,400133,0,402954,2,1
595757,2545059,340,296,26738,0,27078,296,1
4154740,840113,68,61,1352,0,1420,61,1
3802719,3550135,91,3,3170,0,3261,3,1
4330386,1190435,278,432,1246,3922,1524,4354,1
1301815,759787,752,34,48944,0,49696,34,1
3734245,625042,915,2,34965,0,35880,2,1
1196844,1959920,548,109,36289,0,36837,109,1
358057,931270,86,206,1795,0,1881,206,1
1236075,1104836,344,649,2346,0,2690,649,1
3506612,829466,119,536,1034,0,1153,536,1
2075015,65369,2664,57,85781,0,88445,57,1
3561222,528066,236,175,1461,0,1697,175,1
3638272,432443,2022,3,370904,0,372926,3,1
2981537,1188373,1252,3,118718,0,119970,3,1
522588,2237086,496,6,20091,0,20587,6,1
1847461,923697,1211,14,51149,0,52360,14,1
1537492,948272,175,37,6621,0,6796,37,1
2260014,4286643,2466,1,98622,0,101088,1,1
1163500,1532739,398,127,9540,0,9938,127,1
781211,4381597,976,35,51781,0,52757,35,1
1196844,4808095,548,163,36289,0,36837,163,1
4427914,3756957,25,37,178,0,203,37,1
837553,1635254,1249,48,61665,0,62914,48,1
3685001,908097,37,42,1779,0,1816,42,1
748019,164405,675,240,18480,0,19155,240,1
3361377,3025382,4841,2,761793,0,766634,2,1
1225580,1232481,159,313,2943,0,3102,313,1
4527056,2085859,11,764,71,100,82,864,1
1962884,2527445,404,2,3358,0,3762,2,1
611927,2517172,305,141,8695,0,9000,141,1
3872736,3443873,258,1,12660,0,12918,1,1
4314280,547491,568,17,9552,0,10120,17,1
829561,784073,49,5,2109,0,2158,5,1
4179343,4810927,119,147,9822,0,9941,147,1
1301815,2742220,752,340,48944,0,49696,340,1
3638272,18761,2022,1,370904,0,372926,1,1
2893353,4600557,204,124,1051,0,1255,124,1
1533546,3630838,703,34,22095,0,22798,34,1
2772113,2730691,792,40,42907,0,43699,40,1
3280389,2405883,1101,4,411419,0,412520,4,1
650944,44777,3,685,344,450,347,1135,1
773149,2342664,202,1181,926,26502,1128,27683,1
3115867,827866,1350,107,61232,0,62582,107,1
3280389,344579,1101,2,411419,0,412520,2,1
1236887,529648,73,626,705,0,778,626,1
2950311,4739555,807,2,85116,0,85923,2,1
560588,3365459,13,69,214,0,227,69,1
3734245,4652426,915,162,34965,0,35880,162,1
1420087,1432945,204,168,1781,0,1985,168,1
4140279,3739564,337,42,49384,0,49721,42,1
3881634,972399,641,327,8471,0,9112,327,1
3761102,2233091,279,141,11592,0,11871,141,1
1234540,257476,1071,4,75251,0,76322,4,1
3867232,3718749,71,77,1994,0,2065,77,1
3361377,3294162,4841,13,761793,0,766634,13,1
55855,4310504,245,195,5888,0,6133,195,1
3671141,1337159,1444,37,48400,0,49844,37,1
1878924,897873,85,383,2012,0,2097,383,1
3509903,3897392,1530,3,509445,0,510975,3,1
4169303,3581291,93,83,1967,535,2060,618,1
2961801,1704670,1483,50,101962,0,103445,50,1
2989110,2902805,1042,46,19283,0,20325,46,1
2343253,4113967,1882,9,86401,0,88283,9,1
3638272,4195269,2022,219,370904,0,372926,219,1
689519,1968010,92,786,1171,10371,1263,11157,1
1735116,1159406,503,136,16146,0,16649,136,1
2985909,1869968,706,54,43348,0,44054,54,1
471706,1165249,794,7,65616,0,66410,7,1
252905,2054943,218,14,4356,0,4574,14,1
1913445,4004883,564,2,47943,0,48507,2,1
1698789,1055762,309,12,970,0,1279,12,1
2120140,191070,453,452,6305,0,6758,452,1
4443577,4041735,509,34,11936,0,12445,34,1
4209323,2694042,1630,53,89460,0,91090,53,1
1774441,2406215,65,461,1305,0,1370,461,1
4771452,3466610,411,100,8072,0,8483,100,1
2958239,2425860,101,181,3638,0,3739,181,1
4738916,2171332,1165,4,34124,0,35289,4,1
2791231,2373535,183,90,5221,0,5404,90,1
752551,318704,460,2,3526,0,3986,2,1
2542968,722561,444,8,4728,0,5172,8,1
3610598,3808548,380,2,17343,0,17723,2,1
2096270,1728358,970,5,26018,0,26988,5,1
4257751,2771136,109,6,8420,0,8529,6,1
765601,4016191,1485,29,101510,0,102995,29,1
2482338,2088883,712,2,24222,0,24934,2,1
1847461,4514642,1211,7,51149,0,52360,7,1
1442500,3282190,298,183,535,834,833,1017,1
2851923,2557698,242,158,1496,0,1738,158,1
3280389,183119,1101,41,411419,0,412520,41,1
805360,3529060,1514,55,119306,0,120820,55,1
1506065,172922,136,9,3968,0,4104,9,1
860473,2025917,751,7,20450,0,21201,7,1
3742930,4514752,410,419,22242,0,22652,419,1
3058068,1192084,124,640,12734,0,12858,640,1
1537919,3099014,48,54,129,0,177,54,1
1355114,794988,47,3,2747,0,2794,3,1
755739,396902,1117,31,58043,0,59160,31,1
4319972,3170292,640,75,35279,651,35919,726,1
2781817,3172058,704,41,24613,0,25317,41,1
3610598,2712813,380,150,17343,0,17723,150,1
1475850,2223429,33,1,655,0,688,1,1
3823546,3192753,61,6,3026,0,3087,6,1
1301815,901946,752,10,48944,0,49696,10,1
1460845,554173,72,1,1322,0,1394,1,1
2332330,527267,76,327,427,262,503,589,1
1926532,3655721,336,37,9127,0,9463,37,1
1301815,2586867,752,54,48944,0,49696,54,1
1253890,354904,55,3193,280,105780,335,108973,1
1234540,559722,1071,75,75251,0,76322,75,1
2458529,1947814,116,4,344,0,460,4,1
3361377,2981585,4841,4,761793,0,766634,4,1
3280389,2241298,1101,1,411419,0,412520,1,1
141367,1739441,17,100,963,0,980,100,1
17330,505557,154,12,972,0,1126,12,1
966744,3671566,7,63,313,6,320,69,1
6618,1458608,892,24,68849,0,69741,24,1
3182882,770460,54,4,765,0,819,4,1
2300104,2170785,65,12,1453,0,1518,12,1
427805,2201614,483,1,156906,0,157389,1,1
2147720,225165,1608,34,78786,0,80394,34,1
748019,201891,675,34,18480,0,19155,34,1
2521358,1069719,9,2,87,0,96,2,1
3734245,401282,915,21,34965,911,35880,932,1
2502456,1543809,719,74,50725,0,51444,74,1
2551530,4425050,145,5,2250,0,2395,5,1
2516076,3133897,1455,195,77782,0,79237,195,1
4191410,773237,1590,25,96434,0,98024,25,1
408965,3301838,903,22,38623,0,39526,22,1
3842148,2433805,719,20,11430,0,12149,20,1
4385783,1945129,290,14,10995,0,11285,14,1
2445035,3738596,49,6,238,0,287,6,1
3671141,1748671,1444,135,48400,0,49844,135,1
2911269,3034103,740,128,20606,0,21346,128,1
4417253,4268113,1130,183,68389,0,69519,183,1
4417253,2741539,1130,74,68389,0,69519,74,1
4479394,3936500,52,42,446,0,498,42,1
296476,880495,112,414,297,210,409,624,1
2553405,4241477,568,3,12913,0,13481,3,1
1792987,1474305,97,74,3867,0,3964,74,1
1431076,3241251,167,2002,1978,228,2145,2230,1
3768187,1416419,84,401,243,2098,327,2499,1
2375878,2538313,248,264,14925,0,15173,264,1
4233503,281753,224,18,7867,0,8091,18,1
1937293,3628071,434,7,16761,0,17195,7,1
687713,1597393,436,1,47160,0,47596,1,1
3065808,1815850,1235,42,82317,0,83552,42,1
6618,210149,892,67,68849,0,69741,67,1
2380608,3414325,360,19,3399,0,3759,19,1
1580988,1557834,2821,1,400133,0,402954,1,1
2887240,778390,1143,4,118405,0,119548,4,1
4838761,3168925,214,6,384,0,598,6,1
2319796,96945,52,3,424,0,476,3,1
4302921,493046,509,45,13289,0,13798,45,1
1503116,27834,415,109,37079,0,37494,109,1
4799966,2131149,557,20,4819,0,5376,20,1
646587,1619999,122,32,5819,0,5941,32,1
1924872,4617512,361,237,5715,0,6076,237,1
1063358,4297602,1350,45,63494,0,64844,45,1
3094886,1044771,675,9,6621,0,7296,9,1
595757,3975888,340,4,26738,0,27078,4,1
2446968,2768860,452,26,20110,0,20562,26,1
1580988,2080858,2821,4,400133,0,402954,4,1
577580,2053070,187,269,3831,0,4018,269,1
2464401,1262532,577,124,23681,0,24258,124,1
3075881,2938624,313,2,3346,0,3659,2,1
2182964,1813084,214,96,6975,0,7189,96,1
1103332,504267,732,7,59415,0,60147,7,1
2147720,1776244,1608,80,78786,0,80394,80,1
842476,2053359,898,184,12479,0,13377,184,1
2950311,1258836,807,36,85116,0,85923,36,1
1478080,1556369,593,9,7009,0,7602,9,1
3773737,4203193,108,1,2435,0,2543,1,1
3930937,3043589,225,105,8777,0,9002,105,1
2901637,4818132,21,15,315,0,336,15,1
2502456,787826,719,189,50725,0,51444,189,1
3361377,2125178,4841,1,761793,0,766634,1,1
2961801,3321089,1483,74,101962,0,103445,74,1
2886330,4025368,415,71,10154,0,10569,71,1
3361377,2082286,4841,3,761793,0,766634,3,1
765601,4487697,1485,69,101510,0,102995,69,1
932720,2760997,1411,2,111323,0,112734,2,1
2961801,3884421,1483,3,101962,0,103445,3,1
911192,2359651,106,55,6327,0,6433,55,1
3638272,3659744,2022,1,370904,0,372926,1,1
988087,1650543,322,258,3765,0,4087,258,1
4621719,521749,306,138,4102,0,4408,138,1
1276253,1777073,407,1,46534,0,46941,1,1
3760120,2027108,76,1172,394,5587,470,6759,1
4295952,4577883,808,73,57369,0,58177,73,1
2092359,3889015,421,239,26936,0,27357,239,1
1927211,3286788,1668,61,113322,0,114990,61,1
3509903,4377457,1530,4,509445,0,510975,4,1
3065808,1907419,1235,67,82317,0,83552,67,1
2096270,4644144,970,437,26018,0,26988,437,1
592541,4651692,132,7,6913,0,7045,7,1
3505068,4592301,167,12,2673,0,2840,12,1
4302921,1297679,509,140,13289,0,13798,140,1
2981537,1998659,1252,1,118718,0,119970,1,1
2158267,471706,62,794,692,65616,754,66410,1
3509903,3783907,1530,3,509445,0,510975,3,1
1818911,3793936,425,258,2972,2342,3397,2600,1
4238001,1420466,869,87,61161,0,62030,87,1
940526,4223768,475,60,20786,0,21261,60,1
2122741,4660885,190,47,6085,0,6275,47,1
3992144,1791777,402,268,23683,0,24085,268,1
4437944,4443880,262,20,3324,0,3586,20,1
3765475,4792688,873,18,107914,0,108787,18,1
2887240,599853,1143,1,118405,0,119548,1,1
433459,589932,435,4,821,0,1256,4,1
4295952,4803464,808,67,57369,0,58177,67,1
1927211,2582799,1668,180,113322,0,114990,180,1
489584,2593143,421,39,12098,0,12519,39,1
3379919,3203720,15,8,39,0,54,8,1
663087,4825729,551,106,3410,0,3961,106,1
1533546,3101382,703,18,22095,0,22798,18,1
1723506,2544143,733,76,21835,0,22568,76,1
2199673,3543467,118,9,2496,0,2614,9,1
4423184,3670802,384,7,29809,0,30193,7,1
6618,4325033,892,8,68849,0,69741,8,1
392779,4116295,148,335,2136,0,2284,335,1
946854,2081727,22,3,2951,0,2973,3,1
3318434,3849675,55,105,1995,0,2050,105,1
998554,4219872,177,23,654,95,831,118,1
2981537,1300838,1252,2,118718,0,119970,2,1
817090,4225930,188,38,4245,0,4433,38,1
3361377,1151501,4841,5,761793,0,766634,5,1
4798192,1858261,816,39,20426,0,21242,39,1
1927211,2927289,1668,14,113322,0,114990,14,1
4731354,4406307,67,24,1999,0,2066,24,1
657592,1245979,231,53,3222,0,3453,53,1
2514271,2534366,387,30,19070,0,19457,30,1
3294702,4087007,991,6,68888,0,69879,6,1
4653941,1173032,951,28,45883,422,46834,450,1
1927211,3506351,1668,80,113322,0,114990,80,1
3361377,653081,4841,1,761793,0,766634,1,1
4213935,2115839,5,8,149,0,154,8,1
1276253,1944906,407,5,46534,0,46941,5,1
2343253,91376,1882,81,86401,0,88283,81,1
2148937,2455899,672,2,47361,0,48033,2,1
3638272,4603277,2022,1,370904,0,372926,1,1
69534,4790995,60,10,4328,0,4388,10,1
1880135,3113698,810,12,71924,0,72734,12,1
176070,4334423,39,8,600,0,639,8,1
530200,1274526,2035,2,62809,0,64844,2,1
1412630,200145,217,153,2179,0,2396,153,1
2490914,847279,570,14,22965,0,23535,14,1
3437068,3513410,295,27,1597,0,1892,27,1
4257751,4477544,109,13,8420,0,8529,13,1
1310800,4635696,200,4,6100,0,6300,4,1
996752,1170381,173,1,3538,0,3711,1,1
4712099,2986214,89,1,1106,0,1195,1,1
4272102,1949293,1608,27,104171,0,105779,27,1
2365051,1508512,118,26,436,0,554,26,1
3845119,4322870,461,76,28609,0,29070,76,1
3559552,1966242,145,12,2863,0,3008,12,1
1341178,1029480,899,231,16829,0,17728,231,1
1633022,2432484,246,1,23530,0,23776,1,1
1471685,2786500,1681,56,25550,0,27231,56,1
4642569,3929471,872,49,27586,0,28458,49,1
1071044,2485637,180,123,5128,0,5308,123,1
3509903,1498943,1530,2,509445,0,510975,2,1
4789203,3258311,355,2,11315,0,11670,2,1
3906136,4662637,387,15,41169,0,41556,15,1
4238001,3931869,869,69,61161,0,62030,69,1
2529661,4854085,493,55,27309,0,27802,55,1
3361377,3090208,4841,4,761793,0,766634,4,1
4257751,1934117,109,5,8420,0,8529,5,1
3361377,4286205,4841,2,761793,0,766634,2,1
805360,2020210,1514,63,119306,0,120820,63,1
4011264,2528215,1360,50,116777,0,118137,50,1
3361377,4106468,4841,1,761793,0,766634,1,1
3361377,3882555,4841,1,761793,0,766634,1,1
3438576,144571,3424,3,137753,0,141177,3,1
4727207,4235796,925,12,84581,0,85506,12,1
3338906,1067326,140,7,6745,0,6885,7,1
805360,1079393,1514,100,119306,0,120820,100,1
2886330,471706,415,794,10154,65616,10569,66410,1
1839283,3071481,765,10,36658,0,37423,10,1
1927211,684783,1668,29,113322,0,114990,29,1
267820,2741399,81,4,313,0,394,4,1
2861639,446407,481,52,10848,0,11329,52,1
2718229,3832039,43,12,328,0,371,12,1
1785615,3259971,153,22,2575,0,2728,22,1
4672596,2855914,107,28,3286,0,3393,28,1
733639,3072273,259,469,3744,0,4003,469,1
474172,203328,471,2,38713,0,39184,2,1
1559887,2547310,49,26,664,0,713,26,1
709509,3267063,359,416,2719,0,3078,416,1
1580988,3219045,2821,77,400133,0,402954,77,1
4259308,896754,47,39,197,298,244,337,1
3806161,1844296,66,319,1921,0,1987,319,1
1580988,878732,2821,4,400133,0,402954,4,1
2498087,3459727,1630,53,32582,0,34212,53,1
671026,3475182,421,20,8079,0,8500,20,1
2405789,1132481,1010,17,93387,0,94397,17,1
92352,3682632,1138,3,20575,0,21713,3,1
3115867,838349,1350,256,61232,784,62582,1040,1
873241,3019564,616,28,22633,0,23249,28,1
3638272,1995813,2022,7,370904,0,372926,7,1
593740,4597203,1107,32,62807,0,63914,32,1
1971124,2586149,30,826,332,0,362,826,1
2015479,4592122,232,1748,740,8,972,1756,1
3294702,4748399,991,145,68888,0,69879,145,1
435064,4283654,75,551,1031,206,1106,757,1
4295952,1952125,808,10,57369,0,58177,10,1
3632293,4469910,570,11,21294,0,21864,11,1
4289995,1395311,525,391,4959,0,5484,391,1
4479119,4331304,39,279,435,0,474,279,1
269982,3960424,351,43,9019,0,9370,43,1
3361377,1903484,4841,2,761793,0,766634,2,1
1539837,477671,1127,104,62979,0,64106,104,1
1250021,2448632,4637,16,85913,0,90550,16,1
4423184,1293635,384,49,29809,0,30193,49,1
940526,352283,475,7,20786,0,21261,7,1
2260014,3089380,2466,38,98622,0,101088,38,1
3914135,649761,2152,32,60084,0,62236,32,1
3966421,65928,104,1045,1999,0,2103,1045,1
2255478,1012489,190,60,2000,0,2190,60,1
3291396,1425943,195,11,11502,0,11697,11,1
1100354,2435670,163,1,24439,0,24602,1,1
3765475,1772816,873,1,107914,0,108787,1,1
2260014,821979,2466,1,98622,0,101088,1,1
3866209,2657284,449,2605,2902,690,3351,3295,1
3271484,1629820,1507,327,34093,0,35600,327,1
755739,1223825,1117,171,58043,0,59160,171,1
1779486,4311925,211,245,1444,0,1655,245,1
1875,4123704,656,97,61388,0,62044,97,1
860473,2172460,751,4,20450,0,21201,4,1
2881425,2350095,102,146,5272,3040,5374,3186,1
787416,4234717,115,2,9954,0,10069,2,1
3873768,4781963,449,149,35424,0,35873,149,1
2884705,2247584,649,14,10233,0,10882,14,1
2432100,2009278,15,41,630,0,645,41,1
4738916,747715,1165,16,34124,0,35289,16,1
1769943,934667,553,119,7901,1054,8454,1173,1
3765475,860402,873,1,107914,0,108787,1,1
3098318,1678899,230,4,1307,0,1537,4,1
3672238,4680325,518,119,12172,0,12690,119,1
3765475,2413867,873,4,107914,0,108787,4,1
907654,920204,798,226,24575,0,25373,226,1
3449530,3030552,717,28,73648,0,74365,28,1
2592965,4725720,567,580,1811,0,2378,580,1
2940588,3764759,554,63,9477,0,10031,63,1
1606469,3380377,96,146,5210,0,5306,146,1
3214323,1439643,147,7,12543,0,12690,7,1
3177962,2833080,40,1,519,0,559,1,1
1839283,216238,765,39,36658,0,37423,39,1
49336,42760,14,8,132,0,146,8,1
1633022,1419310,246,3,23530,0,23776,3,1
4191410,3153127,1590,24,96434,0,98024,24,1
3137585,4014198,1196,5,77354,0,78550,5,1
3857537,3458775,1008,8,5225,0,6233,8,1
2887240,3130761,1143,2,118405,0,119548,2,1
4035655,2366829,913,80,5979,0,6892,80,1
2886330,1875785,415,36,10154,0,10569,36,1
724436,150578,217,364,2547,1669,2764,2033,1
4322182,2833404,83,4,3535,0,3618,4,1
3280389,1215755,1101,2,411419,0,412520,2,1
2536472,2809631,344,1,9725,0,10069,1,1
3590948,58605,492,116,2943,0,3435,116,1
1644941,530200,172,2035,424,62809,596,64844,1
3137585,650824,1196,37,77354,0,78550,37,1
957197,4483756,614,1,37109,0,37723,1,1
765601,4550798,1485,47,101510,0,102995,47,1
3280389,2763409,1101,1,411419,0,412520,1,1
337208,4141211,174,56,1581,245,1755,301,1
1995965,4074198,86,135,200,0,286,135,1
2617350,2265923,256,67,6547,0,6803,67,1
3454216,4462656,89,115,449,618,538,733,1
1436174,4430473,105,1,9512,0,9617,1,1
3257465,791670,541,63,27614,0,28155,63,1
3842148,2394976,719,335,11430,10973,12149,11308,1
2827436,2882468,882,2,271525,0,272407,2,1
427805,3813714,483,1,156906,0,157389,1,1
1539837,4520152,1127,27,62979,0,64106,27,1
2063746,4366991,408,253,2642,530,3050,783,1
441667,4725805,198,26,14727,0,14925,26,1
3638272,4163161,2022,2,370904,0,372926,2,1
1891400,2879581,31,5,1176,0,1207,5,1
2610334,4088798,26,189,229,0,255,189,1
1139873,323922,670,3,10236,0,10906,3,1
3361377,908207,4841,1,761793,0,766634,1,1
4648695,2140422,145,65,625,0,770,65,1
1091128,3974930,88,30,1720,0,1808,30,1
862958,4754700,87,28,4203,0,4290,28,1
2827436,1232809,882,2,271525,0,272407,2,1
660008,3388871,139,11,2004,0,2143,11,1
2877907,982224,508,226,16021,0,16529,226,1
1367871,403913,104,70,6433,0,6537,70,1
4733353,1258518,244,398,1693,0,1937,398,1
380998,961834,200,1,8943,0,9143,1,1
1968010,1924416,786,3,10371,0,11157,3,1
932720,3488232,1411,97,111323,0,112734,97,1
1966548,4843636,208,1,53149,0,53357,1,1
4815919,2375269,367,384,3361,2509,3728,2893,1
603234,3760071,82,19,504,0,586,19,1
1436216,3662459,1068,217,68770,0,69838,217,1
3266676,1659872,62,114,420,151,482,265,1
1913445,283094,564,183,47943,0,48507,183,1
55855,1715763,245,81,5888,0,6133,81,1
1710318,564833,95,150,1946,0,2041,150,1
1763353,556313,126,1,10072,0,10198,1,1
2752180,67971,154,165,717,0,871,165,1
4440160,2066427,736,229,20522,0,21258,229,1
593740,4263731,1107,47,62807,0,63914,47,1
393185,3096420,591,69,7719,749,8310,818,1
3638272,3136898,2022,5,370904,0,372926,5,1
4318206,430092,251,134,13123,0,13374,134,1
1071044,651819,180,42,5128,0,5308,42,1
1249967,1115667,207,310,11933,0,12140,310,1
873006,1268716,375,180,33630,0,34005,180,1
1443319,186751,104,12,436,0,540,12,1
2827436,1873384,882,16,271525,0,272407,16,1
3509903,1317721,1530,1,509445,0,510975,1,1
78836,2762245,86,13,3525,0,3611,13,1
3065808,1983397,1235,52,82317,0,83552,52,1
773149,3487259,202,1227,926,1456,1128,2683,1
2790006,2686601,367,278,14747,0,15114,278,1
2267633,1870763,422,4,13247,0,13669,4,1
2299048,1575789,36,1,502,0,538,1,1
1534362,1110006,1531,19,105859,0,107390,19,1
2405789,4412771,1010,29,93387,0,94397,29,1
1225988,2255906,157,9,8881,0,9038,9,1
1615261,584002,955,80,12715,0,13670,80,1
4125527,587911,305,23,1880,0,2185,23,1
3214893,1139948,1087,45,6553,0,7640,45,1
4782707,4177878,513,39,31665,0,32178,39,1
2091039,1218579,218,434,940,1019,1158,1453,1
3836080,2716330,1197,11,59457,0,60654,11,1
3196759,2701929,57,19,440,0,497,19,1
3774580,2208741,256,4,3916,0,4172,4,1
3435785,4035655,220,913,1519,5979,1739,6892,1
1580988,948677,2821,29,400133,0,402954,29,1
4451122,2510466,985,55,41669,0,42654,55,1
3361377,163286,4841,2,761793,0,766634,2,1
2827436,3686190,882,2,271525,0,272407,2,1
3761102,411739,279,22,11592,0,11871,22,1
752551,1559950,460,382,3526,1524,3986,1906,1
1306885,2738968,172,18,3706,0,3878,18,1
3065808,2187320,1235,208,82317,3143,83552,3351,1
3361377,4296242,4841,3,761793,0,766634,3,1
3539834,3560504,15,2,1854,0,1869,2,1
3639542,2760277,840,508,336,290,1176,798,1
4653941,678654,951,11,45883,0,46834,11,1
3280389,886560,1101,1,411419,0,412520,1,1
449646,1564674,29,218,257,0,286,218,1
2495609,2615050,103,31,2169,0,2272,31,1
1588330,38542,694,26,10280,0,10974,26,1
1580988,3753523,2821,2,400133,0,402954,2,1
1305455,1138179,31,3,298,0,329,3,1
544230,4819024,1532,2,60768,0,62300,2,1
1580988,1885203,2821,42,400133,0,402954,42,1
1966548,1564197,208,1,53149,0,53357,1,1
2187320,4096798,208,105,3143,0,3351,105,1
2343253,2872181,1882,77,86401,169,88283,246,1
1389617,962107,482,78,2070,0,2552,78,1
2872979,1676127,341,39,28510,1494,28851,1533,1
3361377,2230128,4841,2,761793,0,766634,2,1
4649206,3456050,566,34,31367,0,31933,34,1
765601,2805738,1485,17,101510,0,102995,17,1
3837347,2903128,169,39,2761,0,2930,39,1
4642569,503179,872,73,27586,0,28458,73,1
3509903,3723474,1530,2,509445,0,510975,2,1
873241,4802848,616,45,22633,0,23249,45,1
2120733,2251530,819,242,20803,0,21622,242,1
1606469,132026,96,1,5210,0,5306,1,1
1632970,4705816,68,239,1727,0,1795,239,1
3992144,4569694,402,57,23683,0,24085,57,1
2023979,1940935,192,184,3227,0,3419,184,1
427805,1499999,483,2,156906,0,157389,2,1
4545429,4265654,61,692,770,0,831,692,1
2024753,1646004,172,621,1901,487,2073,1108,1
1927211,3996450,1668,60,113322,0,114990,60,1
1063358,2269038,1350,47,63494,0,64844,47,1
2380608,798650,360,463,3399,0,3759,463,1
3914135,3397860,2152,43,60084,0,62236,43,1
1787075,4289554,894,2,28305,0,29199,2,1
4411870,1194863,948,56,60517,0,61465,56,1
3361377,1180804,4841,184,761793,0,766634,184,1
932720,1099889,1411,160,111323,0,112734,160,1
283814,2358310,17,1,198,0,215,1,1
2022555,4499622,35,7,1068,0,1103,7,1
1250021,4028766,4637,58,85913,0,90550,58,1
2092043,3021395,73,24,2886,0,2959,24,1
3300452,1929487,114,7,1992,0,2106,7,1
386502,1169783,57,246,339,314,396,560,1
2260014,2381399,2466,6,98622,0,101088,6,1
4011264,2950780,1360,98,116777,0,118137,98,1
3992451,353191,17,46,222,0,239,46,1
4238001,808778,869,212,61161,0,62030,212,1
1580988,1834569,2821,79,400133,0,402954,79,1
3756233,961672,40,128,1481,0,1521,128,1
270994,2022757,7,3,335,0,342,3,1
4314280,3511577,568,191,9552,0,10120,191,1
1331940,2376646,802,68,32617,0,33419,68,1
1735116,4076954,503,10,16146,0,16649,10,1
3671141,3399114,1444,9,48400,0,49844,9,1
1575009,1046315,429,17,37745,0,38174,17,1
895123,4581483,149,122,2246,0,2395,122,1
4035725,3639542,146,840,453,336,599,1176,1
4711523,176292,115,66,1069,0,1184,66,1
3509903,1900378,1530,3,509445,0,510975,3,1
4052496,3949616,107,62,4222,0,4329,62,1
3257465,22404,541,3,27614,0,28155,3,1
3361377,2786136,4841,1,761793,0,766634,1,1
3906136,1178747,387,41,41169,0,41556,41,1
3487259,4442759,1227,96,1456,0,2683,96,1
2055544,3123939,141,1127,2577,0,2718,1127,1
1879936,3426930,281,8,6786,0,7067,8,1
2893334,3525380,889,87,30148,0,31037,87,1
489387,2741325,42,1,693,0,735,1,1
4653941,125491,951,1,45883,0,46834,1,1
3280389,3299226,1101,1,411419,0,412520,1,1
2120140,294168,453,5,6305,0,6758,5,1
765601,3499721,1485,71,101510,0,102995,71,1
2074594,1726555,123,101,201,0,324,101,1
427805,4249551,483,3,156906,0,157389,3,1
2897926,218398,565,24,25983,0,26548,24,1
4302921,4312463,509,5,13289,0,13798,5,1
3449530,399560,717,29,73648,0,74365,29,1
670309,832733,304,7,7567,0,7871,7,1
1190435,3131218,432,15,3922,0,4354,15,1
635909,2698053,179,4,6949,0,7128,4,1
3215649,1315881,106,172,1393,0,1499,172,1
938472,413064,124,85,4326,0,4450,85,1
4678614,4058585,452,6,16881,0,17333,6,1
2790006,505624,367,7,14747,0,15114,7,1
1875,3154294,656,71,61388,0,62044,71,1
4560210,779819,177,45,6565,0,6742,45,1
671026,4553324,421,113,8079,0,8500,113,1
4222854,2455790,207,52,1950,0,2157,52,1
3361377,2922262,4841,1,761793,0,766634,1,1
3914135,4510386,2152,28,60084,0,62236,28,1
1311307,296433,358,30,10864,0,11222,30,1
2099723,544230,97,1532,1446,60768,1543,62300,1
4678614,4412093,452,81,16881,0,17333,81,1
2432946,1363369,16,14,583,0,599,14,1
2538150,4462726,62,23,107,0,169,23,1
471706,3718557,794,38,65616,0,66410,38,1
2075015,3751289,2664,3,85781,0,88445,3,1
4727207,2720278,925,313,84581,928,85506,1241,1
795978,4288830,17,186,55,138,72,324,1
4642569,2709955,872,182,27586,0,28458,182,1
4318582,3619876,5,20,239,0,244,20,1
3280389,3951363,1101,1,411419,0,412520,1,1
1539837,3693823,1127,22,62979,0,64106,22,1
3214323,988784,147,39,12543,0,12690,39,1
2343253,2147925,1882,5,86401,0,88283,5,1
1341178,3683756,899,130,16829,0,17728,130,1
3638272,3651137,2022,3,370904,0,372926,3,1
2950311,451105,807,14,85116,0,85923,14,1
3482737,4543370,66,44,139,0,205,44,1
1839283,1084550,765,129,36658,0,37423,129,1
3257653,3202210,100,3,5222,0,5322,3,1
1068490,4048074,201,108,1742,0,1943,108,1
4656285,2522943,1446,32,35428,0,36874,32,1
2375878,3077758,248,19,14925,0,15173,19,1
1062390,2801302,289,555,1396,319,1685,874,1
4629176,1198111,2058,28,9211,0,11269,28,1
1008268,4628490,35,6,1089,0,1124,6,1
2474070,4010450,102,11,2421,0,2523,11,1
45028,3113788,243,4,2021,0,2264,4,1
3638272,3856157,2022,1,370904,0,372926,1,1
817110,3659440,138,25,1927,0,2065,25,1
2147720,63013,1608,73,78786,0,80394,73,1
408965,2006354,903,13,38623,0,39526,13,1
2061169,3856660,41,72,383,329,424,401,1
502082,3393428,589,197,16428,0,17017,197,1
2206250,2390407,153,36,4857,0,5010,36,1
3759853,3371747,451,25,16330,0,16781,25,1
92352,947526,1138,241,20575,0,21713,241,1
3361377,2287903,4841,8,761793,0,766634,8,1
2405789,297320,1010,35,93387,0,94397,35,1
3858334,4430402,129,12,1342,0,1471,12,1
2781817,2234386,704,8,24613,0,25317,8,1
4113414,3001735,403,185,3521,0,3924,185,1
4318206,1955041,251,88,13123,0,13374,88,1
3509903,1289891,1530,2,509445,0,510975,2,1
4272102,1420851,1608,17,104171,0,105779,17,1
687713,2384117,436,1,47160,0,47596,1,1
4798192,4537374,816,2,20426,0,21242,2,1
4120497,2277787,25,474,189,333,214,807,1
1580988,1341675,2821,22,400133,0,402954,22,1
658737,919910,42,24,262,0,304,24,1
4460693,1084630,403,1,2596,0,2999,1,1
1548012,3870460,73,14,1957,0,2030,14,1
3381542,2972919,67,18,184,0,251,18,1
1609659,1142047,523,19,29763,0,30286,19,1
3361377,2479860,4841,99,761793,0,766634,99,1
1677231,3583081,97,143,572,0,669,143,1
3509903,2286824,1530,1,509445,0,510975,1,1
1799076,4074907,146,207,3750,0,3896,207,1
3655779,614907,61,240,738,0,799,240,1
665164,2307130,396,136,12610,0,13006,136,1
4319972,4036357,640,3,35279,0,35919,3,1
2381218,3924603,298,231,3375,0,3673,231,1
2818749,2619523,92,100,3797,0,3889,100,1
2981537,1690914,1252,2,118718,0,119970,2,1
4237335,4394559,34,60,139,0,173,60,1
2027108,273366,1172,17,5587,0,6759,17,1
3721550,2084892,188,64,14527,0,14715,64,1
2206273,3902691,235,6,4892,0,5127,6,1
3252058,1364453,26,12,1860,0,1886,12,1
1323965,4182118,78,146,815,0,893,146,1
3844858,1456487,1591,1,28974,0,30565,1,1
439557,2019530,2090,32,61744,0,63834,32,1
157948,807384,6,487,35,0,41,487,1
4408813,4338088,288,58,10077,0,10365,58,1
2064263,2105641,69,22,504,0,573,22,1
1733957,1667353,554,77,15185,0,15739,77,1
92352,598801,1138,85,20575,0,21713,85,1
2343253,4009114,1882,3,86401,0,88283,3,1
2785706,1466231,130,408,1838,3853,1968,4261,1
4279424,2198452,293,175,948,0,1241,175,1
3361377,4068037,4841,1,761793,0,766634,1,1
1580988,2074093,2821,5,400133,0,402954,5,1
3235479,729410,999,73,66486,0,67485,73,1
2886626,3509821,192,176,6077,0,6269,176,1
4360960,2274625,1642,17,110084,0,111726,17,1
1581753,1445225,63,138,110,76,173,214,1
3137585,3033041,1196,115,77354,0,78550,115,1
4818741,1924204,107,395,989,0,1096,395,1
2148937,158260,672,93,47361,0,48033,93,1
474172,2195029,471,7,38713,0,39184,7,1
3936039,4040617,799,66,23884,0,24683,66,1
2187588,3475347,91,86,492,0,583,86,1
3540815,3603995,64,2,453,0,517,2,1
2075015,297153,2664,122,85781,0,88445,122,1
1721946,1170741,45,136,158,1381,203,1517,1
2792558,975667,37,7,405,0,442,7,1
3776823,2449078,64,69,671,0,735,69,1
3946789,3402933,261,31,5606,0,5867,31,1
2498087,3506934,1630,75,32582,0,34212,75,1
1735116,1436950,503,128,16146,0,16649,128,1
1710318,4559466,95,2,1946,0,2041,2,1
3065808,2003565,1235,12,82317,0,83552,12,1
837553,3958064,1249,199,61665,0,62914,199,1
1751669,2537635,860,44,9825,0,10685,44,1
3102873,2032034,341,172,15098,0,15439,172,1
4318206,4162266,251,18,13123,0,13374,18,1
2348093,1869394,335,26,12064,0,12399,26,1
688537,1717817,94,293,1363,0,1457,293,1
354904,599180,3193,34,105780,0,108973,34,1
3280389,4839626,1101,5,411419,0,412520,5,1
1580988,3418999,2821,1,400133,0,402954,1,1
4353839,4294250,144,617,3320,0,3464,617,1
2120733,2280679,819,67,20803,0,21622,67,1
3464608,3530398,129,1,2235,0,2364,1,1
593740,7211,1107,100,62807,0,63914,100,1
2502456,4245918,719,23,50725,0,51444,23,1
4745784,3359048,49,4,1839,0,1888,4,1
4417253,213791,1130,3,68389,0,69519,3,1
3671141,1809481,1444,27,48400,0,49844,27,1
2961801,4125989,1483,227,101962,0,103445,227,1
3793936,1917285,258,13,2342,0,2600,13,1
2260014,2388150,2466,108,98622,0,101088,108,1
1140134,2055732,311,2,11111,0,11422,2,1
307250,481149,919,7,35588,0,36507,7,1
1301815,1905369,752,48,48944,0,49696,48,1
1534362,4815761,1531,30,105859,0,107390,30,1
1652056,667838,326,1,66845,0,67171,1,1
1428477,3204640,255,98,15459,0,15714,98,1
1140134,4387,311,60,11111,0,11422,60,1
1499177,1703976,168,56,1229,0,1397,56,1
3638272,2051969,2022,26,370904,0,372926,26,1
1436216,3323791,1068,52,68770,0,69838,52,1
3612446,4467711,32,4,1944,0,1976,4,1
3842148,1443188,719,73,11430,0,12149,73,1
3361377,2756137,4841,13,761793,0,766634,13,1
4417253,2439066,1130,25,68389,0,69519,25,1
2510516,4630797,170,35,922,0,1092,35,1
4249983,847481,679,45,16076,0,16755,45,1
3361377,3735085,4841,3,761793,0,766634,3,1
1022123,4256453,126,31,8212,0,8338,31,1
1913445,986594,564,20,47943,0,48507,20,1
1107075,4200726,69,93,743,0,812,93,1
3361377,1639373,4841,3,761793,0,766634,3,1
1130958,3477967,42,1,1641,0,1683,1,1
1565864,3770494,102,352,620,0,722,352,1
4711523,712170,115,34,1069,0,1184,34,1
3882395,4153271,42,16,602,0,644,16,1
805360,318148,1514,66,119306,0,120820,66,1
1301815,2989461,752,33,48944,0,49696,33,1
4606184,1936308,265,153,4466,0,4731,153,1
4272102,554913,1608,65,104171,0,105779,65,1
2650412,1195479,931,95,29038,0,29969,95,1
3561502,1756343,1144,49,68800,0,69944,49,1
423761,1870204,238,62,1367,488,1605,550,1
2940588,1173414,554,9,9477,0,10031,9,1
1541786,2898368,128,602,271,208,399,810,1
2790006,4815839,367,59,14747,0,15114,59,1
6618,3341273,892,4,68849,0,69741,4,1
2281149,1249478,282,37,28082,0,28364,37,1
4319972,192393,640,170,35279,0,35919,170,1
2900246,1882278,29,138,250,0,279,138,1
4821538,3793246,3,13,50,0,53,13,1
790848,3633019,196,746,957,32317,1153,33063,1
3873768,1922741,449,39,35424,0,35873,39,1
792037,3460762,57,6,16445,0,16502,6,1
1462592,4854085,80,55,1198,0,1278,55,1
3180100,3117310,83,237,931,0,1014,237,1
3038385,2525373,73,63,636,122,709,185,1
1580988,493356,2821,2,400133,0,402954,2,1
2529661,4671082,493,15,27309,0,27802,15,1
1428477,2678260,255,8,15459,0,15714,8,1
530200,4161375,2035,16,62809,0,64844,16,1
1055530,4393064,415,1200,14969,0,15384,1200,1
595757,648853,340,19,26738,0,27078,19,1
2281149,1988877,282,27,28082,0,28364,27,1
2147720,4210554,1608,210,78786,0,80394,210,1
1500491,381924,78,36,1369,0,1447,36,1
3280389,4772748,1101,3,411419,0,412520,3,1
3761102,1115479,279,163,11592,0,11871,163,1
2950311,84306,807,30,85116,0,85923,30,1
4238001,1516243,869,3,61161,0,62030,3,1
530200,2681323,2035,6,62809,0,64844,6,1
502082,617910,589,14,16428,0,17017,14,1
1927974,2925772,107,18,9317,0,9424,18,1
4712099,1639585,89,43,1106,0,1195,43,1
1154430,3530234,155,28,1425,0,1580,28,1
2147720,3511113,1608,38,78786,0,80394,38,1
2698749,2134807,108,174,2511,0,2619,174,1
3873768,4252076,449,439,35424,0,35873,439,1
3638272,4758884,2022,3,370904,0,372926,3,1
4738916,3758743,1165,136,34124,0,35289,136,1
2516076,49134,1455,56,77782,0,79237,56,1
1887709,2999870,217,76,28983,0,29200,76,1
1580988,2762098,2821,1,400133,0,402954,1,1
1100354,4768912,163,1,24439,0,24602,1,1
3214893,3317785,1087,41,6553,0,7640,41,1
4011264,1319260,1360,1,116777,0,118137,1,1
3361377,2302941,4841,1,761793,0,766634,1,1
3065808,1876187,1235,34,82317,0,83552,34,1
2388735,1967886,403,28,4921,0,5324,28,1
1853437,4124426,31,16,210,0,241,16,1
4842461,1283251,450,145,3728,0,4178,145,1
471706,3768028,794,1037,65616,0,66410,1037,1
731671,45690,45,135,1296,0,1341,135,1
2498662,39970,91,14,535,0,626,14,1
1106007,845442,76,56,1132,0,1208,56,1
1961449,1264370,53,4,129,0,182,4,1
1580988,3012429,2821,1,400133,0,402954,1,1
3361377,4430865,4841,60,761793,0,766634,60,1
530200,1002788,2035,146,62809,0,64844,146,1
1639434,878137,587,87,8053,0,8640,87,1
2790336,3057661,132,50,990,0,1122,50,1
593740,4765973,1107,121,62807,0,63914,121,1
4269771,3235101,85,6,2600,0,2685,6,1
1301815,3125160,752,32,48944,0,49696,32,1
1580988,81236,2821,1,400133,0,402954,1,1
3721550,2147691,188,57,14527,0,14715,57,1
3112136,2968035,406,64,41366,0,41772,64,1
1453862,2862019,112,903,498,57,610,960,1
2256870,2711925,66,30,1885,0,1951,30,1
2147720,2941712,1608,77,78786,0,80394,77,1
2498087,251829,1630,158,32582,1467,34212,1625,1
4238001,1314056,869,10,61161,0,62030,10,1
4708541,2102594,981,38,15678,0,16659,38,1
3361377,2029916,4841,1,761793,0,766634,1,1
1205168,1622017,662,9,7710,0,8372,9,1
621115,1029052,66,6,6250,0,6316,6,1
4079785,3812245,444,1,144,0,588,1,1
3873768,3404453,449,58,35424,0,35873,58,1
3509903,433596,1530,3,509445,0,510975,3,1
612450,390491,94,3,547,0,641,3,1
3438576,1511248,3424,10,137753,0,141177,10,1
4569293,281453,191,110,5084,0,5275,110,1
2405789,3145196,1010,49,93387,0,94397,49,1
3065808,2649657,1235,66,82317,0,83552,66,1
2837948,4766736,83,1,1320,0,1403,1,1
2668661,852847,18,4,170,0,188,4,1
2439199,1550662,631,3,5929,0,6560,3,1
3836080,682737,1197,273,59457,0,60654,273,1
3340218,4368767,8,17,91,0,99,17,1
932720,3941112,1411,70,111323,0,112734,70,1
3017653,533203,91,336,1058,0,1149,336,1
2405789,3498460,1010,16,93387,0,94397,16,1
4319972,393867,640,155,35279,0,35919,155,1
1792932,631242,153,54,901,0,1054,54,1
46697,394347,363,122,3359,0,3722,122,1
2209136,3128514,620,140,33789,0,34409,140,1
2267633,3941742,422,135,13247,0,13669,135,1
4078514,3002219,12,5,1781,0,1793,5,1
4251247,2134818,47,11,524,0,571,11,1
2105917,2518158,59,10,348,0,407,10,1
429643,143286,767,95,19668,0,20435,95,1
427805,2005745,483,2,156906,0,157389,2,1
3509903,3218741,1530,2,509445,0,510975,2,1
347640,165865,330,89,1106,0,1436,89,1
1631645,2061466,65,5,911,0,976,5,1
77213,3834114,214,29,1656,0,1870,29,1
4295952,4069205,808,69,57369,0,58177,69,1
1880135,451322,810,52,71924,0,72734,52,1
3294702,4284774,991,43,68888,0,69879,43,1
4475727,2514472,41,4,220,0,261,4,1
2343253,1169,1882,1,86401,0,88283,1,1
1580988,2494236,2821,5,400133,0,402954,5,1
3509903,626389,1530,4,509445,0,510975,4,1
1777298,489707,468,2,6381,0,6849,2,1
2484593,1902802,29,32,50,46,79,78,1
3213299,1891534,53,86,299,46,352,132,1
1588330,1657855,694,8,10280,0,10974,8,1
3672238,2384998,518,98,12172,0,12690,98,1
3361377,3429060,4841,1,761793,0,766634,1,1
3280389,4749523,1101,1,411419,0,412520,1,1
2998788,2996989,3,10,1284,0,1287,10,1
2148937,1284544,672,10,47361,0,48033,10,1
3589461,4781744,40,4,163,0,203,4,1
805360,2242206,1514,91,119306,0,120820,91,1
1028920,1676186,194,67,1053,0,1247,67,1
3361377,3986066,4841,3,761793,0,766634,3,1
3549674,2596694,602,17,38542,0,39144,17,1
4329398,679592,70,238,220,155,290,393,1
3509903,2367785,1530,1,509445,0,510975,1,1
3318449,4666646,21,142,968,0,989,142,1
3502068,3473351,378,15,2133,0,2511,15,1
2120733,4848014,819,75,20803,0,21622,75,1
354904,3038932,3193,11,105780,0,108973,11,1
3140664,2966815,268,74,16099,0,16367,74,1
3280389,60399,1101,2,411419,0,412520,2,1
670296,4518808,632,5,10586,0,11218,5,1
1139873,1581579,670,31,10236,0,10906,31,1
1055530,2550816,415,116,14969,0,15384,116,1
1966548,1930164,208,3,53149,0,53357,3,1
1207753,3937380,533,73,9348,0,9881,73,1
3685001,443441,37,1,1779,0,1816,1,1
842476,2624330,898,59,12479,0,13377,59,1
1970133,551899,13,2,77,0,90,2,1
3676295,4011105,374,1,70881,0,71255,1,1
3294702,12354,991,4,68888,0,69879,4,1
2441425,3463570,803,102,18561,0,19364,102,1
3842148,2374967,719,17,11430,0,12149,17,1
3632293,4221898,570,18,21294,0,21864,18,1
1912031,4619637,226,420,2674,0,2900,420,1
3967002,4110188,69,10,299,0,368,10,1
3683235,4038290,311,7,23110,0,23421,7,1
3742930,697311,410,5,22242,0,22652,5,1
932720,3686068,1411,30,111323,0,112734,30,1
4843360,4033887,355,67,7866,0,8221,67,1
4451122,3845940,985,79,41669,0,42654,79,1
3999324,236246,9,306,47,11,56,317,1
493062,3277447,34,10,2722,0,2756,10,1
92352,1287113,1138,20,20575,0,21713,20,1
1020925,1641856,204,181,3339,0,3543,181,1
347798,516054,328,18,1624,0,1952,18,1
4662055,1044458,155,41,2918,0,3073,41,1
3383083,403561,96,44,1075,0,1171,44,1
2075015,1829277,2664,6,85781,0,88445,6,1
3112136,16579,406,2,41366,0,41772,2,1
3094886,4816848,675,30,6621,0,7296,30,1
4272102,3474677,1608,88,104171,0,105779,88,1
2923257,2673016,108,36,3187,0,3295,36,1
765601,3415425,1485,132,101510,0,102995,132,1
4642569,2800247,872,115,27586,0,28458,115,1
417999,2924203,173,435,2109,0,2282,435,1
1580988,1012985,2821,3,400133,0,402954,3,1
821089,3680619,394,379,4820,0,5214,379,1
3361377,3095792,4841,1,761793,0,766634,1,1
2853969,1853856,1051,10,42591,0,43642,10,1
1420087,4576364,204,9,1781,0,1985,9,1
3361377,1089989,4841,1,761793,0,766634,1,1
2456814,2064553,16,3,61,0,77,3,1
1436216,4822215,1068,33,68770,0,69838,33,1
408965,1907231,903,59,38623,0,39526,59,1
3361377,1347157,4841,2,761793,0,766634,2,1
781211,1004661,976,86,51781,0,52757,86,1
4801471,1906376,585,28,17979,0,18564,28,1
4674575,3406529,273,24,4000,0,4273,24,1
3916976,3027238,188,89,6098,0,6286,89,1
4011264,3948328,1360,5,116777,0,118137,5,1
4209323,4787225,1630,142,89460,0,91090,142,1
3082104,3820650,47,1,4343,0,4390,1,1
1147991,1098252,21,216,53,596,74,812,1
4304056,3420434,164,157,12698,0,12862,157,1
2516076,1210381,1455,19,77782,0,79237,19,1
1250021,1840132,4637,4,85913,0,90550,4,1
3361377,2370429,4841,6,761793,0,766634,6,1
4183784,4779968,931,160,59894,0,60825,160,1
1400646,1790151,80,87,1995,591,2075,678,1
805360,3054085,1514,29,119306,0,120820,29,1
1580988,242176,2821,2,400133,0,402954,2,1
4436276,4186985,67,204,1169,0,1236,204,1
1493489,4312084,523,127,17512,0,18035,127,1
3291145,1695095,105,90,4218,0,4323,90,1
4417253,2254404,1130,70,68389,0,69519,70,1
3873768,506368,449,187,35424,0,35873,187,1
2343253,4308341,1882,11,86401,0,88283,11,1
3509903,4719870,1530,2,509445,0,510975,2,1
18228,4338673,122,150,3947,0,4069,150,1
3756233,1875,40,656,1481,61388,1521,62044,1
2406672,2488421,22,1,1754,0,1776,1,1
4525011,3081155,172,10,6076,0,6248,10,1
4295952,4054045,808,288,57369,0,58177,288,1
3449530,3412149,717,36,73648,0,74365,36,1
821089,2060907,394,20,4820,0,5214,20,1
4209323,1886007,1630,24,89460,0,91090,24,1
3361380,97882,342,1,2750,0,3092,1,1
2772113,4493580,792,96,42907,0,43699,96,1
1534362,4168321,1531,8,105859,0,107390,8,1
1523725,1955889,205,183,580,321,785,504,1
3361377,1156264,4841,78,761793,0,766634,78,1
2527938,1805660,34,103,286,1625,320,1728,1
823355,1181600,17,2,277,0,294,2,1
1907524,4213095,39,3,651,0,690,3,1
2981537,1804749,1252,2,118718,0,119970,2,1
4238001,235979,869,4,61161,0,62030,4,1
4191410,977156,1590,82,96434,0,98024,82,1
2343253,2912755,1882,3,86401,0,88283,3,1
1471685,4616574,1681,2,25550,0,27231,2,1
635909,613546,179,2,6949,0,7128,2,1
745588,2311001,55,42,679,0,734,42,1
1927211,4258747,1668,103,113322,0,114990,103,1
636814,236065,116,3,9387,0,9503,3,1
1234540,1105124,1071,6,75251,0,76322,6,1
3361377,4567219,4841,2,761793,0,766634,2,1
1723506,3022409,733,3,21835,0,22568,3,1
3721550,4290363,188,29,14527,0,14715,29,1
713414,1335474,106,1,213,0,319,1,1
3235479,2803178,999,29,66486,0,67485,29,1
3769160,2485817,156,64,1054,0,1210,64,1
2841785,76809,16,1,149,0,165,1,1
4443577,3174667,509,332,11936,0,12445,332,1
3683235,4715368,311,12,23110,0,23421,12,1
4313572,498653,930,1,16971,0,17901,1,1
3742930,1509395,410,69,22242,0,22652,69,1
3147764,3998986,25,303,299,0,324,303,1
1546845,1692940,60,7,278,85,338,92,1
2827436,3697800,882,1,271525,0,272407,1,1
2281149,4610459,282,27,28082,0,28364,27,1
311390,3934648,281,63,428,0,709,63,1
4272102,2033249,1608,28,104171,0,105779,28,1
1580988,3324431,2821,2,400133,0,402954,2,1
1966548,4365418,208,55,53149,0,53357,55,1
4236325,4723586,372,10,6103,0,6475,10,1
2343253,2131134,1882,1,86401,0,88283,1,1
4423184,961669,384,67,29809,0,30193,67,1
225198,3074807,36,168,111,0,147,168,1
3438576,3593315,3424,37,137753,0,141177,37,1
1580988,2566862,2821,1,400133,0,402954,1,1
4408344,4506427,8,11,1042,0,1050,11,1
1769943,2143195,553,91,7901,0,8454,91,1
3280389,4416278,1101,1,411419,0,412520,1,1
805360,112416,1514,14,119306,0,120820,14,1
4254737,2946905,574,97,1945,0,2519,97,1
405955,2696362,109,8,6949,0,7058,8,1
4417253,664098,1130,19,68389,0,69519,19,1
4010500,2204112,67,109,600,87,667,196,1
3361377,3228974,4841,2,761793,0,766634,2,1
3362545,2642580,297,141,947,0,1244,141,1
2981537,452920,1252,2,118718,0,119970,2,1
2950311,910252,807,85,85116,0,85923,85,1
2961801,802,1483,27,101962,0,103445,27,1
3280389,3370196,1101,1,411419,0,412520,1,1
2827436,3658536,882,1,271525,0,272407,1,1
2092359,4320128,421,19,26936,0,27357,19,1
4183784,1018146,931,100,59894,0,60825,100,1
1693361,115833,42,4,2151,0,2193,4,1
2260014,4380003,2466,11,98622,0,101088,11,1
1294660,3187537,48,51,600,161,648,212,1
2887240,4248388,1143,1,118405,0,119548,1,1
4807996,2816575,90,83,1796,0,1886,83,1
1821227,4694982,43,1,461,0,504,1,1
1503116,4816878,415,64,37079,0,37494,64,1
3509903,3390379,1530,1,509445,0,510975,1,1
3638272,3493950,2022,1,370904,0,372926,1,1
1331940,3911360,802,85,32617,0,33419,85,1
2314038,43111,456,15,16347,0,16803,15,1
1086912,3064294,907,281,33396,0,34303,281,1
6618,1619006,892,44,68849,0,69741,44,1
3943091,1977546,53,2,10283,0,10336,2,1
3361377,3443823,4841,1,761793,0,766634,1,1
2770509,3872420,798,442,316,79,1114,521,1
176882,1118217,3,3,35,0,38,3,1
3143946,3472449,172,16,936,0,1108,16,1
3509903,1113258,1530,5,509445,0,510975,5,1
258641,3160057,119,2358,1182,187,1301,2545,1
399115,2906786,4,4,41,0,45,4,1
1785514,1912031,37,226,329,2674,366,2900,1
1544048,3163239,206,15,4200,0,4406,15,1
2604284,3214016,90,149,510,0,600,149,1
3509903,3042560,1530,1,509445,0,510975,1,1
376404,1136219,193,48,1790,0,1983,48,1
4411870,3368996,948,15,60517,0,61465,15,1
3509903,2626720,1530,5,509445,0,510975,5,1
2441425,3751222,803,306,18561,0,19364,306,1
255306,714298,21,179,107,8,128,187,1
2482338,1757742,712,115,24222,0,24934,115,1
2068128,421664,76,9,2000,0,2076,9,1
1575009,4201505,429,8,37745,0,38174,8,1
1170369,179229,14,74,389,0,403,74,1
4519069,1259401,387,226,20799,0,21186,226,1
687144,1181395,679,239,859,0,1538,239,1
2212117,2664721,43,6,6252,0,6295,6,1
2872979,264421,341,20,28510,0,28851,20,1
4451491,2972260,817,58,8836,0,9653,58,1
3361377,3530403,4841,2,761793,0,766634,2,1
408965,1736130,903,62,38623,0,39526,62,1
3638272,1958401,2022,1,370904,0,372926,1,1
4492248,1979019,237,23,17127,0,17364,23,1
3969921,1660858,104,52,193,0,297,52,1
2522799,114921,253,129,3062,0,3315,129,1
1301815,2613404,752,17,48944,0,49696,17,1
1539837,3523221,1127,72,62979,0,64106,72,1
2069566,876466,29,99,266,0,295,99,1
1196844,2707856,548,238,36289,0,36837,238,1
445996,3567566,1175,55,12828,0,14003,55,1
792037,992971,57,1,16445,0,16502,1,1
1242199,3365773,207,71,6182,0,6389,71,1
1499792,1074043,15,17,59,0,74,17,1
1508894,2672837,73,120,2758,0,2831,120,1
1103332,3665163,732,39,59415,0,60147,39,1
2261139,1013840,2014,55,42851,0,44865,55,1
2981537,1845137,1252,3,118718,0,119970,3,1
4238001,703790,869,21,61161,0,62030,21,1
929513,1366269,145,190,4279,0,4424,190,1
2827436,1745469,882,1,271525,0,272407,1,1
4169303,4074987,93,5,1967,0,2060,5,1
3660943,3297789,12,24,555,0,567,24,1
978341,1748537,604,32,10065,0,10669,32,1
2405789,1916466,1010,18,93387,0,94397,18,1
1162927,1259390,14,1,695,0,709,1,1
2031305,4700711,396,71,23435,0,23831,71,1
2498087,3457394,1630,78,32582,0,34212,78,1
3509903,223428,1530,8,509445,0,510975,8,1
627727,2231608,56,5,2488,0,2544,5,1
2948092,1281226,412,9,18486,0,18898,9,1
22713,2497043,144,30,3915,0,4059,30,1
4088169,2388775,142,21,1347,0,1489,21,1
286966,4509709,309,122,676,0,985,122,1
4416945,221893,417,66,33228,0,33645,66,1
3881566,957075,781,3,14176,0,14957,3,1
3449530,346624,717,42,73648,0,74365,42,1
3280389,1031097,1101,1,411419,0,412520,1,1
4656285,1233813,1446,55,35428,0,36874,55,1
3509903,3551867,1530,28,509445,0,510975,28,1
3137585,2366377,1196,18,77354,0,78550,18,1
791133,1603899,485,497,3126,5551,3611,6048,1
3441731,1621200,57,30,818,0,875,30,1
3910135,4290417,298,17,14348,0,14646,17,1
3216427,1037916,262,1,6471,0,6733,1,1
2985909,3763272,706,2,43348,0,44054,2,1
755739,2859504,1117,96,58043,0,59160,96,1
4416945,3202505,417,75,33228,0,33645,75,1
282129,364552,146,82,2112,0,2258,82,1
3509214,509745,263,26,14139,0,14402,26,1
2260121,3561341,262,3,521,0,783,3,1
1119943,1871624,136,31,1365,0,1501,31,1
4184779,659865,240,36,427,0,667,36,1
2285283,1562038,279,2,6799,0,7078,2,1
60980,599403,649,14,20708,0,21357,14,1
3824547,131485,1075,123,14337,0,15412,123,1
4653941,110962,951,1,45883,0,46834,1,1
1242199,3669587,207,206,6182,0,6389,206,1
793511,3491096,447,15,3807,0,4254,15,1
3361377,3336346,4841,162,761793,0,766634,162,1
4209323,810296,1630,110,89460,0,91090,110,1
4656799,982782,187,152,2411,0,2598,152,1
3992144,3990825,402,1,23683,0,24085,1,1
745032,690098,510,261,3189,2591,3699,2852,1
3638272,299444,2022,2,370904,0,372926,2,1
3361377,3865229,4841,9,761793,0,766634,9,1
1887709,1235872,217,95,28983,0,29200,95,1
2516076,2901090,1455,6,77782,0,79237,6,1
3897381,4135304,222,33,1888,0,2110,33,1
3280389,3741635,1101,2,411419,0,412520,2,1
1557745,4848062,46,78,568,0,614,78,1
3721550,4682852,188,26,14527,0,14715,26,1
1042229,3502068,82,378,274,2133,356,2511,1
2343245,275649,19,4,230,0,249,4,1
2122741,2486005,190,22,6085,0,6275,22,1
4233503,1218268,224,30,7867,0,8091,30,1
3361377,3242684,4841,2,761793,0,766634,2,1
3379358,968538,44,1,3147,0,3191,1,1
663087,3837509,551,7,3410,0,3961,7,1
4365938,3574841,250,92,10362,0,10612,92,1
873006,3238294,375,17,33630,0,34005,17,1
427805,284662,483,2,156906,0,157389,2,1
792037,4136179,57,62,16445,0,16502,62,1
3038385,2481873,73,381,636,0,709,381,1
3594818,2806367,81,25,1945,354,2026,379,1
2961801,1097801,1483,9,101962,0,103445,9,1
4711909,4079592,440,74,2933,0,3373,74,1
711824,4442669,113,211,3107,0,3220,211,1
448517,3184685,625,39,12450,0,13075,39,1
3361377,83549,4841,3,761793,0,766634,3,1
4345608,568733,234,318,2526,0,2760,318,1
3067549,2477256,684,1124,1696,7025,2380,8149,1
1763353,4338436,126,1,10072,0,10198,1,1
1575009,3622120,429,746,37745,0,38174,746,1
79267,1977413,30,154,157,554,187,708,1
3765475,2143465,873,213,107914,0,108787,213,1
3361377,31168,4841,1,761793,0,766634,1,1
2707591,4763979,162,7,2360,0,2522,7,1
474172,2919890,471,32,38713,0,39184,32,1
2827436,1825339,882,1,271525,0,272407,1,1
4744009,737623,7,2,657,0,664,2,1
835556,1166041,295,10,1068,0,1363,10,1
1534362,3113954,1531,43,105859,0,107390,43,1
471706,2955205,794,1,65616,0,66410,1,1
4516604,1819595,314,6,13314,0,13628,6,1
3638272,3340381,2022,1,370904,0,372926,1,1
3765475,3463546,873,2,107914,0,108787,2,1
2853969,546123,1051,25,42591,0,43642,25,1
4649206,1322003,566,40,31367,0,31933,40,1
3884904,4011363,61,1,1946,0,2007,1,1
244444,2215793,39,47,1390,0,1429,47,1
3759853,2215364,451,6,16330,95,16781,101,1
4183784,1814450,931,29,59894,0,60825,29,1
1069020,4013269,85,132,1408,0,1493,132,1
3594609,4453696,48,1,2765,0,2813,1,1
3873768,1894810,449,20,35424,0,35873,20,1
3198742,50641,551,49,5252,0,5803,49,1
1478080,3021837,593,5,7009,0,7602,5,1
1580988,1790475,2821,2,400133,0,402954,2,1
2648270,3435385,43,108,198,0,241,108,1
2529661,1031385,493,36,27309,0,27802,36,1
3016810,778075,164,141,4329,0,4493,141,1
2887240,4015924,1143,4,118405,0,119548,4,1
3632293,1196617,570,76,21294,0,21864,76,1
1356925,2547589,248,28,6996,0,7244,28,1
2445500,2642030,68,3,3239,0,3307,3,1
2647342,4416295,68,3,1550,0,1618,3,1
1591435,199456,387,17,31245,0,31632,17,1
1651260,1712984,321,30,2355,0,2676,30,1
2498087,1490237,1630,54,32582,0,34212,54,1
2481372,3144316,49,1,2149,0,2198,1,1
842615,1585435,510,370,12316,0,12826,370,1
519175,3980822,173,2,7221,0,7394,2,1
978341,3516291,604,9,10065,0,10669,9,1
4304056,1920970,164,76,12698,0,12862,76,1
1533314,4099609,361,48,6007,0,6368,48,1
2260014,2143860,2466,8,98622,0,101088,8,1
4249983,4283906,679,336,16076,0,16755,336,1
3016810,1723932,164,28,4329,0,4493,28,1
1436216,352221,1068,1,68770,0,69838,1,1
3246688,575597,429,148,3462,0,3891,148,1
646587,375032,122,1,5819,0,5941,1,1
4423184,3310282,384,54,29809,0,30193,54,1
1621606,2274870,559,742,4228,0,4787,742,1
1633022,1250676,246,2,23530,0,23776,2,1
3561502,1792203,1144,87,68800,0,69944,87,1
4360960,257458,1642,1,110084,0,111726,1,1
1436174,3842925,105,3,9512,0,9617,3,1
1880135,1459621,810,24,71924,0,72734,24,1
3361377,2898680,4841,1,761793,0,766634,1,1
427805,2387478,483,1,156906,0,157389,1,1
2193513,658877,100,95,1276,0,1376,95,1
3501482,1179827,522,79,28046,0,28568,79,1
3824547,3238987,1075,1,14337,0,15412,1,1
2502456,354449,719,197,50725,0,51444,197,1
2326007,4321180,94,319,3295,0,3389,319,1
3379164,515537,74,74,889,1883,963,1957,1
3280389,2157280,1101,3,411419,0,412520,3,1
2035685,1349803,111,105,610,0,721,105,1
3509903,1985552,1530,2,509445,0,510975,2,1
2464401,590199,577,85,23681,0,24258,85,1
592541,1024173,132,2,6913,0,7045,2,1
3523978,1290231,142,127,955,0,1097,127,1
1580988,4275983,2821,1,400133,0,402954,1,1
2887240,1094324,1143,2,118405,0,119548,2,1
1847461,2782666,1211,68,51149,0,52360,68,1
1580988,1398404,2821,28,400133,0,402954,28,1
3638272,3847154,2022,1,370904,0,372926,1,1
3578463,4473252,240,109,4104,0,4344,109,1
3561502,3739452,1144,19,68800,0,69944,19,1
3509903,2832957,1530,16,509445,0,510975,16,1
2260014,3208169,2466,8,98622,0,101088,8,1
427805,4553759,483,3,156906,0,157389,3,1
593740,1744210,1107,220,62807,0,63914,220,1
3395938,2731942,546,60,39878,0,40424,60,1
2075015,3557729,2664,49,85781,0,88445,49,1
3438576,1497773,3424,2,137753,0,141177,2,1
513426,1443097,57,52,713,0,770,52,1
917130,219864,325,641,7017,0,7342,641,1
2405789,2768430,1010,141,93387,0,94397,141,1
1927211,1807717,1668,128,113322,0,114990,128,1
1135323,135953,169,24,12240,0,12409,24,1
1911252,3069251,22,5,208,0,230,5,1
3361377,2151015,4841,1,761793,0,766634,1,1
3316706,599250,42,3,207,0,249,3,1
2702681,587361,287,47,2373,0,2660,47,1
4692327,3510655,149,69,2092,0,2241,69,1
3361377,3450856,4841,39,761793,0,766634,39,1
2669924,3912118,226,8,1977,0,2203,8,1
3676295,2814882,374,1,70881,0,71255,1,1
2745433,2756126,36,24,1914,0,1950,24,1
1278809,680250,24,3,1825,0,1849,3,1
1966548,1047491,208,21,53149,0,53357,21,1
1923830,1811245,181,176,2733,0,2914,176,1
978797,3770972,599,2,12421,0,13020,2,1
4741813,1543023,140,18,3184,0,3324,18,1
3845119,4517919,461,54,28609,0,29070,54,1
2893353,4424293,204,13,1051,0,1255,13,1
1414603,4224526,40,38,745,0,785,38,1
3549674,4568188,602,36,38542,0,39144,36,1
948768,2903110,587,115,14768,0,15355,115,1
3235479,2012212,999,29,66486,0,67485,29,1
4272102,3468037,1608,75,104171,0,105779,75,1
3835618,4088731,694,1418,25433,1242,26127,2660,1
1250021,2521898,4637,10,85913,0,90550,10,1
4547438,1607984,1291,333,25237,0,26528,333,1
1659017,1351239,817,16,13055,0,13872,16,1
24546,148294,3,12,87,0,90,12,1
2128775,2039792,114,10,570,0,684,10,1
3361377,1238037,4841,1,761793,0,766634,1,1
1541866,923272,542,73,16481,0,17023,73,1
4191410,3223295,1590,30,96434,0,98024,30,1
3449530,1424105,717,32,73648,0,74365,32,1
2145181,3710659,114,3,1746,0,1860,3,1
1710856,306751,311,160,3120,0,3431,160,1
2344012,1655913,85,71,423,0,508,71,1
2702681,2363934,287,94,2373,774,2660,868,1
532681,2484131,433,96,35023,0,35456,96,1
3509903,536184,1530,1,509445,0,510975,1,1
1417425,863497,640,532,2016,0,2656,532,1
653164,3864379,106,6,1488,0,1594,6,1
4624595,1584086,722,66,53368,0,54090,66,1
1179906,3008227,316,19,14467,0,14783,19,1
4411870,3492386,948,87,60517,0,61465,87,1
354904,505442,3193,5,105780,0,108973,5,1
2147720,97640,1608,114,78786,807,80394,921,1
4738916,3380638,1165,2,34124,0,35289,2,1
781211,120417,976,105,51781,0,52757,105,1
153871,3562834,333,1,3892,0,4225,1,1
1580988,890133,2821,3,400133,0,402954,3,1
2261139,3658369,2014,241,42851,0,44865,241,1
805360,3622167,1514,38,119306,0,120820,38,1
3943091,488497,53,11,10283,0,10336,11,1
1494665,3564860,668,96,37638,0,38306,96,1
3316788,2051637,20,15,1710,0,1730,15,1
3907996,3422598,485,81,18964,0,19449,81,1
1988347,1427291,205,18,3660,0,3865,18,1
2005334,135742,116,5,1073,0,1189,5,1
2969730,608444,270,765,2509,0,2779,765,1
887534,2134186,207,66,2236,0,2443,66,1
3638272,1467213,2022,1,370904,0,372926,1,1
3906136,2788888,387,2,41169,0,41556,2,1
4479581,1093361,601,34,19545,0,20146,34,1
4751453,560647,520,115,27570,0,28090,115,1
3361377,1587101,4841,6,761793,0,766634,6,1
3638272,3141991,2022,2,370904,0,372926,2,1
4011264,3818486,1360,47,116777,0,118137,47,1
4451491,1337489,817,105,8836,0,9653,105,1
1384744,3746194,35,2,166,0,201,2,1
3361377,4865662,4841,1,761793,0,766634,1,1
1301815,3076753,752,25,48944,0,49696,25,1
3987684,3727225,286,11,17372,0,17658,11,1
1288771,281989,73,3,5367,0,5440,3,1
4302921,1333778,509,69,13289,0,13798,69,1
3463741,2586542,82,23,3948,0,4030,23,1
4009105,3118856,35,418,779,0,814,418,1
2516076,753683,1455,10,77782,0,79237,10,1
827277,3789351,24,6,268,0,292,6,1
2685897,3518888,38,90,4789,0,4827,90,1
4058889,3886729,118,68,1543,0,1661,68,1
1818152,1528542,20,76,1167,2395,1187,2471,1
3658026,1824651,223,35,1451,0,1674,35,1
2755798,4688423,494,24,24862,0,25356,24,1
858791,1987727,110,5,2663,0,2773,5,1
3509903,4405466,1530,2,509445,0,510975,2,1
15030,2211980,34,39,207,0,241,39,1
932720,897612,1411,55,111323,0,112734,55,1
3361377,1347446,4841,1,761793,0,766634,1,1
3294702,4327782,991,123,68888,0,69879,123,1
3271484,4369836,1507,3,34093,0,35600,3,1
4140279,1850093,337,1,49384,0,49721,1,1
2514271,4149111,387,41,19070,0,19457,41,1
765601,1878325,1485,99,101510,0,102995,99,1
2827436,2946724,882,2,271525,0,272407,2,1
3395938,3256529,546,3,39878,0,40424,3,1
3570041,303527,172,6,1455,0,1627,6,1
2342664,1103435,1181,30,26502,0,27683,30,1
1250021,3503400,4637,616,85913,166,90550,782,1
3676295,1532898,374,2,70881,0,71255,2,1
4360960,241584,1642,5,110084,0,111726,5,1
1609659,2900899,523,17,29763,0,30286,17,1
503632,1763872,50,406,431,86,481,492,1
4727207,4447173,925,1,84581,0,85506,1,1
3509903,933108,1530,2,509445,0,510975,2,1
2827436,4623722,882,1,271525,0,272407,1,1
2497238,4379869,251,59,2806,0,3057,59,1
1900620,1917362,59,16,1163,0,1222,16,1
805360,102825,1514,21,119306,0,120820,21,1
3167388,4778365,203,81,9760,0,9963,81,1
3914135,886655,2152,21,60084,0,62236,21,1
4275432,3290560,59,115,322,8,381,123,1
2405451,3606092,124,12,2161,0,2285,12,1
657387,2600118,47,39,2455,0,2502,39,1
805360,3946765,1514,18,119306,0,120820,18,1
2405451,2097685,124,933,2161,0,2285,933,1
3280389,4145759,1101,2,411419,0,412520,2,1
4922,326869,200,20,5946,0,6146,20,1
1678359,3057341,39,1,305,0,344,1,1
3995686,554319,113,38,6154,0,6267,38,1
439557,4306862,2090,14,61744,0,63834,14,1
1234540,3939428,1071,31,75251,0,76322,31,1
3457077,4580371,201,57,1913,0,2114,57,1
2405789,4453733,1010,58,93387,0,94397,58,1
4437944,2097685,262,933,3324,0,3586,933,1
2961801,3297579,1483,33,101962,0,103445,33,1
4635332,3548998,90,112,2326,339,2416,451,1
1591435,2606339,387,31,31245,0,31632,31,1
4011264,1705247,1360,60,116777,0,118137,60,1
3361377,1022868,4841,1,761793,0,766634,1,1
4360960,2855038,1642,5,110084,0,111726,5,1
2375878,754698,248,9,14925,0,15173,9,1
2774344,1082013,48,102,423,223,471,325,1
4106313,2753499,161,205,3004,293,3165,498,1
2147720,3718388,1608,148,78786,0,80394,148,1
1471685,2487248,1681,7,25550,0,27231,7,1
4096880,2110998,71,57,790,0,861,57,1
1870921,2861764,182,28,8739,0,8921,28,1
848776,3129465,29,1,685,0,714,1,1
4710933,2786314,126,58,1331,0,1457,58,1
3561502,4487514,1144,40,68800,0,69944,40,1
2894019,3346033,93,320,349,9541,442,9861,1
3509903,3742838,1530,1,509445,0,510975,1,1
1705425,3650593,248,2,6280,0,6528,2,1
285124,3789004,135,1156,4250,0,4385,1156,1
4771452,155019,411,12,8072,0,8483,12,1
4192206,1290457,468,9,18229,0,18697,9,1
1966548,3176380,208,2,53149,0,53357,2,1
474172,636281,471,20,38713,0,39184,20,1
2498087,1918070,1630,59,32582,0,34212,59,1
2962038,4253822,495,3,14236,0,14731,3,1
553041,3016181,455,32,5962,0,6417,32,1
3280389,446453,1101,2,411419,0,412520,2,1
3509903,1156543,1530,1,509445,0,510975,1,1
2781817,4346112,704,184,24613,0,25317,184,1
476426,2147274,72,98,1975,0,2047,98,1
3333,1120596,37,5,653,0,690,5,1
3844858,2218803,1591,314,28974,0,30565,314,1
226540,2940589,463,104,10650,0,11113,104,1
1839283,3709057,765,4,36658,0,37423,4,1
1063358,2930964,1350,22,63494,0,64844,22,1
3242275,4336477,551,108,17400,0,17951,108,1
3361380,3897174,342,53,2750,0,3092,53,1
2247463,2909366,388,121,2747,128,3135,249,1
1966548,182993,208,8,53149,0,53357,8,1
3668051,1658261,89,2,3044,0,3133,2,1
3280389,531159,1101,1,411419,0,412520,1,1
4058687,4235417,418,16,3486,0,3904,16,1
3940873,3349664,50,5,1162,0,1212,5,1
2793437,1458628,582,92,25447,720,26029,812,1
3320279,2856607,312,2,2691,0,3003,2,1
2853969,626251,1051,1,42591,0,43642,1,1
4708835,92759,190,2,7539,0,7729,2,1
4241523,3143149,71,39,1727,0,1798,39,1
4330391,4722523,773,38,32759,0,33532,38,1
3638272,4442075,2022,1,370904,0,372926,1,1
2403192,1812565,163,146,5302,0,5465,146,1
2147720,4520485,1608,30,78786,0,80394,30,1
873006,1728117,375,35,33630,0,34005,35,1
3294702,946225,991,77,68888,0,69879,77,1
3361377,2427552,4841,4,761793,0,766634,4,1
3280389,3689916,1101,5,411419,0,412520,5,1
427805,1479544,483,1,156906,0,157389,1,1
2092043,3642119,73,16,2886,0,2959,16,1
1161189,3824808,112,84,3964,0,4076,84,1
4547438,1118128,1291,329,25237,0,26528,329,1
874376,1414042,109,34,517,0,626,34,1
4319287,2073434,271,59,1522,513,1793,572,1
3187565,700271,97,72,4164,0,4261,72,1
2961801,4210499,1483,15,101962,0,103445,15,1
3280389,123082,1101,2,411419,0,412520,2,1
439557,924984,2090,31,61744,0,63834,31,1
3652028,1629019,179,351,2368,5823,2547,6174,1
3361377,2255041,4841,1,761793,0,766634,1,1
679540,4742991,396,183,8028,0,8424,183,1
4771452,1800020,411,391,8072,0,8483,391,1
4619326,4479268,539,5,22721,0,23260,5,1
3509903,4605351,1530,1,509445,0,510975,1,1
4392239,1098605,108,7,561,0,669,7,1
2650412,1357816,931,186,29038,0,29969,186,1
36972,452081,55,3,2372,0,2427,3,1
2961552,3764177,562,1036,16546,64563,17108,65599,1
3638272,4755946,2022,1,370904,0,372926,1,1
3590948,2047964,492,61,2943,0,3435,61,1
2961801,3961433,1483,334,101962,0,103445,334,1
363750,2150845,1001,31,10994,0,11995,31,1
1310800,4782690,200,99,6100,0,6300,99,1
1539837,3718020,1127,305,62979,6132,64106,6437,1
765601,3824782,1485,172,101510,0,102995,172,1
3280389,3745352,1101,2,411419,0,412520,2,1
3638272,1092409,2022,14,370904,0,372926,14,1
3438576,437439,3424,1,137753,0,141177,1,1
4183784,4089461,931,138,59894,0,60825,138,1
2459378,3957822,22,4,266,0,288,4,1
2490914,4621144,570,12,22965,0,23535,12,1
2950311,2248749,807,12,85116,0,85923,12,1
1847461,2053607,1211,2,51149,0,52360,2,1
1062967,3681359,260,38,15276,0,15536,38,1
218698,2669216,43,280,99,1050,142,1330,1
2212117,2102815,43,7,6252,0,6295,7,1
4561602,2037629,19,7,242,0,261,7,1
3872736,2585903,258,28,12660,0,12918,28,1
1291960,1143921,123,3,2351,0,2474,3,1
733639,2266365,259,12,3744,0,4003,12,1
2772256,2529265,82,81,4404,0,4486,81,1
4217182,4796863,55,77,202,0,257,77,1
4574571,2351395,186,151,6965,0,7151,151,1
3449530,3004393,717,66,73648,0,74365,66,1
4621719,1936306,306,2,4102,0,4408,2,1
2482338,2505904,712,37,24222,0,24934,37,1
4353839,404013,144,18,3320,0,3464,18,1
161276,4121347,146,19,6548,0,6694,19,1
4182887,2092194,3,14,84,0,87,14,1
1763353,54360,126,4,10072,0,10198,4,1
3074145,3065689,205,1,5623,0,5828,1,1
3449530,3952725,717,8,73648,0,74365,8,1
2472511,3746875,97,324,227,0,324,324,1
4183784,3496570,931,1,59894,0,60825,1,1
1204965,1223828,101,5,388,0,489,5,1
3712501,2540757,65,12,217,0,282,12,1
64357,4117306,309,40,6329,0,6638,40,1
2634068,1220731,101,104,952,0,1053,104,1
1615261,303693,955,54,12715,0,13670,54,1
3395853,2114256,252,123,3685,0,3937,123,1
2405789,3994045,1010,29,93387,0,94397,29,1
3844858,4070532,1591,72,28974,0,30565,72,1
3225310,2347024,320,185,10537,0,10857,185,1
1062967,2926105,260,619,15276,0,15536,619,1
1839283,3047588,765,11,36658,0,37423,11,1
3607310,1706071,318,68,3879,0,4197,68,1
1580988,3487347,2821,1,400133,0,402954,1,1
2751572,486441,481,90,44036,0,44517,90,1
1225988,447950,157,16,8881,0,9038,16,1
932720,1016054,1411,28,111323,0,112734,28,1
2431423,1331741,39,1,646,0,685,1,1
3509903,1451934,1530,1,509445,0,510975,1,1
1562656,1921868,126,688,630,0,756,688,1
3596662,2777433,10,3,133,0,143,3,1
4653941,4216244,951,10,45883,0,46834,10,1
2260014,3343222,2466,1,98622,0,101088,1,1
1601101,2908677,578,22,1448,0,2026,22,1
4295952,2446328,808,66,57369,0,58177,66,1
2296460,4753961,91,490,3634,0,3725,490,1
3987684,531237,286,27,17372,0,17658,27,1
1337919,1348993,250,19,10276,0,10526,19,1
3112136,3588494,406,12,41366,0,41772,12,1
4701737,2036955,98,4,4855,0,4953,4,1
765601,4024279,1485,17,101510,0,102995,17,1
3361377,3897464,4841,2,761793,0,766634,2,1
2887240,3823756,1143,1,118405,0,119548,1,1
471706,3199342,794,28,65616,0,66410,28,1
1609659,4336441,523,33,29763,0,30286,33,1
3509903,4695337,1530,3,509445,0,510975,3,1
4827056,2372668,226,170,12578,0,12804,170,1
3989108,1521082,372,766,7033,6562,7405,7328,1
354904,1982745,3193,43,105780,0,108973,43,1
4011264,1537637,1360,10,116777,0,118137,10,1
3742684,802835,299,42,2003,0,2302,42,1
447388,4520863,74,3432,490,908,564,4340,1
1709015,2535225,66,18,998,0,1064,18,1
3872736,4372403,258,33,12660,0,12918,33,1
2887240,883599,1143,3,118405,0,119548,3,1
298564,4668514,662,105,6261,0,6923,105,1
635909,1787075,179,894,6949,28305,7128,29199,1
4011264,4075712,1360,104,116777,0,118137,104,1
2981537,879532,1252,2,118718,0,119970,2,1
2672396,126031,5,108,187,0,192,108,1
414608,2646784,50,4,5531,0,5581,4,1
4750855,4471087,355,61,18880,0,19235,61,1
1831774,746594,228,17,1883,0,2111,17,1
3294702,549519,991,61,68888,0,69879,61,1
3120969,2540095,1,25,28,0,29,25,1
1580988,366300,2821,2,400133,0,402954,2,1
1293807,1728206,1837,1,30865,0,32702,1,1
1478234,2590844,13,47,167,0,180,47,1
4417253,4101678,1130,92,68389,0,69519,92,1
3280389,1710864,1101,1,411419,0,412520,1,1
4073917,2889619,24,52,1529,0,1553,52,1
896542,4092061,45,32,874,0,919,32,1
4158795,1881638,544,58,3195,0,3739,58,1
781211,374540,976,257,51781,0,52757,257,1
3671141,2068207,1444,185,48400,0,49844,185,1
1609659,3526402,523,120,29763,0,30286,120,1
1906425,1575124,273,85,2940,431,3213,516,1
2981537,3174645,1252,1,118718,0,119970,1,1
109809,300821,30,3,140,0,170,3,1
4077796,4751557,237,23,301,0,538,23,1
4057848,3721522,556,43,3400,0,3956,43,1
2616927,3808172,184,21,2688,0,2872,21,1
2920167,1814699,20,67,104,0,124,67,1
765601,2054265,1485,24,101510,0,102995,24,1
3070849,700643,83,127,2913,0,2996,127,1
4496752,3951393,554,87,16258,0,16812,87,1
3102873,3507311,341,15,15098,0,15439,15,1
681618,941843,75,301,8789,0,8864,301,1
1606469,4479581,96,601,5210,19545,5306,20146,1
1192480,1197651,397,7,20737,0,21134,7,1
4283503,2461634,125,55,4904,0,5029,55,1
3549674,3671350,602,125,38542,0,39144,125,1
3112136,3398634,406,14,41366,0,41772,14,1
3361377,3125539,4841,2,761793,0,766634,2,1
2827436,2877442,882,1,271525,0,272407,1,1
1311307,3913751,358,229,10864,5248,11222,5477,1
1054898,409660,33,54,1374,0,1407,54,1
941212,1578551,184,214,6404,0,6588,214,1
3361377,4701473,4841,1,761793,0,766634,1,1
2877907,2680141,508,30,16021,0,16529,30,1
3214323,2996370,147,72,12543,0,12690,72,1
3140664,2182964,268,214,16099,6975,16367,7189,1
2694929,3627230,186,1,4613,0,4799,1,1
3676295,2049620,374,1,70881,0,71255,1,1
1787075,510272,894,249,28305,0,29199,249,1
4789157,1626970,71,21,965,0,1036,21,1
1029999,1506495,47,1,609,0,656,1,1
4653941,3184980,951,3,45883,0,46834,3,1
2981537,888771,1252,2,118718,0,119970,2,1
2147720,4552182,1608,372,78786,1146,80394,1518,1
4257482,1740934,138,182,962,0,1100,182,1
4411870,655729,948,17,60517,0,61465,17,1
276502,2930214,30,1,2245,0,2275,1,1
4618481,3921990,64,552,2014,321,2078,873,1
1100354,1576866,163,4,24439,0,24602,4,1
2107861,2605009,535,7,25743,0,26278,7,1
4782707,1703197,513,6,31665,0,32178,6,1
2851109,1222392,450,3,98552,0,99002,3,1
3361377,4142370,4841,1,761793,0,766634,1,1
2092359,2461634,421,55,26936,0,27357,55,1
3509903,2194928,1530,1,509445,0,510975,1,1
4656285,2392650,1446,7,35428,0,36874,7,1
4209323,3362928,1630,22,89460,0,91090,22,1
307250,2953376,919,1,35588,0,36507,1,1
744113,1310200,60,8,366,0,426,8,1
1913445,1735056,564,58,47943,0,48507,58,1
1276253,4429275,407,1,46534,0,46941,1,1
2096270,3289195,970,341,26018,0,26988,341,1
866888,1217713,391,120,2049,0,2440,120,1
312306,3754992,25,246,113,127,138,373,1
4321468,4632384,383,56,1846,0,2229,56,1
2514271,3220167,387,3,19070,0,19457,3,1
905894,3217562,268,3,1162,0,1430,3,1
2981537,4809855,1252,4,118718,0,119970,4,1
1242199,3955879,207,106,6182,0,6389,106,1
408965,2342664,903,1181,38623,26502,39526,27683,1
3509903,94196,1530,3,509445,0,510975,3,1
4678614,3122708,452,172,16881,0,17333,172,1
3271484,2178911,1507,2,34093,0,35600,2,1
439557,933441,2090,1,61744,0,63834,1,1
3438576,725140,3424,17,137753,0,141177,17,1
932720,3454825,1411,49,111323,0,112734,49,1
961349,3460153,154,191,5849,0,6003,191,1
3641600,4751634,751,4,9269,0,10020,4,1
4238001,2922324,869,134,61161,0,62030,134,1
4440160,1929922,736,288,20522,0,21258,288,1
427805,3110037,483,3,156906,0,157389,3,1
4411870,2041729,948,91,60517,0,61465,91,1
1102748,134156,555,398,6504,0,7059,398,1
2572827,2839022,36,293,190,237,226,530,1
4238001,4450254,869,124,61161,0,62030,124,1
2785911,4149765,18,210,107,1961,125,2171,1
1591435,1967374,387,13,31245,0,31632,13,1
875909,1374934,118,286,3602,0,3720,286,1
474172,2901598,471,21,38713,0,39184,21,1
3017058,2562560,79,41,842,0,921,41,1
3019092,4101038,108,2,8595,0,8703,2,1
4013601,4650217,653,7,14886,0,15539,7,1
259575,2274870,260,742,13949,0,14209,742,1
2763282,2817951,321,1,10936,0,11257,1,1
896754,3508293,39,43,298,0,337,43,1
1276253,2961868,407,5,46534,0,46941,5,1
2260014,913363,2466,11,98622,0,101088,11,1
1534362,4307659,1531,38,105859,0,107390,38,1
3658026,2199454,223,1,1451,0,1674,1,1
3361377,4489666,4841,6,761793,0,766634,6,1
3115867,3590169,1350,74,61232,0,62582,74,1
4526614,4749438,162,39,750,166,912,205,1
3280389,2091057,1101,1,411419,0,412520,1,1
3910135,1858394,298,3,14348,0,14646,3,1
4208653,1408996,1820,38,21104,0,22924,38,1
4479158,2721855,185,284,1447,0,1632,284,1
474172,2245779,471,70,38713,0,39184,70,1
3137585,1738699,1196,53,77354,0,78550,53,1
873006,1237260,375,1,33630,0,34005,1,1
129556,89482,235,33,1685,0,1920,33,1
3672238,4753025,518,31,12172,0,12690,31,1
2782732,4259034,48,3,1004,0,1052,3,1
414608,4704642,50,2,5531,0,5581,2,1
873006,4030626,375,35,33630,0,34005,35,1
1119016,771447,252,409,1457,209,1709,618,1
1966548,3652638,208,50,53149,0,53357,50,1
679540,754981,396,50,8028,0,8424,50,1
2405789,4451001,1010,25,93387,0,94397,25,1
1534362,127054,1531,17,105859,0,107390,17,1
4463545,1843598,94,103,3842,0,3936,103,1
2237068,1633060,211,60,2206,0,2417,60,1
3734245,710755,915,1,34965,0,35880,1,1
2851109,482945,450,2,98552,0,99002,2,1
3509903,4341622,1530,1,509445,0,510975,1,1
681618,4196019,75,1,8789,0,8864,1,1
1339664,4606422,228,68,6682,0,6910,68,1
2441425,513404,803,212,18561,0,19364,212,1
2827436,305524,882,1,271525,0,272407,1,1
427805,2011363,483,1,156906,0,157389,1,1
3845148,4296640,44,14,3928,0,3972,14,1
3280389,2207479,1101,1,411419,0,412520,1,1
3683258,4547490,130,154,1772,0,1902,154,1
4653941,612206,951,1,45883,0,46834,1,1
4642569,4183006,872,76,27586,0,28458,76,1
4219659,1134025,28,26,463,0,491,26,1
571766,1018343,58,11,608,0,666,11,1
3280389,3499035,1101,1,411419,0,412520,1,1
3638272,3197387,2022,73,370904,0,372926,73,1
1913445,2871197,564,82,47943,0,48507,82,1
408965,511933,903,8,38623,0,39526,8,1
2147720,3471365,1608,151,78786,0,80394,151,1
681618,4052212,75,1,8789,0,8864,1,1
4004339,3492716,153,42,6086,0,6239,42,1
1927211,1588396,1668,195,113322,0,114990,195,1
3764177,3837017,1036,35,64563,0,65599,35,1
363750,2962397,1001,3,10994,0,11995,3,1
866357,3517208,825,327,18479,0,19304,327,1
3509903,3120894,1530,117,509445,0,510975,117,1
3836080,2749127,1197,223,59457,0,60654,223,1
1477543,2499233,84,829,1627,0,1711,829,1
2096270,1070366,970,59,26018,0,26988,59,1
3320279,2656910,312,66,2691,0,3003,66,1
544337,1566999,35,24,1987,0,2022,24,1
226540,1484267,463,39,10650,0,11113,39,1
805360,851670,1514,53,119306,0,120820,53,1
2981537,1840944,1252,17,118718,0,119970,17,1
3449530,1695529,717,20,73648,0,74365,20,1
3235479,35843,999,61,66486,0,67485,61,1
3361377,2816122,4841,1,761793,0,766634,1,1
4743951,4227410,19,22,317,0,336,22,1
4337603,3612165,333,37,9909,0,10242,37,1
1330101,3013285,193,161,1999,0,2192,161,1
4281128,732718,114,28,325,308,439,336,1
427805,1941179,483,80,156906,248,157389,328,1
3765475,3049720,873,158,107914,0,108787,158,1
2169041,4673114,16,601,342,22,358,623,1
1148261,1983273,140,111,1719,0,1859,111,1
3361377,3978038,4841,1,761793,0,766634,1,1
3039218,2511454,17,329,779,0,796,329,1
3509903,4063304,1530,6,509445,0,510975,6,1
4727207,2203816,925,5,84581,0,85506,5,1
1870921,2124754,182,1,8739,0,8921,1,1
1559783,3114859,204,55,1917,0,2121,55,1
1719848,3224874,252,228,3039,0,3291,228,1
4727207,2379000,925,4,84581,0,85506,4,1
3280389,3590410,1101,5,411419,0,412520,5,1
1975845,3618614,42,2,406,0,448,2,1
948375,4578473,113,1,4186,0,4299,1,1
607449,3359980,380,1,19369,0,19749,1,1
4751453,796278,520,17,27570,0,28090,17,1
4624595,1705624,722,55,53368,0,54090,55,1
4534401,3493170,103,125,4125,0,4228,125,1
3683235,769292,311,36,23110,0,23421,36,1
250177,2614252,330,28,3969,0,4299,28,1
3280389,1199977,1101,1,411419,0,412520,1,1
3514277,3113756,1338,184,13269,0,14607,184,1
3235479,3557707,999,22,66486,0,67485,22,1
3509903,253077,1530,1,509445,0,510975,1,1
3509903,1153442,1530,2,509445,0,510975,2,1
3210349,3217728,46,3,3372,0,3418,3,1
1875,1627492,656,18,61388,0,62044,18,1
4609928,3087946,56,45,169,0,225,45,1
4574571,4715972,186,247,6965,0,7151,247,1
141067,1154412,432,58,2002,793,2434,851,1
1276253,921478,407,1,46534,0,46941,1,1
2793437,4025755,582,1,25447,0,26029,1,1
687713,2046120,436,40,47160,0,47596,40,1
3396719,3093185,660,55,8141,0,8801,55,1
4654551,4489881,94,4,525,0,619,4,1
3167388,1379983,203,117,9760,0,9963,117,1
4176629,4239215,116,51,1535,0,1651,51,1
4411870,2446825,948,30,60517,0,61465,30,1
1875,2245031,656,22,61388,0,62044,22,1
2092359,157746,421,20,26936,0,27357,20,1
3214323,4312146,147,22,12543,0,12690,22,1
733639,2960080,259,12,3744,0,4003,12,1
4360960,2325617,1642,4,110084,0,111726,4,1
3509903,475239,1530,1,509445,0,510975,1,1
515290,962794,285,104,34080,0,34365,104,1
3361377,2030544,4841,1,761793,0,766634,1,1
595757,2714986,340,26,26738,0,27078,26,1
3845119,2794357,461,21,28609,0,29070,21,1
4239596,532760,51,368,95,509,146,877,1
1015986,953916,604,264,14201,0,14805,264,1
636814,4671332,116,24,9387,0,9503,24,1
1645177,697595,33,1,262,0,295,1,1
2981537,3749667,1252,6,118718,0,119970,6,1
3305062,1351196,36,31,191,0,227,31,1
2342664,2904830,1181,5,26502,0,27683,5,1
4642569,1709176,872,10,27586,0,28458,10,1
3280389,1592137,1101,115,411419,0,412520,115,1
1639434,1196844,587,548,8053,36289,8640,36837,1
1580988,4394130,2821,1,400133,0,402954,1,1
4198771,3162592,207,111,8543,0,8750,111,1
4370551,4785739,31,1,730,0,761,1,1
4519298,3562540,577,5,14443,0,15020,5,1
3845119,1235528,461,63,28609,0,29070,63,1
459115,4296870,75,20,757,0,832,20,1
641955,4532707,36,214,397,956,433,1170,1
2502456,3481718,719,53,50725,0,51444,53,1
4628096,3580574,219,4,5074,0,5293,4,1
2872979,3505000,341,172,28510,0,28851,172,1
3065808,266197,1235,23,82317,0,83552,23,1
2863066,1518169,56,2,1342,0,1398,2,1
2854744,5183,92,46,1158,0,1250,46,1
708086,1819077,47,131,261,0,308,131,1
1937293,1654099,434,1180,16761,26347,17195,27527,1
129556,1576177,235,362,1685,0,1920,362,1
932720,4790698,1411,31,111323,0,112734,31,1
3361377,195203,4841,1,761793,0,766634,1,1
4664320,3571164,109,223,1966,0,2075,223,1
1805743,4673501,316,207,3694,0,4010,207,1
1135323,2846458,169,477,12240,0,12409,477,1
1103332,1422570,732,60,59415,0,60147,60,1
3758692,3550289,711,55,34731,0,35442,55,1
4715501,4508636,176,287,1688,1174,1864,1461,1
3765475,2076628,873,1,107914,0,108787,1,1
3638272,2171527,2022,1,370904,0,372926,1,1
3853609,1580508,505,720,6896,19611,7401,20331,1
1580988,859890,2821,2,400133,0,402954,2,1
2733969,4657353,143,5,372,0,515,5,1
748019,3127107,675,2,18480,0,19155,2,1
4384375,1732308,129,97,4747,0,4876,97,1
2827436,4712996,882,4,271525,0,272407,4,1
3407150,138282,41,297,663,0,704,297,1
1190415,3856555,54,302,719,189,773,491,1
4011264,3555674,1360,57,116777,0,118137,57,1
1777298,2806862,468,319,6381,0,6849,319,1
3561502,3367707,1144,39,68800,0,69944,39,1
2950311,4757997,807,26,85116,0,85923,26,1
393185,4817736,591,75,7719,0,8310,75,1
3638272,21873,2022,2,370904,0,372926,2,1
1913445,3562269,564,71,47943,0,48507,71,1
1534362,956447,1531,38,105859,0,107390,38,1
4220190,4338741,320,284,15994,0,16314,284,1
816721,3259647,14,16,251,0,265,16,1
1330432,1183414,12,378,1926,0,1938,378,1
3563089,1551772,32,138,259,0,291,138,1
3280389,3336523,1101,2,411419,0,412520,2,1
765601,4858726,1485,126,101510,0,102995,126,1
3065808,4050671,1235,47,82317,0,83552,47,1
3361377,1243962,4841,1,761793,0,766634,1,1
1086912,2718291,907,14,33396,0,34303,14,1
1652056,356044,326,1,66845,0,67171,1,1
3559552,774336,145,12,2863,0,3008,12,1
2827436,1683263,882,2,271525,0,272407,2,1
2827436,3959538,882,4,271525,0,272407,4,1
2518926,4661167,9,150,305,0,314,150,1
1521855,3326467,228,118,7649,0,7877,118,1
3509903,739271,1530,2,509445,0,510975,2,1
3835618,1483514,694,600,25433,0,26127,600,1
1243032,2223172,60,211,160,623,220,834,1
805360,4720476,1514,11,119306,0,120820,11,1
571147,3104339,364,92,5484,0,5848,92,1
1642305,3613174,58,6,2080,0,2138,6,1
4805020,3710059,41,1,278,0,319,1,1
1761151,3133720,260,2,4153,0,4413,2,1
907654,1041827,798,212,24575,0,25373,212,1
1302093,775097,48,1,1219,0,1267,1,1
417416,217222,75,4,1695,0,1770,4,1
915390,800172,1345,3,5262,0,6607,3,1
3280389,3606231,1101,3,411419,0,412520,3,1
3395938,3331060,546,11,39878,0,40424,11,1
3873768,3709810,449,28,35424,0,35873,28,1
3316788,2628830,20,37,1710,0,1730,37,1
1124035,2727924,84,106,3736,0,3820,106,1
3137585,2605157,1196,3,77354,0,78550,3,1
2343253,189837,1882,107,86401,0,88283,107,1
427805,4550890,483,2,156906,0,157389,2,1
670989,1268496,22,28,393,0,415,28,1
320344,2012930,351,107,3831,378,4182,485,1
4653941,4220988,951,89,45883,0,46834,89,1
1544168,2870444,114,52,3348,0,3462,52,1
4417253,358389,1130,38,68389,0,69519,38,1
3943091,2286533,53,1,10283,0,10336,1,1
3074145,3935906,205,2,5623,0,5828,2,1
2195890,4539780,134,172,5208,0,5342,172,1
1927211,951898,1668,28,113322,0,114990,28,1
3721550,444361,188,64,14527,0,14715,64,1
2961801,637297,1483,26,101962,0,103445,26,1
805360,2224678,1514,93,119306,0,120820,93,1
887534,2151739,207,7,2236,0,2443,7,1
552610,1821035,69,1794,48,60,117,1854,1
2259151,100703,218,35,1957,0,2175,35,1
309729,2278411,24,4,361,0,385,4,1
3141618,3376873,176,153,590,0,766,153,1
4649206,2780163,566,105,31367,0,31933,105,1
4653941,420175,951,1,45883,0,46834,1,1
2360690,562972,43,5,2002,0,2045,5,1
1428477,1605977,255,5,15459,0,15714,5,1
755739,3148235,1117,24,58043,0,59160,24,1
354788,3905270,203,80,5964,0,6167,80,1
3065808,950740,1235,66,82317,0,83552,66,1
1580988,687935,2821,81,400133,0,402954,81,1
2769533,726221,88,44,1042,102,1130,146,1
408965,45729,903,4,38623,0,39526,4,1
408965,4060547,903,45,38623,0,39526,45,1
2101710,1956397,152,3,6934,0,7086,3,1
792037,961953,57,1,16445,0,16502,1,1
4361203,4687612,144,5,1840,0,1984,5,1
1805743,3640999,316,110,3694,0,4010,110,1
3993347,4033436,434,168,3778,0,4212,168,1
1497278,4405237,1869,181,35111,0,36980,181,1
3059060,2921791,78,453,855,0,933,453,1
2827436,2429188,882,2,271525,0,272407,2,1
4272102,4464291,1608,5,104171,0,105779,5,1
2961801,4235440,1483,1,101962,0,103445,1,1
2736770,3495008,55,1,1047,0,1102,1,1
3638272,1775617,2022,1,370904,0,372926,1,1
2859702,3779154,149,28,1471,0,1620,28,1
1534362,274675,1531,16,105859,0,107390,16,1
1138515,4376160,341,20,12443,0,12784,20,1
2751572,65618,481,81,44036,0,44517,81,1
2263130,4845950,712,3,14043,0,14755,3,1
507060,3993488,191,64,6141,0,6332,64,1
1250021,2770829,4637,32,85913,0,90550,32,1
1432079,4204066,118,78,2194,780,2312,858,1
2075015,766066,2664,15,85781,0,88445,15,1
3023692,3158596,133,110,258,279,391,389,1
2412707,2163627,21,173,318,0,339,173,1
4321468,3919583,383,64,1846,0,2229,64,1
1140134,4518711,311,2,11111,0,11422,2,1
3075692,2802492,327,215,1182,1064,1509,1279,1
2635438,3801632,92,118,184,0,276,118,1
3449530,821224,717,112,73648,0,74365,112,1
2985909,4174775,706,59,43348,0,44054,59,1
3549674,3751360,602,28,38542,0,39144,28,1
1249967,1628006,207,30,11933,0,12140,30,1
2827436,450640,882,1,271525,0,272407,1,1
3384159,1089684,415,154,6659,0,7074,154,1
2317782,1722724,788,106,2668,0,3456,106,1
457215,2517485,223,46,1057,215,1280,261,1
3638272,4139897,2022,1,370904,0,372926,1,1
530200,4375688,2035,1,62809,0,64844,1,1
2859844,2522395,43,39,1047,0,1090,39,1
1580988,939851,2821,21,400133,0,402954,21,1
725039,4097570,163,13,1138,0,1301,13,1
1537492,4004209,175,10,6621,0,6796,10,1
2096868,736867,80,79,128,73,208,152,1
3011019,1236029,142,18,564,0,706,18,1
3765475,2571508,873,1,107914,0,108787,1,1
2241519,4657888,23,1789,460,124,483,1913,1
3509903,1436812,1530,2,509445,0,510975,2,1
4417253,2555052,1130,70,68389,0,69519,70,1
2343253,4388825,1882,2,86401,0,88283,2,1
3384159,1764801,415,118,6659,0,7074,118,1
1063358,3624237,1350,54,63494,0,64844,54,1
3509422,2087748,255,48,1344,0,1599,48,1
3569179,34621,1064,4,40015,0,41079,4,1
1839283,3009972,765,34,36658,0,37423,34,1
2343253,514153,1882,3,86401,0,88283,3,1
1521567,3873303,80,7,1628,0,1708,7,1
324108,3563963,113,378,618,319,731,697,1
3361377,733286,4841,2,761793,0,766634,2,1
1503116,1670031,415,12,37079,0,37494,12,1
3509903,4464373,1530,1,509445,0,510975,1,1
4319972,985223,640,184,35279,0,35919,184,1
4789203,2374491,355,122,11315,0,11670,122,1
3361377,462569,4841,2,761793,0,766634,2,1
3509903,1502075,1530,1,509445,0,510975,1,1
3501482,919473,522,104,28046,0,28568,104,1
3058068,1739999,124,1,12734,0,12858,1,1
2827436,4390713,882,1,271525,0,272407,1,1
1870921,2456765,182,3,8739,0,8921,3,1
4653941,382439,951,188,45883,0,46834,188,1
3836080,4699522,1197,85,59457,0,60654,85,1
3229735,203962,283,134,1354,0,1637,134,1
2784961,4245752,221,192,3707,0,3928,192,1
1580988,275192,2821,2,400133,0,402954,2,1
4319972,668922,640,377,35279,0,35919,377,1
3438576,2616628,3424,55,137753,0,141177,55,1
4295952,1920970,808,76,57369,0,58177,76,1
4321286,2482538,32,2,208,0,240,2,1
1315946,1422112,105,77,285,0,390,77,1
2120733,3198554,819,137,20803,0,21622,137,1
4708541,3952414,981,199,15678,0,16659,199,1
4067716,3031171,622,47,4349,0,4971,47,1
3509903,4312526,1530,2,509445,0,510975,2,1
573101,509721,781,66,12750,0,13531,66,1
2307763,1748043,34,6,94,0,128,6,1
4708541,2380283,981,65,15678,0,16659,65,1
1580988,3407458,2821,4,400133,0,402954,4,1
3906136,4315451,387,49,41169,0,41556,49,1
1973082,69139,1036,6,18915,0,19951,6,1
3280389,656958,1101,5,411419,0,412520,5,1
1389617,3081120,482,28,2070,0,2552,28,1
2482338,1560907,712,29,24222,0,24934,29,1
2793423,4118726,122,5,1527,0,1649,5,1
1534362,2323537,1531,8,105859,0,107390,8,1
680015,341483,485,180,9502,0,9987,180,1
3438576,907659,3424,14,137753,0,141177,14,1
3676295,4436053,374,2,70881,0,71255,2,1
2075015,3291942,2664,35,85781,0,88445,35,1
2041134,2101215,477,128,4284,1547,4761,1675,1
3509903,1524933,1530,2,509445,0,510975,2,1
2169693,2905904,194,115,7674,0,7868,115,1
1615261,1556337,955,1177,12715,585,13670,1762,1
2698749,193267,108,52,2511,0,2619,52,1
3867232,3682713,71,7,1994,0,2065,7,1
4461896,611749,120,30,1345,0,1465,30,1
4625755,30524,130,72,1609,0,1739,72,1
4330391,1443095,773,7,32759,0,33532,7,1
153871,3811591,333,20,3892,0,4225,20,1
1031334,421849,459,32,16840,0,17299,32,1
932720,197758,1411,39,111323,0,112734,39,1
3638272,3969110,2022,1,370904,0,372926,1,1
3462300,241729,342,104,2917,0,3259,104,1
3361377,3617156,4841,1,761793,0,766634,1,1
1550740,3038921,302,240,668,1721,970,1961,1
427805,3145336,483,1,156906,0,157389,1,1
2985909,1365891,706,76,43348,0,44054,76,1
1539837,2984432,1127,83,62979,0,64106,83,1
1549334,2910893,81,35,6693,0,6774,35,1
2375878,4093911,248,126,14925,0,15173,126,1
4254737,3849783,574,112,1945,0,2519,112,1
1575009,1170316,429,74,37745,0,38174,74,1
4853234,815375,1256,80,29554,0,30810,80,1
4479581,3504394,601,112,19545,0,20146,112,1
4582129,1604203,1231,10,10356,0,11587,10,1
4191410,4471174,1590,36,96434,0,98024,36,1
3055481,2279539,135,52,1883,0,2018,52,1
2027108,3356208,1172,11,5587,121,6759,132,1
1843507,848940,537,6,11729,0,12266,6,1
2191846,2688223,51,14,1499,0,1550,14,1
3509903,4513160,1530,58,509445,0,510975,58,1
4455047,3237219,83,1,1453,0,1536,1,1
2436304,886937,559,218,1979,923,2538,1141,1
3509903,1239843,1530,5,509445,0,510975,5,1
1094821,2335313,223,35,2745,0,2968,35,1
3469653,3763868,32,4,2818,0,2850,4,1
4011264,404533,1360,63,116777,0,118137,63,1
104540,3682339,149,36,2917,0,3066,36,1
2877907,280294,508,28,16021,0,16529,28,1
4842461,2329928,450,30,3728,0,4178,30,1
3454888,2609702,162,21,7886,0,8048,21,1
427805,2310534,483,4,156906,0,157389,4,1
1580988,3173146,2821,137,400133,0,402954,137,1
3509903,606186,1530,1,509445,0,510975,1,1
3501482,1826717,522,20,28046,0,28568,20,1
4418909,2235811,266,34,2172,0,2438,34,1
273363,3157207,768,95,11045,0,11813,95,1
4408813,1515706,288,4,10077,0,10365,4,1
2950311,4647619,807,47,85116,0,85923,47,1
687713,1659795,436,25,47160,0,47596,25,1
3264096,2341921,331,40,697,0,1028,40,1
3638272,4142224,2022,2,370904,0,372926,2,1
3935366,215469,377,218,3803,0,4180,218,1
307250,2198967,919,4,35588,0,36507,4,1
3671141,4302309,1444,24,48400,0,49844,24,1
3038921,2464456,240,5,1721,0,1961,5,1
1580988,3849759,2821,1,400133,0,402954,1,1
1763353,2078308,126,4,10072,0,10198,4,1
544230,3461726,1532,322,60768,0,62300,322,1
1520840,4281988,155,18,2950,0,3105,18,1
253352,536945,237,153,10413,0,10650,153,1
2727581,2720097,757,31,7394,0,8151,31,1
4224492,750653,123,269,1308,0,1431,269,1
393185,975713,591,12,7719,0,8310,12,1
3065808,4117643,1235,101,82317,0,83552,101,1
3257465,4731531,541,388,27614,0,28155,388,1
3992144,776030,402,1,23683,0,24085,1,1
3633019,2117296,746,68,32317,0,33063,68,1
3280389,4485346,1101,2,411419,0,412520,2,1
3671141,626128,1444,8,48400,87,49844,95,1
4678416,593740,31,1107,1988,62807,2019,63914,1
1331940,1218169,802,66,32617,0,33419,66,1
276216,2165537,312,108,12600,0,12912,108,1
3065808,731553,1235,155,82317,0,83552,155,1
2031305,3726583,396,79,23435,0,23831,79,1
588533,345828,84,5,2858,0,2942,5,1
1580988,1181062,2821,36,400133,0,402954,36,1
268540,3865690,104,65,825,0,929,65,1
18762,2703050,82,555,1159,266,1241,821,1
4233503,1429172,224,37,7867,0,8091,37,1
371654,858343,25,1103,16,1075,41,2178,1
4547438,2575138,1291,59,25237,0,26528,59,1
2394976,291869,335,89,10973,0,11308,89,1
1403753,3924715,31,396,132,297,163,693,1
3907996,3047849,485,89,18964,0,19449,89,1
3509903,512321,1530,1,509445,0,510975,1,1
4411870,1318149,948,551,60517,0,61465,551,1
3302638,3131103,148,23,512,0,660,23,1
4123892,1979701,45,1,383,0,428,1,1
3280389,2543268,1101,1,411419,0,412520,1,1
3632293,3752912,570,177,21294,0,21864,177,1
3137585,1549239,1196,66,77354,0,78550,66,1
3291396,1549317,195,303,11502,0,11697,303,1
3280389,3955143,1101,5,411419,0,412520,5,1
3708550,2095418,139,320,1251,0,1390,320,1
1723506,1014232,733,34,21835,0,22568,34,1
4642549,1150104,146,293,794,0,940,293,1
544230,2392955,1532,38,60768,0,62300,38,1
2961801,100414,1483,40,101962,0,103445,40,1
1880135,1407059,810,28,71924,0,72734,28,1
544230,2517882,1532,4,60768,0,62300,4,1
3438576,2607939,3424,14,137753,0,141177,14,1
3271484,505862,1507,1,34093,0,35600,1,1
4710933,3742930,126,410,1331,22242,1457,22652,1
4272102,1883270,1608,65,104171,0,105779,65,1
1735116,3342286,503,27,16146,0,16649,27,1
3280389,1922005,1101,1,411419,0,412520,1,1
428631,2365590,8,14,91,43,99,57,1
3638272,4568042,2022,1,370904,0,372926,1,1
3116723,2364483,194,6,4798,0,4992,6,1
3578463,889632,240,14,4104,0,4344,14,1
873241,4591002,616,72,22633,0,23249,72,1
3361377,1073993,4841,1,761793,0,766634,1,1
3616842,763416,317,310,3201,0,3518,310,1
2494800,1453862,752,112,5329,498,6081,610,1
3065808,382391,1235,60,82317,0,83552,60,1
2527654,4414451,39,3,1740,0,1779,3,1
427805,1500139,483,1,156906,0,157389,1,1
2197837,3126823,97,635,1984,0,2081,635,1
1540080,3307956,255,12,3594,0,3849,12,1
439557,2042964,2090,58,61744,0,63834,58,1
4283503,3632787,125,112,4904,1380,5029,1492,1
1880135,273080,810,46,71924,0,72734,46,1
1539837,4122364,1127,4,62979,0,64106,4,1
4853234,30601,1256,1,29554,0,30810,1,1
3137585,1908341,1196,25,77354,0,78550,25,1
3127090,1215741,678,3,10017,0,10695,3,1
4360960,253415,1642,25,110084,0,111726,25,1
31819,262790,75,35,3334,0,3409,35,1
2052930,638958,407,3,8479,0,8886,3,1
1723506,353526,733,45,21835,0,22568,45,1
2961801,4832799,1483,105,101962,0,103445,105,1
2887240,3587392,1143,1,118405,0,119548,1,1
1977657,564771,141,34,1990,0,2131,34,1
1178312,432280,1213,540,2028,653,3241,1193,1
4782707,894024,513,10,31665,0,32178,10,1
3361377,3831839,4841,75,761793,0,766634,75,1
1879936,2009949,281,77,6786,0,7067,77,1
3006008,2421143,51,10,431,0,482,10,1
3569179,3054395,1064,5,40015,0,41079,5,1
2685897,4447816,38,102,4789,0,4827,102,1
4656285,3558903,1446,15,35428,0,36874,15,1
4500329,4811066,10,75,100,55,110,130,1
1164238,3178593,179,252,2363,0,2542,252,1
2877907,4533410,508,13,16021,0,16529,13,1
1466231,3799791,408,61,3853,0,4261,61,1
3816073,136101,60,134,456,257,516,391,1
196521,3864766,1176,11,11269,0,12445,11,1
4023687,133438,69,3,7295,0,7364,3,1
4195951,405,55,3,3156,0,3211,3,1
4272102,3362462,1608,70,104171,0,105779,70,1
2981537,2878151,1252,2,118718,0,119970,2,1
1063358,644095,1350,15,63494,0,64844,15,1
1236075,3023249,344,1041,2346,0,2690,1041,1
2981537,3589477,1252,1,118718,0,119970,1,1
3638272,3976242,2022,4,370904,0,372926,4,1
757158,4071194,85,285,929,0,1014,285,1
3509903,851054,1530,2,509445,0,510975,2,1
3361377,523922,4841,1,761793,0,766634,1,1
4586549,1107028,68,36,497,0,565,36,1
3941858,2515620,202,3,5760,0,5962,3,1
792037,3799667,57,1,16445,0,16502,1,1
1937293,2470519,434,3,16761,0,17195,3,1
3280389,2246325,1101,1,411419,0,412520,1,1
2342664,2745833,1181,76,26502,0,27683,76,1
544230,682905,1532,90,60768,0,62300,90,1
3941858,2066190,202,37,5760,0,5962,37,1
805360,2528431,1514,71,119306,0,120820,71,1
435003,98067,92,597,1730,0,1822,597,1
1276253,772410,407,1,46534,0,46941,1,1
3509903,1050353,1530,2,509445,0,510975,2,1
3783912,3952082,53,19,392,0,445,19,1
3361377,4729837,4841,1,761793,0,766634,1,1
4360960,4234688,1642,32,110084,0,111726,32,1
3914135,2806447,2152,27,60084,0,62236,27,1
60980,3888199,649,6,20708,0,21357,6,1
3914135,2188741,2152,21,60084,0,62236,21,1
2887240,3648009,1143,9,118405,0,119548,9,1
4191410,894086,1590,30,96434,0,98024,30,1
2343253,3781323,1882,2,86401,0,88283,2,1
2947429,3509463,19,1,892,0,911,1,1
4113414,3995038,403,73,3521,0,3924,73,1
1192480,2911826,397,1,20737,0,21134,1,1
1984622,632997,145,2,20659,0,20804,2,1
3509903,1912300,1530,1,509445,0,510975,1,1
593740,1131368,1107,40,62807,0,63914,40,1
1533314,3237572,361,209,6007,0,6368,209,1
3509903,2427382,1530,1,509445,0,510975,1,1
2285106,2380347,21,40,176,0,197,40,1
2827436,4413097,882,3,271525,0,272407,3,1
3633019,3755898,746,36,32317,0,33063,36,1
2457029,3657487,77,40,10427,0,10504,40,1
3638272,4746799,2022,1,370904,0,372926,1,1
1276253,2225212,407,10,46534,0,46941,10,1
522588,314065,496,30,20091,0,20587,30,1
907654,1143375,798,44,24575,0,25373,44,1
2107861,2785563,535,1,25743,0,26278,1,1
4850321,3429945,113,17,988,0,1101,17,1
1973082,4022252,1036,76,18915,0,19951,76,1
1654099,3063631,1180,26,26347,0,27527,26,1
957197,2841746,614,3,37109,0,37723,3,1
871388,2708398,144,430,1422,0,1566,430,1
2088912,4651606,64,73,1178,0,1242,73,1
1103332,3212031,732,54,59415,0,60147,54,1
4385783,1982268,290,195,10995,0,11285,195,1
256934,779224,287,52,11635,0,11922,52,1
427805,968471,483,3,156906,0,157389,3,1
1741661,2669207,31,46,226,0,257,46,1
3361377,1500921,4841,2,761793,0,766634,2,1
3873768,3784684,449,86,35424,0,35873,86,1
4746749,3523016,283,16,3968,0,4251,16,1
1497278,3187472,1869,11,35111,0,36980,11,1
2267633,2907692,422,132,13247,0,13669,132,1
2326007,1131674,94,6,3295,0,3389,6,1
519175,963684,173,167,7221,0,7394,167,1
2343253,101135,1882,3,86401,0,88283,3,1
2827436,1756143,882,1,271525,0,272407,1,1
4727207,3462093,925,18,84581,0,85506,18,1
4302921,1808817,509,29,13289,0,13798,29,1
3764177,4424186,1036,73,64563,0,65599,73,1
2277070,428321,751,7,4932,0,5683,7,1
2981537,2081870,1252,31,118718,0,119970,31,1
544230,3594720,1532,12,60768,0,62300,12,1
1234540,3454046,1071,30,75251,0,76322,30,1
1503116,3749654,415,84,37079,0,37494,84,1
3115867,1913282,1350,1,61232,0,62582,1,1
4140279,2215833,337,1,49384,0,49721,1,1
1927211,3090837,1668,66,113322,0,114990,66,1
1814709,3600982,316,61,5746,0,6062,61,1
1331940,3778992,802,40,32617,0,33419,40,1
4782707,1918947,513,48,31665,0,32178,48,1
3836080,2637062,1197,194,59457,0,60654,194,1
3764177,27599,1036,4,64563,0,65599,4,1
2260014,432574,2466,7,98622,0,101088,7,1
2687552,2121755,238,78,25574,0,25812,78,1
458096,1941093,239,168,1048,729,1287,897,1
4209323,587942,1630,31,89460,0,91090,31,1
3361377,3187485,4841,1,761793,0,766634,1,1
4788253,4544411,364,57,3550,0,3914,57,1
1927211,2169943,1668,39,113322,0,114990,39,1
4467395,2290451,2084,84,14574,493,16658,577,1
3638272,3798894,2022,2,370904,0,372926,2,1
483251,3907529,154,2,5257,0,5411,2,1
3549674,193108,602,34,38542,0,39144,34,1
3361377,2410471,4841,2,761793,0,766634,2,1
3509903,3599754,1530,1,509445,0,510975,1,1
471706,4658637,794,2,65616,0,66410,2,1
4721617,2845304,307,155,12885,0,13192,155,1
515290,1457370,285,27,34080,0,34365,27,1
3230621,1632616,355,218,1149,1963,1504,2181,1
3509903,559056,1530,4,509445,0,510975,4,1
1056518,829576,659,56,3945,0,4604,56,1
2261139,740630,2014,35,42851,0,44865,35,1
2851109,3409122,450,1,98552,0,99002,1,1
1063358,377091,1350,4,63494,0,64844,4,1
3981429,2926976,208,86,1911,0,2119,86,1
2772113,3743032,792,20,42907,0,43699,20,1
3638272,1457073,2022,55,370904,0,372926,55,1
2981537,4594019,1252,1,118718,0,119970,1,1
1462439,838588,777,15,5849,0,6626,15,1
2032442,4039578,109,14,10458,0,10567,14,1
3361377,755760,4841,2,761793,0,766634,2,1
2307868,2770026,1131,8,38777,0,39908,8,1
354904,3332920,3193,3,105780,0,108973,3,1
1031334,2820227,459,105,16840,0,17299,105,1
427805,2553311,483,1,156906,0,157389,1,1
2885394,2167886,174,98,3481,0,3655,98,1
4494033,2442457,98,343,852,0,950,343,1
4653271,1626288,43,61,591,0,634,61,1
3911176,4561972,13,237,665,0,678,237,1
4004184,4684198,202,22,266,0,468,22,1
4338728,678341,18,10,182,0,200,10,1
3943091,4813821,53,1,10283,0,10336,1,1
4641044,275127,300,2,1842,0,2142,2,1
354904,4471290,3193,9,105780,0,108973,9,1
2629743,3101239,169,125,527,1614,696,1739,1
1519747,218698,94,43,364,99,458,142,1
2502456,178430,719,1,50725,0,51444,1,1
3175944,1524867,324,10,7415,0,7739,10,1
2058931,3520813,6,1,220,0,226,1,1
4238001,2988763,869,132,61161,0,62030,132,1
902876,3756997,63,211,243,0,306,211,1
3120890,1733655,141,64,1294,0,1435,64,1
431086,3202886,619,3,14910,0,15529,3,1
1878924,959338,85,7,2012,0,2097,7,1
1533546,4549396,703,30,22095,0,22798,30,1
2631746,182852,80,12,420,23,500,35,1
2261139,4304583,2014,1,42851,0,44865,1,1
3764177,3339556,1036,638,64563,0,65599,638,1
3115867,3446585,1350,10,61232,0,62582,10,1
1939936,1274978,26,91,130,0,156,91,1
2314575,2579149,444,87,1353,610,1797,697,1
3387987,1050520,268,33,19035,0,19303,33,1
2516076,893768,1455,13,77782,0,79237,13,1
805360,3820506,1514,31,119306,0,120820,31,1
4509843,1322804,132,1,3138,0,3270,1,1
1125432,4058334,298,59,2434,0,2732,59,1
595757,2987062,340,257,26738,0,27078,257,1
2428341,4380630,826,92,10151,0,10977,92,1
2169693,713354,194,45,7674,0,7868,45,1
4678614,2289338,452,115,16881,0,17333,115,1
2960143,2450783,8,3,192,0,200,3,1
427805,1503695,483,1,156906,0,157389,1,1
1431048,3781976,88,1,396,0,484,1,1
1139873,1960618,670,135,10236,0,10906,135,1
2502456,509911,719,51,50725,0,51444,51,1
3361377,4414278,4841,1,761793,0,766634,1,1
892512,3298654,1505,3,11757,0,13262,3,1
530200,3051828,2035,7,62809,0,64844,7,1
2260014,3003182,2466,2,98622,0,101088,2,1
3235479,4092674,999,26,66486,0,67485,26,1
4219479,1291255,158,79,4945,0,5103,79,1
1880135,1476324,810,46,71924,0,72734,46,1
3509903,3838490,1530,2,509445,0,510975,2,1
1537492,4154464,175,2,6621,0,6796,2,1
1212419,3132939,52,1196,695,481,747,1677,1
593740,4429800,1107,50,62807,0,63914,50,1
2147720,2079597,1608,19,78786,0,80394,19,1
4208653,1444979,1820,68,21104,0,22924,68,1
30224,687900,120,131,4175,0,4295,131,1
2751572,3042223,481,41,44036,0,44517,41,1
4492248,1174043,237,96,17127,0,17364,96,1
3509903,3415865,1530,2,509445,0,510975,2,1
755739,46,1117,304,58043,0,59160,304,1
1466684,4755188,13,75,112,1893,125,1968,1
427805,2878685,483,1,156906,0,157389,1,1
4642569,1365011,872,33,27586,0,28458,33,1
961349,1999945,154,89,5849,0,6003,89,1
427805,3605222,483,1,156906,0,157389,1,1
1601507,3978844,129,3,6006,0,6135,3,1
3632293,1978298,570,33,21294,0,21864,33,1
4657972,1294554,213,5,798,0,1011,5,1
2624450,4581495,97,922,836,0,933,922,1
4547438,3140345,1291,39,25237,0,26528,39,1
4360799,754981,910,50,10476,0,11386,50,1
2940588,2813941,554,405,9477,0,10031,405,1
3687184,4365109,8,103,170,0,178,103,1
4249273,1728720,225,25,3063,0,3288,25,1
1787075,1978125,894,64,28305,0,29199,64,1
2513691,2105014,244,26,17485,0,17729,26,1
4528103,1330371,268,190,14258,0,14526,190,1
3676295,3752521,374,1,70881,0,71255,1,1
1927211,2806548,1668,72,113322,0,114990,72,1
2655966,3972395,81,88,2804,0,2885,88,1
3721550,2797356,188,43,14527,0,14715,43,1
4479581,2782120,601,15,19545,0,20146,15,1
2755798,3830356,494,20,24862,0,25356,20,1
1875,557794,656,48,61388,0,62044,48,1
3361377,3170417,4841,1,761793,0,766634,1,1
3257465,1723473,541,32,27614,0,28155,32,1
2307868,3027186,1131,1,38777,0,39908,1,1
361783,3132680,54,84,516,91,570,175,1
3079649,3262407,549,66,2116,0,2665,66,1
276216,1517588,312,180,12600,0,12912,180,1
3112136,19422,406,105,41366,0,41772,105,1
1613202,423460,566,47,8639,0,9205,47,1
333887,1058176,15,1,3610,0,3625,1,1
1471685,3609279,1681,22,25550,0,27231,22,1
4183784,1810898,931,4,59894,0,60825,4,1
3280389,2812217,1101,24,411419,0,412520,24,1
2133068,3864365,47,49,514,0,561,49,1
4642913,3048649,182,26,1183,0,1365,26,1
3065808,4567106,1235,102,82317,0,83552,102,1
3280389,2796847,1101,1,411419,0,412520,1,1
4087774,4483330,578,155,10107,0,10685,155,1
4552182,4503264,372,4,1146,0,1518,4,1
1927211,3949473,1668,64,113322,0,114990,64,1
1913445,4449532,564,26,47943,0,48507,26,1
4777191,2685158,86,6,3938,0,4024,6,1
3872736,4739905,258,241,12660,0,12918,241,1
1741347,3256180,106,44,1850,173,1956,217,1
3361377,1833757,4841,10,761793,0,766634,10,1
2516076,4045807,1455,84,77782,0,79237,84,1
2198488,4077963,37,15,2593,0,2630,15,1
1120955,1886211,13,1,989,0,1002,1,1
1999174,4862900,493,147,2435,0,2928,147,1
1274046,1012912,613,311,2455,0,3068,311,1
2951816,892512,211,1505,287,11757,498,13262,1
4360960,243626,1642,3,110084,0,111726,3,1
2971288,3907944,16,25,455,0,471,25,1
2985909,3124556,706,108,43348,0,44054,108,1
2994739,612025,15,203,121,3465,136,3668,1
2498087,2307130,1630,136,32582,0,34212,136,1
2793437,3400978,582,15,25447,0,26029,15,1
2120140,4825311,453,37,6305,0,6758,37,1
1516853,130039,426,4,10168,0,10594,4,1
2314038,1302592,456,38,16347,0,16803,38,1
2516076,4388881,1455,32,77782,0,79237,32,1
3702662,218222,1,38,3,34,4,72,1
567662,566708,172,31,1626,0,1798,31,1
1221958,763982,51,16,1736,0,1787,16,1
2960291,3258782,66,24,1664,0,1730,24,1
1539837,2455038,1127,63,62979,0,64106,63,1
4678614,4366656,452,174,16881,0,17333,174,1
3140664,3152713,268,30,16099,0,16367,30,1
753076,3876737,100,2951,305,1921,405,4872,1
4220190,1432027,320,120,15994,0,16314,120,1
2326007,1159243,94,1,3295,0,3389,1,1
846208,1176609,600,514,17288,0,17888,514,1
2041371,4228143,211,713,2804,0,3015,713,1
572390,3716086,91,11,3173,0,3264,11,1
2887240,2946681,1143,3,118405,0,119548,3,1
4416945,1989917,417,37,33228,0,33645,37,1
4233503,3440799,224,127,7867,0,8091,127,1
2457029,3576455,77,11,10427,0,10504,11,1
2108878,2064527,78,24,4399,0,4477,24,1
3742930,2755106,410,1,22242,0,22652,1,1
593740,1332079,1107,2,62807,0,63914,2,1
3454888,2586794,162,9,7886,0,8048,9,1
4649206,4712237,566,47,31367,0,31933,47,1
2464401,2140745,577,156,23681,0,24258,156,1
2827436,2567830,882,13,271525,0,272407,13,1
3651179,1867607,1752,17,2979,0,4731,17,1
1927780,2077497,420,60,6230,0,6650,60,1
748019,1060907,675,7,18480,0,19155,7,1
1928928,409634,169,9,5084,0,5253,9,1
2985909,965597,706,48,43348,0,44054,48,1
1880135,4520375,810,37,71924,0,72734,37,1
2957859,2274870,190,742,4518,0,4708,742,1
386424,1557641,131,55,7871,0,8002,55,1
211450,521632,9,79,227,0,236,79,1
3509903,1875996,1530,1,509445,0,510975,1,1
2436781,2381935,689,14,9972,0,10661,14,1
3116723,2014006,194,690,4798,0,4992,690,1
195401,4499653,65,224,286,289,351,513,1
1966548,3535197,208,2,53149,0,53357,2,1
2781817,4767957,704,94,24613,0,25317,94,1
1471685,1959917,1681,11,25550,0,27231,11,1
4183784,2800126,931,41,59894,0,60825,41,1
4087774,250177,578,330,10107,3969,10685,4299,1
3676295,3628857,374,1,70881,0,71255,1,1
3836080,2754375,1197,53,59457,0,60654,53,1
3065808,4125252,1235,42,82317,0,83552,42,1
3873768,980902,449,50,35424,0,35873,50,1
3449530,2280112,717,9,73648,0,74365,9,1
3431613,3669471,234,222,1959,0,2193,222,1
2961801,1855226,1483,66,101962,0,103445,66,1
1588330,4279396,694,9,10280,0,10974,9,1
1880135,2093289,810,24,71924,0,72734,24,1
4534401,273812,103,79,4125,0,4228,79,1
1285213,1137419,21,69,300,310,321,379,1
1250021,2174627,4637,4,85913,0,90550,4,1
3361377,393137,4841,1,761793,0,766634,1,1
3914135,2734190,2152,64,60084,0,62236,64,1
3070589,3250452,280,5,4483,0,4763,5,1
4754959,2045452,159,14,183,0,342,14,1
427805,2139326,483,1,156906,0,157389,1,1
1301815,1575618,752,81,48944,0,49696,81,1
3016810,597757,164,78,4329,0,4493,78,1
4653941,791590,951,4,45883,0,46834,4,1
3873768,4351511,449,217,35424,0,35873,217,1
1493489,183515,523,110,17512,0,18035,110,1
4629176,3187249,2058,65,9211,0,11269,65,1
3525425,4398291,81,14,2773,144,2854,158,1
3992144,2019123,402,33,23683,0,24085,33,1
1580988,3390582,2821,1,400133,0,402954,1,1
3314795,1801341,14,83,52,85,66,168,1
3361377,1983998,4841,2,761793,0,766634,2,1
615890,1237666,239,105,2229,0,2468,105,1
2981537,985999,1252,1,118718,0,119970,1,1
1520840,3865553,155,20,2950,0,3105,20,1
1301815,1522231,752,21,48944,0,49696,21,1
4678614,1072474,452,13,16881,0,17333,13,1
2308819,2193501,141,497,5491,0,5632,497,1
711442,4319857,300,22,999,0,1299,22,1
1580988,559975,2821,2,400133,0,402954,2,1
1580988,2753866,2821,2,400133,0,402954,2,1
781211,2171690,976,520,51781,0,52757,520,1
196521,4684467,1176,4,11269,0,12445,4,1
3638272,4083675,2022,1,370904,0,372926,1,1
3361377,2536764,4841,5,761793,0,766634,5,1
1029490,3430312,67,10,290,0,357,10,1
4313572,3653273,930,4,16971,0,17901,4,1
1913445,3799162,564,46,47943,0,48507,46,1
60980,4437341,649,67,20708,0,21357,67,1
1265022,3178692,4,2,89,0,93,2,1
1541364,1431723,148,247,1256,0,1404,247,1
2101710,3673739,152,1,6934,0,7086,1,1
1654099,3040030,1180,85,26347,0,27527,85,1
4368123,4832355,51,134,653,0,704,134,1
1249967,4299517,207,39,11933,0,12140,39,1
4827810,682084,39,6,528,0,567,6,1
1103332,3054933,732,55,59415,0,60147,55,1
4762204,2793021,2239,80,4518,0,6757,80,1
2206250,4274478,153,159,4857,0,5010,159,1
929513,529104,145,14,4279,0,4424,14,1
3102873,1867368,341,3,15098,0,15439,3,1
2182964,4303743,214,41,6975,0,7189,41,1
4183784,699097,931,11,59894,0,60825,11,1
2343944,1310215,24,4,108,0,132,4,1
6618,3191715,892,103,68849,0,69741,103,1
1179164,1249496,6,1,136,0,142,1,1
1580988,4468867,2821,4,400133,0,402954,4,1
2887240,805184,1143,188,118405,0,119548,188,1
1882506,2026053,94,13,1999,0,2093,13,1
1185502,1001364,197,94,1739,0,1936,94,1
2526256,4133408,59,125,852,0,911,125,1
3361377,1293572,4841,4,761793,0,766634,4,1
4848648,1663828,45,9,640,0,685,9,1
3509903,1728482,1530,1,509445,0,510975,1,1
4751453,1003321,520,35,27570,0,28090,35,1
3638272,3728811,2022,1,370904,0,372926,1,1
2793437,2517496,582,6,25447,0,26029,6,1
1586936,592541,41,132,301,6913,342,7045,1
1324626,2000752,7,1592,234,162,241,1754,1
1717922,2277070,432,751,6340,4932,6772,5683,1
4637792,4563684,430,277,517,1011,947,1288,1
636814,3967931,116,6,9387,0,9503,6,1
2631746,3480548,80,76,420,0,500,76,1
2948092,4134022,412,11,18486,0,18898,11,1
4520526,4154121,33,3,1224,0,1257,3,1
241332,3726885,446,114,2086,0,2532,114,1
4440160,3964857,736,2,20522,0,21258,2,1
2887240,2111158,1143,5,118405,0,119548,5,1
687713,2236554,436,1,47160,0,47596,1,1
3043117,1622116,130,22,2809,0,2939,22,1
3294702,355234,991,24,68888,0,69879,24,1
2981537,354841,1252,1,118718,0,119970,1,1
2147720,1055929,1608,77,78786,0,80394,77,1
2981537,4334982,1252,246,118718,0,119970,246,1
3253453,1526577,194,120,893,0,1087,120,1
3361377,2534008,4841,1,761793,0,766634,1,1
3137585,201238,1196,21,77354,0,78550,21,1
837553,3238644,1249,99,61665,0,62914,99,1
4030633,4687516,168,679,912,0,1080,679,1
3225310,1694606,320,1,10537,0,10857,1,1
1353265,2399627,128,27,6709,0,6837,27,1
4365938,1106044,250,196,10362,0,10612,196,1
3361377,4369731,4841,2,761793,0,766634,2,1
2343253,4154137,1882,4,86401,0,88283,4,1
3671141,1441604,1444,95,48400,0,49844,95,1
2398291,1336325,14,156,324,0,338,156,1
3764177,3174423,1036,35,64563,0,65599,35,1
1357274,3507716,371,38,1887,0,2258,38,1
3361377,4351502,4841,1,761793,0,766634,1,1
2897926,4181044,565,4,25983,0,26548,4,1
2567221,4585339,80,21,677,0,757,21,1
3638272,2436307,2022,1,370904,0,372926,1,1
388875,2208991,112,19,3598,0,3710,19,1
3638272,1320440,2022,43,370904,0,372926,43,1
3280389,1405543,1101,2,411419,0,412520,2,1
3115867,2259641,1350,5,61232,0,62582,5,1
1031334,2386350,459,53,16840,0,17299,53,1
1222244,3485121,52,1,165,0,217,1,1
3936039,1081755,799,30,23884,0,24683,30,1
2529661,2758300,493,96,27309,0,27802,96,1
3257465,231916,541,339,27614,0,28155,339,1
3361377,4063782,4841,7,761793,0,766634,7,1
3361377,3350947,4841,1,761793,0,766634,1,1
792037,471805,57,8,16445,0,16502,8,1
507060,1133573,191,79,6141,0,6332,79,1
1818152,2089023,20,1,1167,0,1187,1,1
302204,686941,366,1,3449,0,3815,1,1
4488849,3010798,136,64,4704,0,4840,64,1
3189108,739530,421,19,6767,0,7188,19,1
3638272,2807632,2022,2,370904,0,372926,2,1
2148937,4864264,672,1,47361,0,48033,1,1
3914135,209264,2152,17,60084,0,62236,17,1
4624595,3847798,722,21,53368,0,54090,21,1
354904,2252534,3193,25,105780,0,108973,25,1
4140279,3025470,337,4,49384,0,49721,4,1
765601,4862882,1485,127,101510,0,102995,127,1
151330,1394802,132,11,909,0,1041,11,1
4440160,1736841,736,269,20522,0,21258,269,1
3137585,3098709,1196,115,77354,0,78550,115,1
3561502,994460,1144,175,68800,0,69944,175,1
3438576,1396389,3424,1,137753,0,141177,1,1
3638272,4093780,2022,1,370904,0,372926,1,1
4683224,1808473,35,78,233,0,268,78,1
2763282,1988547,321,2,10936,0,11257,2,1
517189,4312851,115,180,1511,0,1626,180,1
4525011,1945227,172,17,6076,0,6248,17,1
4653941,2579133,951,57,45883,0,46834,57,1
3361377,2544712,4841,13,761793,0,766634,13,1
3765475,4042120,873,2,107914,0,108787,2,1
1927211,2261723,1668,43,113322,0,114990,43,1
3561502,4852609,1144,30,68800,0,69944,30,1
4708541,2806758,981,44,15678,0,16659,44,1
1604785,2111848,139,19,1999,0,2138,19,1
1983211,3399374,136,12,1225,0,1361,12,1
4598624,2058861,118,23,2264,0,2382,23,1
3509903,847982,1530,1,509445,0,510975,1,1
253406,1358594,185,4,2002,0,2187,4,1
2528239,2331001,196,27,1630,0,1826,27,1
1398588,1238116,12,2,37,0,49,2,1
2260014,240384,2466,25,98622,0,101088,25,1
3361377,1094951,4841,2,761793,0,766634,2,1
1580988,11360,2821,2,400133,0,402954,2,1
1722543,1427282,62,26,398,0,460,26,1
471706,3064551,794,4,65616,0,66410,4,1
1621606,1522523,559,52,4228,0,4787,52,1
2950311,746672,807,23,85116,0,85923,23,1
4330391,3201344,773,54,32759,0,33532,54,1
2482338,3181246,712,125,24222,1755,24934,1880,1
3361377,964077,4841,2,761793,0,766634,2,1
1063358,4082450,1350,50,63494,0,64844,50,1
3438576,1254801,3424,69,137753,0,141177,69,1
1875,547319,656,76,61388,0,62044,76,1
2687552,3449575,238,4,25574,0,25812,4,1
4314280,2633621,568,92,9552,0,10120,92,1
1580988,2081125,2821,1,400133,0,402954,1,1
2516076,275945,1455,62,77782,0,79237,62,1
1020925,1852061,204,127,3339,0,3543,127,1
2650412,3482083,931,41,29038,0,29969,41,1
446533,2452963,243,246,2507,0,2750,246,1
2938068,2316784,112,99,4178,0,4290,99,1
354904,2960816,3193,208,105780,0,108973,208,1
1135323,2235527,169,1,12240,0,12409,1,1
954784,2562439,567,139,14450,3070,15017,3209,1
196521,64931,1176,15,11269,0,12445,15,1
2617350,3532545,256,7,6547,0,6803,7,1
4327096,1027188,234,48,2944,176,3178,224,1
2405789,3081673,1010,54,93387,0,94397,54,1
1628302,4452,11,1,4819,0,4830,1,1
3361377,2429670,4841,2,761793,0,766634,2,1
2498565,135845,81,86,232,0,313,86,1
3361377,1175507,4841,1,761793,0,766634,1,1
4552666,3481911,341,31,9279,0,9620,31,1
1759632,2825521,98,78,837,0,935,78,1
2295788,3879782,289,93,2710,0,2999,93,1
4417253,4518457,1130,2,68389,0,69519,2,1
4122296,923860,35,20,1071,0,1106,20,1
1580988,3441123,2821,2,400133,0,402954,2,1
3361377,3791091,4841,3,761793,0,766634,3,1
2357953,4339739,35,141,294,0,329,141,1
4104022,1179111,126,1,2390,0,2516,1,1
1117538,4576493,44,679,84,933,128,1612,1
2421038,820381,18,85,928,2091,946,2176,1
2374539,2292592,92,101,3805,0,3897,101,1
3361377,313033,4841,1,761793,0,766634,1,1
80085,267650,75,26,2925,0,3000,26,1
1616492,3872412,310,102,5893,0,6203,102,1
612025,2731232,203,19,3465,0,3668,19,1
3676295,3755434,374,1,70881,0,71255,1,1
2148937,4584783,672,9,47361,0,48033,9,1
844892,2674716,55,43,606,0,661,43,1
752551,1555150,460,85,3526,0,3986,85,1
3992144,3086931,402,597,23683,0,24085,597,1
4062175,2680964,248,80,8522,0,8770,80,1
1654099,4453264,1180,99,26347,0,27527,99,1
4183784,2588509,931,18,59894,0,60825,18,1
3509903,3855520,1530,3,509445,0,510975,3,1
3280389,2488172,1101,3,411419,0,412520,3,1
2861015,4029516,101,2,2097,0,2198,2,1
1887709,3971836,217,3,28983,0,29200,3,1
2147720,4238243,1608,15,78786,0,80394,15,1
593740,3421115,1107,35,62807,0,63914,35,1
3638272,2528843,2022,1,370904,0,372926,1,1
2343253,4862699,1882,1,86401,0,88283,1,1
4731354,2469537,67,38,1999,0,2066,38,1
1927974,2881284,107,24,9317,0,9424,24,1
4423184,2409480,384,1,29809,0,30193,1,1
1031334,4434366,459,40,16840,0,17299,40,1
837553,2827187,1249,23,61665,0,62914,23,1
1937293,2134661,434,97,16761,0,17195,97,1
1887880,1522848,138,1,1279,0,1417,1,1
709709,1277129,166,306,1358,0,1524,306,1
1995984,77893,167,118,3484,0,3651,118,1
3984671,3718057,57,787,263,0,320,787,1
3449530,2323302,717,25,73648,0,74365,25,1
1674952,4061090,84,168,723,0,807,168,1
3361377,2873611,4841,86,761793,0,766634,86,1
1103332,1144168,732,33,59415,0,60147,33,1
4621952,1839097,922,2,5245,0,6167,2,1
1588330,1927780,694,420,10280,6230,10974,6650,1
1276253,1355227,407,103,46534,0,46941,103,1
2436781,461795,689,1,9972,0,10661,1,1
925252,4630299,103,165,4005,0,4108,165,1
869535,2768733,58,3,341,0,399,3,1
522588,584013,496,146,20091,0,20587,146,1
4295952,519839,808,73,57369,0,58177,73,1
60980,186056,649,4,20708,0,21357,4,1
1202593,1221139,93,1,5131,0,5224,1,1
3361377,3895868,4841,2,761793,0,766634,2,1
530200,3426279,2035,76,62809,0,64844,76,1
4220533,554066,329,22,3527,0,3856,22,1
292648,1158340,60,65,932,0,992,65,1
3509903,1517716,1530,2,509445,0,510975,2,1
4507110,404820,1,1,118,0,119,1,1
2457029,662196,77,2,10427,0,10504,2,1
2209136,3623394,620,11,33789,0,34409,11,1
4330391,2263270,773,94,32759,0,33532,94,1
4580859,2079499,86,143,228,0,314,143,1
1735116,2793360,503,177,16146,0,16649,177,1
755739,2852456,1117,32,58043,0,59160,32,1
3263148,3629606,174,26,2060,0,2234,26,1
3509903,2647387,1530,32,509445,0,510975,32,1
842615,2699450,510,26,12316,0,12826,26,1
3823546,85686,61,527,3026,0,3087,527,1
1785307,3664783,154,130,2119,0,2273,130,1
3694946,3206499,167,1337,907,32033,1074,33370,1
3509903,1243883,1530,2,509445,0,510975,2,1
408965,3854722,903,19,38623,0,39526,19,1
4191410,992911,1590,17,96434,0,98024,17,1
1103332,873139,732,58,59415,0,60147,58,1
386424,2723780,131,31,7871,0,8002,31,1
393023,4011264,96,1360,802,116777,898,118137,1
3477164,1516764,80,8,2851,0,2931,8,1
3257465,4243794,541,8,27614,0,28155,8,1
4541367,3897643,175,2,476,0,651,2,1
30224,812166,120,159,4175,0,4295,159,1
3318434,3290387,55,331,1995,0,2050,331,1
2827436,4311906,882,1,271525,0,272407,1,1
3936039,3082163,799,318,23884,0,24683,318,1
3280389,2091441,1101,1,411419,0,412520,1,1
2096270,2104451,970,3,26018,0,26988,3,1
2148937,570074,672,55,47361,0,48033,55,1
2169693,2692900,194,56,7674,0,7868,56,1
159285,4850427,240,71,4650,0,4890,71,1
2827436,443735,882,1,271525,0,272407,1,1
2847192,3960688,105,168,3937,0,4042,168,1
765601,1215076,1485,68,101510,0,102995,68,1
4167572,2193381,81,13,6924,0,7005,13,1
2424662,1218807,146,75,1110,1283,1256,1358,1
2052930,3885992,407,37,8479,0,8886,37,1
4411870,1872558,948,27,60517,0,61465,27,1
932720,4317188,1411,68,111323,0,112734,68,1
2521571,2287082,42,12,168,0,210,12,1
4619326,2030886,539,1,22721,0,23260,1,1
1973082,779690,1036,20,18915,0,19951,20,1
3554097,2424225,65,11,1978,0,2043,11,1
4319972,2983030,640,116,35279,0,35919,116,1
474172,2313585,471,28,38713,0,39184,28,1
3294702,3819766,991,92,68888,0,69879,92,1
3280389,1463493,1101,1,411419,0,412520,1,1
4528103,3026073,268,475,14258,0,14526,475,1
4011264,4215636,1360,21,116777,0,118137,21,1
2101710,852920,152,231,6934,0,7086,231,1
3137585,4461872,1196,59,77354,0,78550,59,1
4321286,2359683,32,1,208,0,240,1,1
427805,914412,483,2,156906,0,157389,2,1
4301309,3577478,323,134,4103,209,4426,343,1
1031334,3919207,459,14,16840,0,17299,14,1
1249227,478913,621,315,7423,0,8044,315,1
2304836,2656408,19,18,151,0,170,18,1
2260014,2693684,2466,28,98622,0,101088,28,1
4220190,2469218,320,169,15994,0,16314,169,1
1580988,346967,2821,2,400133,0,402954,2,1
1230368,1209788,12,1,215,0,227,1,1
3933095,3379725,304,128,2162,469,2466,597,1
2981537,109261,1252,3,118718,0,119970,3,1
1913862,630220,358,594,4027,2886,4385,3480,1
593040,101362,7,90,121,0,128,90,1
2075015,1670790,2664,2,85781,0,88445,2,1
3561502,249001,1144,26,68800,0,69944,26,1
354904,991748,3193,259,105780,0,108973,259,1
2150686,3126349,69,9,983,0,1052,9,1
3135181,3986468,12,111,173,3703,185,3814,1
4329730,3330697,395,131,3730,0,4125,131,1
3933095,2426489,304,521,2162,2911,2466,3432,1
3654276,3134473,153,4,3512,0,3665,4,1
405955,444038,109,2,6949,0,7058,2,1
3361377,830206,4841,1,761793,0,766634,1,1
4642569,613338,872,1805,27586,0,28458,1805,1
1503116,1293331,415,2,37079,0,37494,2,1
755739,2875824,1117,59,58043,0,59160,59,1
354904,904729,3193,29,105780,0,108973,29,1
755739,3719512,1117,6,58043,0,59160,6,1
1539837,1416050,1127,287,62979,0,64106,287,1
427805,4324485,483,1,156906,0,157389,1,1
380817,4807718,32,125,1035,0,1067,125,1
4843487,334828,221,60,751,0,972,60,1
3501482,924035,522,12,28046,0,28568,12,1
3872736,3371422,258,74,12660,0,12918,74,1
837553,4172310,1249,62,61665,0,62914,62,1
2827436,3705464,882,24,271525,0,272407,24,1
1591435,3049393,387,27,31245,0,31632,27,1
3280389,3354831,1101,1,411419,0,412520,1,1
306377,2739181,221,8,300,0,521,8,1
3411803,1681927,157,123,1023,865,1180,988,1
1575009,849895,429,36,37745,0,38174,36,1
932720,4296908,1411,8,111323,0,112734,8,1
2107861,3731091,535,3,25743,0,26278,3,1
1983217,122339,67,3,874,0,941,3,1
4498806,3280074,34,34,73,0,107,34,1
362256,3482737,47,66,288,139,335,205,1
3206499,2901911,1337,2,32033,0,33370,2,1
2343253,3300525,1882,1,86401,0,88283,1,1
3361377,360045,4841,25,761793,0,766634,25,1
2827436,1812230,882,1,271525,0,272407,1,1
3280389,2993937,1101,1,411419,0,412520,1,1
2260014,1813237,2466,34,98622,0,101088,34,1
958615,2459983,56,56,2225,0,2281,56,1
4649206,2554220,566,41,31367,0,31933,41,1
3984303,4011251,133,6,4489,0,4622,6,1
1734954,597924,369,1173,5786,0,6155,1173,1
3054732,1208770,310,4,4246,0,4556,4,1
441667,2989848,198,48,14727,0,14925,48,1
4004339,2098069,153,13,6086,0,6239,13,1
821089,439557,394,2090,4820,61744,5214,63834,1
3764177,1276815,1036,55,64563,0,65599,55,1
3676295,2962451,374,1,70881,0,71255,1,1
4708541,731725,981,40,15678,0,16659,40,1
2514271,1617558,387,139,19070,0,19457,139,1
3796262,2657284,67,2605,403,690,470,3295,1
3569617,2394795,160,4,3695,0,3855,4,1
3873768,1900194,449,64,35424,0,35873,64,1
515290,604823,285,68,34080,0,34365,68,1
3671141,3475234,1444,21,48400,0,49844,21,1
3765475,35324,873,3,107914,0,108787,3,1
2405789,689400,1010,130,93387,0,94397,130,1
3672238,1830317,518,114,12172,0,12690,114,1
2998026,1590220,919,12,24182,113,25101,125,1
3745109,1959206,45,4,142,0,187,4,1
1034643,4008943,198,113,293,0,491,113,1
3316576,4499110,669,92,7971,0,8640,92,1
2795472,2855768,150,17,511,0,661,17,1
720204,1859935,240,350,322,163,562,513,1
2310265,4021080,241,4,6278,0,6519,4,1
1927211,2382906,1668,147,113322,0,114990,147,1
2809337,4467395,52,2084,510,14574,562,16658,1
3137585,3180042,1196,203,77354,0,78550,203,1
4497645,4717522,65,913,536,395,601,1308,1
3112136,435228,406,70,41366,0,41772,70,1
2615366,4523797,5,304,203,101,208,405,1
1346693,967382,107,29,1035,0,1142,29,1
4516604,4452692,314,7,13314,0,13628,7,1
805360,2374695,1514,33,119306,0,120820,33,1
2187320,2860238,208,21,3143,0,3351,21,1
4701417,4573590,305,9,3855,0,4160,9,1
1575009,4121789,429,34,37745,0,38174,34,1
4416945,3080887,417,10,33228,0,33645,10,1
4183784,2113398,931,86,59894,0,60825,86,1
439557,879404,2090,2,61744,0,63834,2,1
932720,3551247,1411,163,111323,0,112734,163,1
2231398,2005683,50,19,1992,0,2042,19,1
1966548,1603979,208,17,53149,0,53357,17,1
3361377,852865,4841,1,761793,0,766634,1,1
3569179,2637513,1064,4,40015,0,41079,4,1
792037,1710056,57,2,16445,0,16502,2,1
311091,1436216,32,1068,459,68770,491,69838,1
3509903,4398597,1530,1,509445,0,510975,1,1
3438576,180906,3424,4,137753,0,141177,4,1
460937,2437433,130,170,609,136,739,306,1
646587,628509,122,20,5819,0,5941,20,1
2655966,4838425,81,3,2804,0,2885,3,1
3698687,4747900,72,11,605,0,677,11,1
1302472,262973,164,85,3470,0,3634,85,1
2405789,4302562,1010,30,93387,0,94397,30,1
4183784,3421710,931,56,59894,0,60825,56,1
3458198,931263,60,20,4425,0,4485,20,1
532681,3211274,433,12,35023,0,35456,12,1
1436216,830957,1068,3,68770,0,69838,3,1
501914,1380796,217,38,5217,0,5434,38,1
226540,3503851,463,10,10650,0,11113,10,1
4257751,473794,109,2,8420,0,8529,2,1
860473,3078626,751,97,20450,0,21201,97,1
873006,3078196,375,297,33630,0,34005,297,1
1063358,1524344,1350,60,63494,0,64844,60,1
576373,2212852,54,211,751,0,805,211,1
1539837,118703,1127,14,62979,0,64106,14,1
4649206,1007846,566,57,31367,0,31933,57,1
3361377,3358786,4841,2,761793,0,766634,2,1
4272102,1883395,1608,91,104171,654,105779,745,1
3638272,1704662,2022,1,370904,0,372926,1,1
2793437,2007646,582,3,25447,0,26029,3,1
855821,254061,770,547,5493,0,6263,547,1
4598255,3282475,791,82,583,0,1374,82,1
2161115,2087003,157,402,951,4405,1108,4807,1
1653998,2307436,24,11,1986,0,2010,11,1
3188223,1899501,24,177,279,423,303,600,1
781211,3013033,976,41,51781,0,52757,41,1
521586,1157928,782,58,18489,0,19271,58,1
1031334,2982385,459,321,16840,0,17299,321,1
3671141,1440550,1444,82,48400,0,49844,82,1
1580988,1990084,2821,1,400133,0,402954,1,1
2261139,676112,2014,52,42851,582,44865,634,1
1355114,976535,47,43,2747,0,2794,43,1
681618,3129706,75,10,8789,0,8864,10,1
4642569,2361498,872,42,27586,0,28458,42,1
4004339,1496530,153,80,6086,0,6239,80,1
4191410,3310157,1590,9,96434,0,98024,9,1
3449530,915647,717,43,73648,0,74365,43,1
3065808,1934584,1235,24,82317,0,83552,24,1
4411870,2146045,948,10,60517,0,61465,10,1
2502456,508607,719,129,50725,0,51444,129,1
2981537,1749580,1252,13,118718,0,119970,13,1
4238001,431547,869,20,61161,0,62030,20,1
286378,4306762,26,2,312,0,338,2,1
2514761,1485558,198,1140,2369,0,2567,1140,1
4110535,4098711,395,237,7311,0,7706,237,1
4106501,2981474,224,7,1969,0,2193,7,1
823355,231572,17,104,277,0,294,104,1
1894869,2327919,263,44,964,0,1227,44,1
1353449,3996125,101,177,920,0,1021,177,1
2827436,1192968,882,1,271525,0,272407,1,1
3361377,3681788,4841,1,761793,0,766634,1,1
1185502,2171341,197,81,1739,0,1936,81,1
487430,1453648,72,94,516,0,588,94,1
4619326,2369929,539,297,22721,0,23260,297,1
1468737,3207049,172,194,792,0,964,194,1
2339149,1582905,97,210,4258,0,4355,210,1
781211,2235856,976,176,51781,0,52757,176,1
92352,763970,1138,168,20575,0,21713,168,1
871344,636759,263,469,1863,0,2126,469,1
3814892,1216360,60,3,3420,0,3480,3,1
3112136,1250091,406,1,41366,0,41772,1,1
1580988,2421939,2821,1,400133,0,402954,1,1
2668463,3644342,116,459,1922,0,2038,459,1
932720,1832574,1411,91,111323,0,112734,91,1
3361377,4528779,4841,7,761793,0,766634,7,1
2893334,3128358,889,5,30148,0,31037,5,1
4675629,4660687,41,1097,850,0,891,1097,1
4621952,1738725,922,46,5245,291,6167,337,1
3280389,3483356,1101,1,411419,0,412520,1,1
3764262,2927434,19,1,544,0,563,1,1
3074145,3256649,205,43,5623,0,5828,43,1
1115891,1892251,41,283,112,188,153,471,1
873241,2991072,616,320,22633,0,23249,320,1
3501482,4542075,522,31,28046,0,28568,31,1
1870921,830409,182,4,8739,0,8921,4,1
3280389,3276621,1101,1,411419,0,412520,1,1
2670449,3911569,277,145,3488,0,3765,145,1
687713,474528,436,48,47160,0,47596,48,1
3638272,3906444,2022,1,370904,0,372926,1,1
2457029,1161510,77,27,10427,0,10504,27,1
3468600,3054732,89,310,257,4246,346,4556,1
3765475,2657743,873,8,107914,0,108787,8,1
2348093,1813773,335,2,12064,0,12399,2,1
2650412,4655316,931,7,29038,0,29969,7,1
307250,4663471,919,2,35588,0,36507,2,1
2911269,1206165,740,67,20606,898,21346,965,1
3509903,3436475,1530,2,509445,0,510975,2,1
687713,2384872,436,1,47160,0,47596,1,1
4114135,2369485,66,523,577,509,643,1032,1
3671141,4025686,1444,47,48400,0,49844,47,1
638753,3831308,88,6,1817,0,1905,6,1
1580988,1431926,2821,5,400133,0,402954,5,1
148562,302328,135,266,587,732,722,998,1
1672938,3023249,83,1041,759,0,842,1041,1
3538670,1097513,54,4,718,0,772,4,1
3361377,1878316,4841,2,761793,0,766634,2,1
781211,2201974,976,113,51781,0,52757,113,1
4112891,4189992,426,75,3572,0,3998,75,1
2210915,2347636,325,237,1678,408,2003,645,1
4191410,955111,1590,56,96434,0,98024,56,1
3973293,762915,325,1,2788,0,3113,1,1
3718020,3844858,305,1591,6132,28974,6437,30565,1
2219036,704010,192,7,1889,0,2081,7,1
1654099,336137,1180,3,26347,0,27527,3,1
244444,2979057,39,2,1390,0,1429,2,1
3946789,1795569,261,29,5606,144,5867,173,1
4004339,2948124,153,64,6086,0,6239,64,1
614645,1961627,16,4,812,0,828,4,1
3638272,630567,2022,85,370904,0,372926,85,1
3531730,2308109,334,69,9763,0,10097,69,1
240570,82646,138,68,1079,0,1217,68,1
4519069,14904,387,16,20799,0,21186,16,1
4191727,3959431,463,4,26315,0,26778,4,1
4249392,3240776,56,62,455,0,511,62,1
3115867,220320,1350,30,61232,0,62582,30,1
2576364,2034102,108,210,1654,0,1762,210,1
1100354,841480,163,1,24439,0,24602,1,1
837553,1650649,1249,56,61665,0,62914,56,1
695505,162970,98,142,2720,0,2818,142,1
3952001,2962391,139,2532,1496,241,1635,2773,1
110570,1809926,68,2452,891,130,959,2582,1
1195811,4184340,89,6,1995,0,2084,6,1
2827436,1342421,882,28,271525,0,272407,28,1
4712782,3306011,171,67,4681,0,4852,67,1
1192480,234251,397,6,20737,0,21134,6,1
427805,3005082,483,1,156906,0,157389,1,1
2516076,964729,1455,14,77782,0,79237,14,1
2147720,2884652,1608,51,78786,0,80394,51,1
1580988,3490023,2821,10,400133,0,402954,10,1
4485028,752919,445,112,14565,0,15010,112,1
4519069,3583668,387,85,20799,0,21186,85,1
1880135,4517919,810,54,71924,0,72734,54,1
4052552,3128185,562,89,5417,0,5979,89,1
429643,80471,767,16,19668,0,20435,16,1
1540080,2537523,255,37,3594,0,3849,37,1
4727207,1059394,925,1,84581,0,85506,1,1
3112136,3923431,406,82,41366,0,41772,82,1
2747503,4053654,56,1,74,0,130,1,1
3509903,1508711,1530,1,509445,0,510975,1,1
1330432,878825,12,5,1926,0,1938,5,1
69708,839077,28,38,229,0,257,38,1
4192206,4354319,468,8,18229,0,18697,8,1
1839283,2193329,765,5,36658,0,37423,5,1
2911269,1089082,740,47,20606,0,21346,47,1
2482338,3742618,712,191,24222,0,24934,191,1
837553,3909888,1249,4,61665,0,62914,4,1
3505280,1785162,81,710,315,50,396,760,1
4479581,3615523,601,6,19545,0,20146,6,1
448517,1921868,625,688,12450,0,13075,688,1
4202576,2996071,600,6,10697,0,11297,6,1
502082,3196538,589,6,16428,0,17017,6,1
2260014,990273,2466,40,98622,0,101088,40,1
2827436,4681169,882,17,271525,0,272407,17,1
3672238,1024040,518,124,12172,0,12690,124,1
4255252,3745109,176,45,991,142,1167,187,1
427805,4744951,483,8,156906,0,157389,8,1
380998,2817341,200,5,8943,0,9143,5,1
1887709,2617439,217,4,28983,0,29200,4,1
1503116,1339630,415,88,37079,0,37494,88,1
2343253,1083249,1882,2,86401,0,88283,2,1
2827436,3929867,882,1,271525,0,272407,1,1
2849535,2413747,273,28,1462,0,1735,28,1
941509,1504171,106,2,3066,0,3172,2,1
1534362,1717071,1531,62,105859,0,107390,62,1
2961801,4037948,1483,81,101962,0,103445,81,1
3112136,1569077,406,111,41366,0,41772,111,1
550866,1433213,79,1033,1089,0,1168,1033,1
1822719,29298,285,39,22351,0,22636,39,1
3075234,1833314,550,115,2457,0,3007,115,1
3509903,2835961,1530,4,509445,0,510975,4,1
1497278,2646456,1869,4,35111,0,36980,4,1
1580988,4385934,2821,2,400133,0,402954,2,1
3361377,3015866,4841,1,761793,0,766634,1,1
4688571,2732260,145,16,776,0,921,16,1
2120733,2834160,819,60,20803,0,21622,60,1
2482338,1825835,712,13,24222,0,24934,13,1
4191727,2245863,463,6,26315,0,26778,6,1
530200,2320419,2035,9,62809,0,64844,9,1
2310265,160316,241,33,6278,0,6519,33,1
3449337,359162,34,9,1668,0,1702,9,1
4725126,3203581,73,165,360,58,433,223,1
3764177,4261257,1036,5,64563,0,65599,5,1
3361377,3520855,4841,78,761793,0,766634,78,1
2314038,755739,456,1117,16347,58043,16803,59160,1
860473,1435679,751,19,20450,0,21201,19,1
427805,304912,483,1,156906,0,157389,1,1
2348093,4405413,335,5,12064,0,12399,5,1
2961801,4788833,1483,74,101962,0,103445,74,1
724436,4735993,217,9,2547,0,2764,9,1
441667,4124885,198,1,14727,0,14925,1,1
427805,4730178,483,6,156906,0,157389,6,1
471706,2674662,794,15,65616,0,66410,15,1
3828577,2655778,120,1,504,0,624,1,1
1234540,4752604,1071,18,75251,0,76322,18,1
3914135,3384816,2152,26,60084,0,62236,26,1
3638272,337607,2022,1,370904,0,372926,1,1
1201711,785699,357,570,15948,0,16305,570,1
3137585,3091406,1196,4,77354,0,78550,4,1
592541,4534733,132,69,6913,0,7045,69,1
1994281,129238,139,58,2492,0,2631,58,1
4411870,1415928,948,60,60517,0,61465,60,1
573641,3765673,253,207,5074,0,5327,207,1
3509903,3702218,1530,5,509445,0,510975,5,1
3631587,2883875,46,19,552,0,598,19,1
3407755,1496814,58,13,630,0,688,13,1
2888974,3522570,197,10,1181,0,1378,10,1
4731849,1785866,455,1,10886,0,11341,1,1
1580988,1644663,2821,35,400133,0,402954,35,1
3378452,2852038,34,28,1186,0,1220,28,1
1769943,1502327,553,5,7901,0,8454,5,1
6618,929335,892,36,68849,0,69741,36,1
4853234,613686,1256,10,29554,0,30810,10,1
2793437,1038159,582,8,25447,0,26029,8,1
1103332,1663435,732,11,59415,0,60147,11,1
1310800,1535451,200,286,6100,0,6300,286,1
2027108,4056599,1172,3,5587,0,6759,3,1
2851109,1540462,450,4,98552,0,99002,4,1
3361377,3608359,4841,19,761793,0,766634,19,1
3280389,2277676,1101,1,411419,0,412520,1,1
4295952,893793,808,165,57369,0,58177,165,1
3630714,4136868,257,439,7929,0,8186,439,1
1652056,456147,326,1,66845,0,67171,1,1
439557,1022561,2090,9,61744,0,63834,9,1
3561502,816119,1144,213,68800,0,69944,213,1
3175944,4716933,324,11,7415,0,7739,11,1
530200,3397811,2035,88,62809,0,64844,88,1
1733957,1296999,554,54,15185,0,15739,54,1
4247586,1791195,5,381,72,0,77,381,1
1757895,4055714,84,21,541,0,625,21,1
4385783,140813,290,2,10995,0,11285,2,1
3765475,4515588,873,1,107914,0,108787,1,1
4209323,2864984,1630,94,89460,0,91090,94,1
3361377,1663407,4841,1,761793,0,766634,1,1
2896906,3008925,1193,118,7172,0,8365,118,1
3361377,919103,4841,1,761793,0,766634,1,1
359225,2033650,27,177,211,533,238,710,1
3397281,4439614,743,176,15050,0,15793,176,1
1436216,1600783,1068,1,68770,0,69838,1,1
4624595,620549,722,28,53368,0,54090,28,1
476426,4043291,72,21,1975,0,2047,21,1
2827436,4354988,882,3,271525,0,272407,3,1
1580988,4854208,2821,1,400133,0,402954,1,1
4528103,2948773,268,3,14258,0,14526,3,1
1230288,664315,37,24,1909,0,1946,24,1
768957,696360,202,85,7986,0,8188,85,1
3605448,206500,202,6,2022,0,2224,6,1
4209323,4721943,1630,37,89460,0,91090,37,1
1306260,3151496,233,207,3200,0,3433,207,1
1958096,2888718,80,1,1029,0,1109,1,1
3361377,1316015,4841,12,761793,0,766634,12,1
3769160,557299,156,72,1054,0,1210,72,1
1533546,4370216,703,62,22095,0,22798,62,1
842615,1269309,510,41,12316,0,12826,41,1
3361377,4835374,4841,1,761793,0,766634,1,1
2260014,4344437,2466,31,98622,0,101088,31,1
3387987,3186415,268,176,19035,0,19303,176,1
3671141,4218728,1444,10,48400,0,49844,10,1
805360,1509383,1514,294,119306,0,120820,294,1
3638272,215967,2022,5,370904,0,372926,5,1
3561502,4468577,1144,75,68800,0,69944,75,1
2851109,4509843,450,132,98552,3138,99002,3270,1
2881425,768269,102,667,5272,32,5374,699,1
185943,3418669,620,70,6573,0,7193,70,1
3361377,3129427,4841,1,761793,0,766634,1,1
448517,3018762,625,38,12450,0,13075,38,1
1591435,3831895,387,91,31245,0,31632,91,1
4782707,1865679,513,1,31665,0,32178,1,1
3671141,1135058,1444,14,48400,0,49844,14,1
1880135,4125864,810,26,71924,0,72734,26,1
2092359,4667477,421,8,26936,0,27357,8,1
4272102,1609926,1608,8,104171,0,105779,8,1
3914135,2587298,2152,26,60084,0,62236,26,1
2827436,4248844,882,2,271525,0,272407,2,1
2276175,584886,262,143,4860,0,5122,143,1
919120,1147187,205,75,2831,0,3036,75,1
2762372,1456690,818,18,6089,0,6907,18,1
2241519,2284436,23,76,460,0,483,76,1
1463080,516411,114,85,253,42,367,127,1
427805,1449170,483,1,156906,0,157389,1,1
1923830,3011649,181,30,2733,0,2914,30,1
431086,365757,619,31,14910,0,15529,31,1
2827436,2956791,882,2,271525,0,272407,2,1
755739,4294930,1117,91,58043,0,59160,91,1
3280389,2432984,1101,1,411419,0,412520,1,1
3509903,407301,1530,1,509445,0,510975,1,1
1580988,369250,2821,23,400133,0,402954,23,1
4269895,4796893,123,43,1039,0,1162,43,1
2923257,126595,108,29,3187,0,3295,29,1
3280389,1506110,1101,3,411419,0,412520,3,1
4689808,4230779,280,20,14220,0,14500,20,1
3280389,4768702,1101,5,411419,0,412520,5,1
4319972,4380303,640,45,35279,0,35919,45,1
3914135,3706569,2152,18,60084,0,62236,18,1
3291145,3687571,105,400,4218,0,4323,400,1
1250021,1951619,4637,127,85913,0,90550,127,1
2164178,983894,574,1,6134,0,6708,1,1
2179869,1648454,88,8,1883,0,1971,8,1
687713,1748336,436,1,47160,0,47596,1,1
3361377,1424875,4841,8,761793,16,766634,24,1
3137585,1485100,1196,81,77354,0,78550,81,1
2261139,2443637,2014,24,42851,0,44865,24,1
1870921,3213638,182,3,8739,0,8921,3,1
474172,1118736,471,36,38713,0,39184,36,1
471706,1465044,794,2,65616,0,66410,2,1
2562720,3785977,52,9,3640,0,3692,9,1
3509903,3815793,1530,4,509445,0,510975,4,1
3280389,3863854,1101,1,411419,0,412520,1,1
4192206,997475,468,66,18229,0,18697,66,1
2024753,794415,172,18,1901,0,2073,18,1
3509903,4202849,1530,1,509445,0,510975,1,1
3871554,1693108,947,11,16042,0,16989,11,1
3139564,3911969,76,9,224,0,300,9,1
613620,2976486,141,118,2512,0,2653,118,1
4751453,241144,520,114,27570,0,28090,114,1
4637792,3180988,430,7,517,0,947,7,1
3278135,1092226,358,148,7252,0,7610,148,1
401947,4725764,367,60,7890,0,8257,60,1
4103612,3990927,932,9,5655,0,6587,9,1
1880135,4304389,810,13,71924,0,72734,13,1
508550,1876909,22,1,878,0,900,1,1
2584036,819794,18,6,107,0,125,6,1
4160619,2443602,152,4,745,0,897,4,1
3509903,4175027,1530,1,509445,0,510975,1,1
3280389,4804295,1101,1,411419,0,412520,1,1
1880135,4459831,810,308,71924,0,72734,308,1
1889641,891924,33,2,1381,0,1414,2,1
1494665,3195236,668,6,37638,0,38306,6,1
2343253,3088155,1882,2,86401,0,88283,2,1
3739473,2369195,448,12,13226,0,13674,12,1
3873768,1440405,449,94,35424,0,35873,94,1
4564202,586759,97,579,1554,0,1651,579,1
2494800,4338437,752,185,5329,883,6081,1068,1
1818152,3347778,20,2,1167,0,1187,2,1
1652056,4695647,326,1,66845,0,67171,1,1
4135607,2048670,19,108,111,0,130,108,1
4006119,1650875,31,1881,491,162,522,2043,1
3137585,666659,1196,73,77354,0,78550,73,1
2498087,1417089,1630,102,32582,0,34212,102,1
1580988,256012,2821,145,400133,0,402954,145,1
4297315,4146022,195,55,7446,0,7641,55,1
895123,3276399,149,6,2246,0,2395,6,1
4547539,659869,206,23,3195,0,3401,23,1
3739473,2907335,448,62,13226,0,13674,62,1
687713,4066824,436,17,47160,0,47596,17,1
4623482,1288217,33,44,192,0,225,44,1
755739,4451833,1117,98,58043,0,59160,98,1
3734245,3853430,915,120,34965,0,35880,120,1
3438576,452639,3424,9,137753,0,141177,9,1
4653007,3026601,169,123,728,0,897,123,1
4750855,2712426,355,214,18880,0,19235,214,1
2516076,184660,1455,30,77782,0,79237,30,1
427805,3612989,483,1,156906,0,157389,1,1
3509903,556980,1530,9,509445,0,510975,9,1
3019092,3106189,108,1,8595,0,8703,1,1
1506065,4370624,136,13,3968,0,4104,13,1
2887240,1063358,1143,1350,118405,63494,119548,64844,1
4841653,357382,8,13,168,0,176,13,1
471706,2643434,794,122,65616,0,66410,122,1
3903852,2109273,21,74,123,0,144,74,1
3509903,1880703,1530,5,509445,0,510975,5,1
2281149,3061917,282,140,28082,0,28364,140,1
1100354,1632562,163,3,24439,0,24602,3,1
1913445,3848506,564,106,47943,0,48507,106,1
4011264,1836065,1360,66,116777,0,118137,66,1
412862,2713277,80,149,860,0,940,149,1
4816740,3092643,141,230,7750,0,7891,230,1
1887669,4748531,733,58,23145,0,23878,58,1
1927211,4783185,1668,15,113322,0,114990,15,1
1234540,750094,1071,88,75251,0,76322,88,1
1503116,4283122,415,7,37079,0,37494,7,1
3134846,3144660,69,6,5634,0,5703,6,1
1843507,4567609,537,77,11729,0,12266,77,1
765601,850077,1485,72,101510,0,102995,72,1
1580988,1723273,2821,1,400133,0,402954,1,1
2147720,2511944,1608,28,78786,0,80394,28,1
3051212,4310769,957,55,8349,0,9306,55,1
2394976,698533,335,194,10973,0,11308,194,1
3399872,1744399,38,3,806,0,844,3,1
2587544,2124284,111,602,1055,0,1166,602,1
3509903,1152497,1530,1,509445,0,510975,1,1
4492248,3894461,237,5,17127,0,17364,5,1
3659050,433594,204,234,619,0,823,234,1
1673877,1865990,160,663,528,0,688,663,1
419362,1367688,314,101,5584,557,5898,658,1
1913445,894267,564,20,47943,0,48507,20,1
1658782,4297761,12,1,173,0,185,1,1
2193513,3016810,100,164,1276,4329,1376,4493,1
4707650,3484071,257,195,6619,0,6876,195,1
2281149,2700528,282,896,28082,0,28364,896,1
1124035,2125541,84,3,3736,0,3820,3,1
2255478,4714460,190,4,2000,0,2190,4,1
246244,1403937,156,112,2431,0,2587,112,1
3509903,1520748,1530,1,509445,0,510975,1,1
3671141,1627974,1444,106,48400,0,49844,106,1
4448698,4120407,11,7,182,43,193,50,1
3361377,3288529,4841,2,761793,0,766634,2,1
1814268,1114462,59,13,4650,0,4709,13,1
4209323,4657922,1630,77,89460,0,91090,77,1
1927211,3822066,1668,57,113322,0,114990,57,1
3074145,4643690,205,1,5623,0,5828,1,1
935972,2122839,59,244,862,0,921,244,1
471706,1617586,794,1,65616,0,66410,1,1
2464401,4679503,577,11,23681,0,24258,11,1
1580988,2330848,2821,27,400133,0,402954,27,1
448517,4746116,625,17,12450,0,13075,17,1
1580988,3031474,2821,139,400133,0,402954,139,1
3907996,3531932,485,55,18964,0,19449,55,1
3242275,2926105,551,619,17400,0,17951,619,1
2647251,2216213,40,8,387,0,427,8,1
4191727,2668968,463,21,26315,0,26778,21,1
3992144,4434473,402,6,23683,0,24085,6,1
1138515,332970,341,118,12443,0,12784,118,1
731863,3964063,70,8,327,0,397,8,1
1192480,2625463,397,4,20737,0,21134,4,1
4604311,1571260,29,7,7472,0,7501,7,1
1875,2819327,656,34,61388,0,62044,34,1
3502068,2801964,378,1,2133,0,2511,1,1
4624595,1477610,722,73,53368,0,54090,73,1
2687552,2347210,238,30,25574,0,25812,30,1
2628417,1962100,11,60,689,0,700,60,1
3841840,808131,195,246,2931,0,3126,246,1
607449,507542,380,55,19369,0,19749,55,1
3943052,934413,156,118,312,0,468,118,1
2841394,1213130,159,379,3045,0,3204,379,1
3361377,771695,4841,1,761793,0,766634,1,1
2790006,3143269,367,72,14747,0,15114,72,1
3280389,4015475,1101,1,411419,0,412520,1,1
2023979,4090306,192,119,3227,0,3419,119,1
765601,3438214,1485,136,101510,0,102995,136,1
471706,4583998,794,4,65616,0,66410,4,1
1356408,4135599,33,1648,21,329,54,1977,1
4053607,2079607,181,349,2197,0,2378,349,1
240632,2263845,52,110,530,0,582,110,1
873006,2899547,375,99,33630,0,34005,99,1
3070849,3174876,83,149,2913,0,2996,149,1
3280389,2846511,1101,3,411419,0,412520,3,1
3102873,2351530,341,91,15098,0,15439,91,1
1822719,2864977,285,4,22351,0,22636,4,1
3216859,1094734,128,223,1073,1328,1201,1551,1
3987684,1728419,286,2,17372,0,17658,2,1
3428306,4829746,103,5,2173,0,2276,5,1
4117427,2561949,329,314,9639,0,9968,314,1
2198120,1457564,21,27,3083,0,3104,27,1
2309976,2490310,458,1,2527,0,2985,1,1
4191727,1083260,463,135,26315,0,26778,135,1
4798192,3485800,816,94,20426,0,21242,94,1
1311307,3677297,358,62,10864,0,11222,62,1
2763282,735375,321,2,10936,0,11257,2,1
67454,4840577,515,973,5700,0,6215,973,1
4133036,2792391,41,1042,564,0,605,1042,1
441667,3147010,198,330,14727,0,14925,330,1
2950311,2759329,807,30,85116,0,85923,30,1
3167388,2509719,203,96,9760,0,9963,96,1
1331940,345484,802,20,32617,0,33419,20,1
4319972,3880150,640,387,35279,0,35919,387,1
1609659,1007161,523,872,29763,0,30286,872,1
3842148,1151862,719,68,11430,0,12149,68,1
380998,569004,200,72,8943,0,9143,72,1
3361377,4573747,4841,8,761793,0,766634,8,1
2209136,353369,620,39,33789,0,34409,39,1
4727207,2113437,925,1,84581,0,85506,1,1
1580988,4091913,2821,2,400133,0,402954,2,1
1966548,2835421,208,2,53149,0,53357,2,1
657387,2278232,47,1,2455,0,2502,1,1
4515355,3553513,21,1,8176,0,8197,1,1
4330391,1980404,773,402,32759,0,33532,402,1
3881566,2091804,781,236,14176,0,14957,236,1
3387987,3330716,268,187,19035,0,19303,187,1
2147720,4045250,1608,28,78786,0,80394,28,1
1723506,218376,733,16,21835,0,22568,16,1
3873768,362008,449,3,35424,0,35873,3,1
429643,3182613,767,10,19668,0,20435,10,1
6618,3388673,892,74,68849,0,69741,74,1
782421,740170,29,6,168,0,197,6,1
2040965,4323262,45,1157,386,188,431,1345,1
2729874,3135639,27,352,49,0,76,352,1
3765475,4532603,873,2,107914,0,108787,2,1
4360960,4841002,1642,9,110084,0,111726,9,1
1344759,364844,276,170,2679,0,2955,170,1
4721617,2475740,307,103,12885,0,13192,103,1
932720,1571209,1411,80,111323,0,112734,80,1
4191727,3158641,463,60,26315,0,26778,60,1
1494665,2361238,668,326,37638,0,38306,326,1
2120733,2720727,819,114,20803,0,21622,114,1
4727207,4205016,925,5,84581,0,85506,5,1
1116703,3043548,533,4,2891,0,3424,4,1
4827056,3140329,226,2,12578,0,12804,2,1
680015,306272,485,98,9502,0,9987,98,1
1984622,2356006,145,4,20659,0,20804,4,1
2348093,4116559,335,102,12064,0,12399,102,1
2751572,1796630,481,50,44036,0,44517,50,1
2961801,3955762,1483,70,101962,0,103445,70,1
607287,4315713,20,80,100,212,120,292,1
4322182,3535488,83,20,3535,0,3618,20,1
1341178,3039600,899,90,16829,0,17728,90,1
3651179,1999036,1752,2,2979,0,4731,2,1
1633022,3342821,246,1,23530,0,23776,1,1
1471685,94242,1681,18,25550,0,27231,18,1
1875,946641,656,55,61388,0,62044,55,1
2827436,4676452,882,1,271525,0,272407,1,1
4506972,2060907,99,20,704,0,803,20,1
1733957,3304333,554,3,15185,0,15739,3,1
4653941,2465418,951,170,45883,0,46834,170,1
3280389,1729860,1101,19,411419,0,412520,19,1
1268655,2053529,237,54,335,0,572,54,1
3765475,3779565,873,1,107914,0,108787,1,1
1100354,4610534,163,2,24439,0,24602,2,1
1426700,4401688,18,53,140,0,158,53,1
941509,140598,106,3,3066,0,3172,3,1
1497278,4134515,1869,61,35111,0,36980,61,1
1629019,2212405,351,257,5823,0,6174,257,1
950702,3574881,114,3,160,0,274,3,1
1534362,156763,1531,57,105859,0,107390,57,1
599167,4101048,18,66,395,0,413,66,1
3638272,4851023,2022,3,370904,0,372926,3,1
946775,1375992,110,101,1072,0,1182,101,1
2884705,3144733,649,5,10233,0,10882,5,1
2170463,2483063,16,1,175,0,191,1,1
2798865,3433766,25,29,2109,0,2134,29,1
3761102,3920146,279,66,11592,0,11871,66,1
3875080,3027182,285,73,5153,0,5438,73,1
3260961,3188888,288,194,7637,0,7925,194,1
765601,1436800,1485,15,101510,0,102995,15,1
4738916,526760,1165,33,34124,0,35289,33,1
1591435,778816,387,66,31245,0,31632,66,1
3361377,531947,4841,5,761793,0,766634,5,1
3361377,3130419,4841,1,761793,0,766634,1,1
4167572,1974057,81,1,6924,0,7005,1,1
4397923,3879726,16,60,1228,0,1244,60,1
1733957,16068,554,370,15185,0,15739,370,1
3280389,1873241,1101,1,411419,0,412520,1,1
493062,3168092,34,134,2722,0,2756,134,1
1787075,104449,894,34,28305,0,29199,34,1
940526,4182706,475,8,20786,0,21261,8,1
2950311,3249400,807,40,85116,0,85923,40,1
1392121,677413,904,103,3808,0,4712,103,1
532681,4213500,433,16,35023,0,35456,16,1
282129,1409229,146,42,2112,0,2258,42,1
2426489,855783,521,15,2911,0,3432,15,1
3361377,1034184,4841,1,761793,0,766634,1,1
607449,2896906,380,1193,19369,7172,19749,8365,1
285124,3381479,135,174,4250,0,4385,174,1
1102748,3296089,555,58,6504,0,7059,58,1
3836080,3873974,1197,73,59457,0,60654,73,1
6618,1341260,892,171,68849,0,69741,171,1
2981537,517463,1252,3,118718,0,119970,3,1
2950326,388999,24,555,241,0,265,555,1
657592,925134,231,309,3222,0,3453,309,1
501914,517132,217,145,5217,0,5434,145,1
4647893,1519114,177,75,616,0,793,75,1
2827436,3978934,882,2,271525,0,272407,2,1
1276253,3632760,407,2,46534,0,46941,2,1
3271484,1913386,1507,32,34093,0,35600,32,1
3765475,3330682,873,31,107914,0,108787,31,1
1539837,3689889,1127,95,62979,0,64106,95,1
2516076,930890,1455,82,77782,0,79237,82,1
1424790,1241088,83,16,220,0,303,16,1
2075015,3294387,2664,15,85781,0,88445,15,1
1839529,3533195,88,447,1985,0,2073,447,1
3361377,210654,4841,1,761793,0,766634,1,1
932720,2169373,1411,55,111323,0,112734,55,1
1937293,4588338,434,241,16761,0,17195,241,1
3638272,275236,2022,2,370904,0,372926,2,1
1654099,3925352,1180,9,26347,0,27527,9,1
3073465,2405714,80,1,1013,0,1093,1,1
302204,2089328,366,134,3449,0,3815,134,1
1022123,3574192,126,10,8212,0,8338,10,1
4503709,2582957,78,8,1054,0,1132,8,1
3115867,1429846,1350,4,61232,0,62582,4,1
3701625,2160385,86,42,2327,0,2413,42,1
2018499,1659116,141,59,1786,0,1927,59,1
1787075,3449287,894,96,28305,0,29199,96,1
4853234,988645,1256,3,29554,0,30810,3,1
4564510,1808666,141,46,1907,0,2048,46,1
3167388,3041000,203,437,9760,0,9963,437,1
2253326,2238717,27,4,554,0,581,4,1
4475243,1678425,24,318,249,0,273,318,1
3298299,993935,181,68,4843,0,5024,68,1
2853969,607526,1051,1,42591,0,43642,1,1
4258870,3977826,336,113,4963,0,5299,113,1
2883055,218670,286,1,13198,0,13484,1,1
3718020,442984,305,76,6132,0,6437,76,1
1249227,615361,621,25,7423,0,8044,25,1
793511,3493442,447,56,3807,0,4254,56,1
1494665,1771725,668,61,37638,0,38306,61,1
4011264,384433,1360,41,116777,0,118137,41,1
3019092,3215101,108,188,8595,0,8703,188,1
1787075,1215626,894,74,28305,921,29199,995,1
1234540,3745592,1071,127,75251,0,76322,127,1
3280389,3186009,1101,4,411419,0,412520,4,1
1331940,204940,802,23,32617,0,33419,23,1
307250,2489604,919,2,35588,0,36507,2,1
1927211,3883154,1668,14,113322,0,114990,14,1
4801471,3984914,585,322,17979,0,18564,322,1
4183784,1399016,931,315,59894,0,60825,315,1
4801471,3207682,585,466,17979,0,18564,466,1
2981537,1507100,1252,2,118718,0,119970,2,1
1637447,3357339,555,8,8549,0,9104,8,1
4348977,1242974,55,10,1054,0,1109,10,1
169008,3268950,25,114,394,0,419,114,1
768957,1073546,202,321,7986,0,8188,321,1
3115867,4440723,1350,29,61232,0,62582,29,1
4727207,2680817,925,3,84581,0,85506,3,1
3509903,2185924,1530,3,509445,0,510975,3,1
1887669,2298832,733,45,23145,0,23878,45,1
3449530,683924,717,40,73648,0,74365,40,1
1889641,3781390,33,2,1381,0,1414,2,1
1310800,586789,200,20,6100,0,6300,20,1
3638272,361006,2022,1,370904,0,372926,1,1
4648695,701729,145,28,625,0,770,28,1
439557,4625488,2090,8,61744,0,63834,8,1
2057864,3883211,307,56,3995,0,4302,56,1
532681,4793248,433,66,35023,0,35456,66,1
3361377,1020749,4841,5,761793,0,766634,5,1
3561502,3300067,1144,375,68800,0,69944,375,1
2498087,3304650,1630,340,32582,0,34212,340,1
708290,3605072,317,3,5975,0,6292,3,1
1609659,1007768,523,60,29763,0,30286,60,1
932720,4425726,1411,44,111323,0,112734,44,1
2106653,1236632,100,1,2586,0,2686,1,1
2893334,2842698,889,75,30148,0,31037,75,1
2502456,405540,719,8,50725,0,51444,8,1
4267908,2397221,71,3,376,0,447,3,1
1927211,2751815,1668,217,113322,0,114990,217,1
2345899,2147505,346,45,1736,128,2082,173,1
2374539,804664,92,138,3805,0,3897,138,1
4140279,1701882,337,1,49384,0,49721,1,1
2542968,371647,444,23,4728,0,5172,23,1
4191410,4406574,1590,99,96434,0,98024,99,1
2128775,2571075,114,9,570,0,684,9,1
1531734,392873,13,2,166,0,179,2,1
688253,2363473,57,1,624,0,681,1,1
4360960,2050544,1642,91,110084,0,111726,91,1
1580988,3461182,2821,3,400133,0,402954,3,1
3866441,3175671,261,36,3655,0,3916,36,1
2872979,3816363,341,12,28510,0,28851,12,1
1927211,4350807,1668,118,113322,0,114990,118,1
946775,4263202,110,3,1072,0,1182,3,1
592541,2823510,132,6,6913,0,7045,6,1
3764177,1096833,1036,27,64563,0,65599,27,1
1436216,1653748,1068,13,68770,0,69838,13,1
3509903,4545542,1530,1,509445,0,510975,1,1
3765475,3531817,873,2,107914,0,108787,2,1
3736196,1213130,159,379,1349,0,1508,379,1
1817799,1785931,402,4,15932,0,16334,4,1
104054,1136290,1,6,30,71,31,77,1
4744679,3422016,247,71,3462,0,3709,71,1
4817410,2805686,31,3,1422,0,1453,3,1
1436216,3469899,1068,16,68770,0,69838,16,1
2723171,3852825,99,112,3999,0,4098,112,1
978341,2690212,604,89,10065,0,10669,89,1
3280389,240959,1101,37,411419,0,412520,37,1
3638272,2251681,2022,4,370904,0,372926,4,1
1127093,2207307,554,252,6014,0,6568,252,1
1807330,4072534,62,5,1136,0,1198,5,1
3235479,3032095,999,43,66486,0,67485,43,1
2772113,973480,792,149,42907,0,43699,149,1
4330391,648898,773,64,32759,0,33532,64,1
25593,1209329,1914,125,502,470,2416,595,1
3065808,2619339,1235,5,82317,0,83552,5,1
2294081,1821035,817,1794,163,60,980,1854,1
3043117,440778,130,23,2809,0,2939,23,1
1331940,1705425,802,248,32617,6280,33419,6528,1
3361377,3251381,4841,131,761793,0,766634,131,1
3509903,1252715,1530,1,509445,0,510975,1,1
3765475,3668824,873,4,107914,0,108787,4,1
3262988,4831734,39,1,846,0,885,1,1
4751453,512541,520,79,27570,0,28090,79,1
92352,3144777,1138,28,20575,0,21713,28,1
3249379,3874407,24,503,524,62,548,565,1
3280389,4065462,1101,2,411419,0,412520,2,1
2985909,3740998,706,47,43348,0,44054,47,1
2827436,2566227,882,39,271525,0,272407,39,1
2886626,2078863,192,128,6077,0,6269,128,1
3509903,2540417,1530,2,509445,0,510975,2,1
3361377,3965544,4841,2,761793,0,766634,2,1
4181760,2074921,359,81,7855,0,8214,81,1
4060074,3719916,178,331,7305,0,7483,331,1
1580988,246059,2821,2,400133,0,402954,2,1
1839283,2003649,765,9,36658,0,37423,9,1
1927780,1493677,420,61,6230,0,6650,61,1
1140134,189423,311,76,11111,0,11422,76,1
1938367,202336,17,2,331,0,348,2,1
1913445,966496,564,56,47943,0,48507,56,1
4295952,663434,808,24,57369,0,58177,24,1
3280389,1408533,1101,1,411419,0,412520,1,1
2257903,72772,142,17,701,0,843,17,1
2519890,3790942,66,1,312,0,378,1,1
1817799,59018,402,5,15932,0,16334,5,1
1697778,1558253,125,35,3760,0,3885,35,1
1187551,2127314,96,790,274,28,370,818,1
1055882,329862,10,9,257,0,267,9,1
4330391,298052,773,18,32759,0,33532,18,1
3638272,3967707,2022,1,370904,0,372926,1,1
1852309,4401332,39,82,197,153,236,235,1
3641600,2809045,751,234,9269,0,10020,234,1
4330391,2961630,773,3,32759,0,33532,3,1
1659017,1273363,817,29,13055,0,13872,29,1
333887,1799709,15,1,3610,0,3625,1,1
1187669,2063746,158,408,514,2642,672,3050,1
94742,1087655,264,451,1526,3037,1790,3488,1
2420758,1444207,17,6,1942,0,1959,6,1
3137585,3532493,1196,2,77354,0,78550,2,1
3438576,4293038,3424,60,137753,0,141177,60,1
4727207,1890212,925,1,84581,0,85506,1,1
2347636,2704740,237,24,408,0,645,24,1
161276,1558896,146,19,6548,0,6694,19,1
4645107,975409,8,3,113,0,121,3,1
3632293,4115048,570,1,21294,0,21864,1,1
3509903,3363496,1530,2,509445,0,510975,2,1
4528103,4097747,268,35,14258,0,14526,35,1
3598710,4338741,62,284,1896,0,1958,284,1
3954325,2978392,1743,1,16616,0,18359,1,1
2853969,1882493,1051,27,42591,0,43642,27,1
2922412,2097685,464,933,3629,0,4093,933,1
2107861,3581885,535,2,25743,0,26278,2,1
2569758,4003106,97,100,1649,0,1746,100,1
1807467,3611021,208,120,2442,0,2650,120,1
1428477,1786935,255,25,15459,0,15714,25,1
4689808,3188762,280,90,14220,0,14500,90,1
3163452,107767,84,2,297,0,381,2,1
3638272,641039,2022,1,370904,0,372926,1,1
3411803,967380,157,19,1023,0,1180,19,1
2314038,2274647,456,48,16347,0,16803,48,1
530200,1346110,2035,3,62809,0,64844,3,1
3266897,793588,346,46,1335,0,1681,46,1
3674250,1085869,155,15,2204,0,2359,15,1
3913751,4208653,229,1820,5248,21104,5477,22924,1
2260014,682062,2466,31,98622,0,101088,31,1
2147720,1194111,1608,172,78786,0,80394,172,1
2893334,3575169,889,317,30148,0,31037,317,1
3561502,2393289,1144,48,68800,0,69944,48,1
860473,1594907,751,301,20450,1458,21201,1759,1
1659017,1726780,817,54,13055,0,13872,54,1
3280389,2114545,1101,1,411419,0,412520,1,1
3137585,1868099,1196,66,77354,0,78550,66,1
1139873,188457,670,40,10236,0,10906,40,1
276216,2062071,312,18,12600,0,12912,18,1
4838376,1790335,606,62,26838,0,27444,62,1
800280,3559385,31,241,265,601,296,842,1
541565,788215,69,38,249,0,318,38,1
2981537,2706256,1252,56,118718,0,119970,56,1
3280389,3232097,1101,1,411419,0,412520,1,1
2772113,2209723,792,22,42907,0,43699,22,1
646587,4190256,122,37,5819,0,5941,37,1
1216656,3076108,244,15,798,0,1042,15,1
653120,2481486,27,7,49,0,76,7,1
4374509,1912031,770,226,9940,2674,10710,2900,1
2827436,4058379,882,4,271525,0,272407,4,1
60980,603643,649,16,20708,0,21357,16,1
4505464,2830555,99,2,2637,0,2736,2,1
4295952,2355488,808,154,57369,1905,58177,2059,1
3559552,4295255,145,14,2863,0,3008,14,1
363750,4855453,1001,55,10994,0,11995,55,1
1506065,3202975,136,42,3968,0,4104,42,1
2623062,2834960,247,5,2203,0,2450,5,1
4451491,3159961,817,362,8836,0,9653,362,1
517497,2097685,117,933,2068,0,2185,933,1
532681,1193358,433,220,35023,0,35456,220,1
3986468,1415424,111,9,3703,0,3814,9,1
451191,2161778,132,231,1659,0,1791,231,1
1919568,2119080,930,79,967,0,1897,79,1
1678122,3751222,2,306,16,0,18,306,1
593740,1917356,1107,84,62807,0,63914,84,1
4512801,159533,19,5,70,0,89,5,1
2808747,4530205,635,67,847,0,1482,67,1
3065808,4821687,1235,5,82317,0,83552,5,1
530200,2922576,2035,89,62809,0,64844,89,1
3561502,2932365,1144,82,68800,0,69944,82,1
3257465,2834160,541,60,27614,0,28155,60,1
4151915,4420112,726,2,3886,0,4612,2,1
3992121,3220141,259,259,1314,3705,1573,3964,1
1311307,1594106,358,55,10864,0,11222,55,1
3765475,3812667,873,6,107914,0,108787,6,1
4192206,3875512,468,59,18229,0,18697,59,1
4838376,3008891,606,127,26838,0,27444,127,1
2267131,121011,205,87,2884,0,3089,87,1
3280389,518604,1101,3,411419,0,412520,3,1
2851109,1064744,450,1,98552,0,99002,1,1
1436174,834024,105,1,9512,0,9617,1,1
3513900,2046648,280,39,1809,152,2089,191,1
4319972,4816686,640,32,35279,0,35919,32,1
3764177,4785181,1036,38,64563,0,65599,38,1
3137585,680267,1196,61,77354,0,78550,61,1
4624595,533011,722,205,53368,0,54090,205,1
755739,3829210,1117,32,58043,0,59160,32,1
4604311,1443564,29,1,7472,0,7501,1,1
805360,1408494,1514,32,119306,0,120820,32,1
471706,809500,794,13,65616,0,66410,13,1
837553,4811488,1249,712,61665,0,62914,712,1
4761378,3514433,139,50,1284,0,1423,50,1
2691855,2340361,32,1,295,0,327,1,1
4011264,3000427,1360,35,116777,0,118137,35,1
4417253,152630,1130,176,68389,0,69519,176,1
401947,326526,367,118,7890,0,8257,118,1
978341,3994813,604,1092,10065,0,10669,1092,1
4191410,1587816,1590,34,96434,0,98024,34,1
4440160,250151,736,30,20522,0,21258,30,1
4330391,3579395,773,81,32759,0,33532,81,1
3509903,2475691,1530,1,509445,0,510975,1,1
2985909,165501,706,15,43348,0,44054,15,1
2147720,947024,1608,43,78786,0,80394,43,1
3629404,4038133,185,780,6681,0,6866,780,1
2827436,2045578,882,2,271525,0,272407,2,1
2514271,835264,387,10,19070,0,19457,10,1
3906136,1257106,387,44,41169,0,41556,44,1
1792987,2887240,97,1143,3867,118405,3964,119548,1
3632787,2404411,112,1841,1380,15,1492,1856,1
2498087,1756292,1630,640,32582,0,34212,640,1
765601,1135181,1485,22,101510,0,102995,22,1
298564,1217677,662,30,6261,0,6923,30,1
2346646,4375046,101,1,2267,0,2368,1,1
1170741,1532531,136,14,1381,0,1517,14,1
2379070,1535293,141,34,2560,0,2701,34,1
1092045,4427203,242,32,9359,0,9601,32,1
3638272,4174816,2022,2,370904,0,372926,2,1
4180995,3791101,219,902,4470,0,4689,902,1
1508894,924955,73,104,2758,0,2831,104,1
1242778,4579033,163,9,2297,0,2460,9,1
2482338,3504849,712,548,24222,0,24934,548,1
4106313,239056,161,2,3004,0,3165,2,1
774122,1239467,160,7,872,0,1032,7,1
1234540,3686434,1071,134,75251,0,76322,134,1
4827056,1267832,226,20,12578,0,12804,20,1
4423184,2422182,384,7,29809,0,30193,7,1
3845148,1339746,44,1,3928,0,3972,1,1
842615,46060,510,377,12316,0,12826,377,1
1056518,3826651,659,108,3945,341,4604,449,1
3802719,951430,91,8,3170,0,3261,8,1
1336304,452496,44,39,1996,0,2040,39,1
6618,4557626,892,18,68849,0,69741,18,1
180517,657876,118,62,4246,0,4364,62,1
3336522,2222207,36,2,2235,0,2271,2,1
3509903,4244199,1530,39,509445,0,510975,39,1
3441019,915390,68,1345,628,5262,696,6607,1
1907524,720996,39,18,651,0,690,18,1
4183784,1185661,931,117,59894,0,60825,117,1
2994391,1497729,315,437,6520,0,6835,437,1
837553,3594818,1249,81,61665,1945,62914,2026,1
2107861,392077,535,1,25743,0,26278,1,1
670296,2441425,632,803,10586,18561,11218,19364,1
354904,72965,3193,46,105780,0,108973,46,1
2488965,2668528,153,164,922,0,1075,164,1
3257465,3801217,541,43,27614,0,28155,43,1
2655966,2006850,81,51,2804,0,2885,51,1
4730895,2289338,125,115,1911,0,2036,115,1
2092706,1785162,47,710,390,50,437,760,1
1196844,535610,548,6,36289,0,36837,6,1
2662809,3070455,303,16,10704,0,11007,16,1
4345608,1280329,234,35,2526,0,2760,35,1
2122741,3520434,190,61,6085,0,6275,61,1
3638272,4160842,2022,4,370904,0,372926,4,1
281939,2849710,80,92,2031,0,2111,92,1
3280389,2266264,1101,1,411419,0,412520,1,1
1400713,3131304,51,77,423,1490,474,1567,1
307250,3957076,919,2,35588,0,36507,2,1
2827436,4410771,882,1,271525,0,272407,1,1
1301815,4662825,752,58,48944,0,49696,58,1
2906327,1990440,61,242,324,0,385,242,1
3361377,3553195,4841,1,761793,0,766634,1,1
3844858,4356866,1591,28,28974,0,30565,28,1
2702724,2731444,566,50,10448,0,11014,50,1
1436216,4246048,1068,6,68770,0,69838,6,1
954784,4316043,567,8,14450,0,15017,8,1
544337,776089,35,361,1987,40,2022,401,1
3454888,3660209,162,304,7886,0,8048,304,1
3936039,201746,799,78,23884,0,24683,78,1
443309,2521840,100,2,1783,0,1883,2,1
1879936,1861455,281,12,6786,0,7067,12,1
3849054,3308090,417,45,13259,0,13676,45,1
1580988,3267891,2821,1,400133,0,402954,1,1
2208689,669384,298,35,4017,0,4315,35,1
2274892,4273450,24,28,579,0,603,28,1
4401835,4456001,204,7,1738,0,1942,7,1
4209323,1774327,1630,44,89460,0,91090,44,1
1534362,2961165,1531,15,105859,0,107390,15,1
4238001,1112144,869,10,61161,0,62030,10,1
1580988,2034968,2821,1,400133,0,402954,1,1
2502278,2936462,9,1,234,0,243,1,1
3971661,3991124,148,82,529,212,677,294,1
427805,2765305,483,5,156906,0,157389,5,1
3506871,1679253,43,126,320,0,363,126,1
1603899,2205170,497,229,5551,0,6048,229,1
2981537,1186473,1252,27,118718,0,119970,27,1
536759,3151754,13,46,97,0,110,46,1
1580988,2096411,2821,2,400133,0,402954,2,1
3137585,1948708,1196,100,77354,0,78550,100,1
4746749,3910786,283,356,3968,0,4251,356,1
2753499,501864,205,27,293,0,498,27,1
3734245,3300614,915,95,34965,0,35880,95,1
765601,1432547,1485,36,101510,0,102995,36,1
2998026,3863363,919,1,24182,0,25101,1,1
3280389,2072197,1101,1,411419,0,412520,1,1
4475727,1075869,41,4,220,0,261,4,1
1103332,4593330,732,203,59415,8083,60147,8286,1
3115867,3152361,1350,34,61232,0,62582,34,1
1929410,3106999,71,91,824,0,895,91,1
3361377,1776907,4841,1,761793,0,766634,1,1
302379,317532,10,9,24,0,34,9,1
3509903,4831256,1530,78,509445,0,510975,78,1
1497278,1181963,1869,113,35111,0,36980,113,1
4451491,991066,817,65,8836,0,9653,65,1
3361377,1580335,4841,2,761793,0,766634,2,1
2075015,2833032,2664,127,85781,0,88445,127,1
768957,298625,202,89,7986,0,8188,89,1
1086912,112642,907,7,33396,0,34303,7,1
2994391,1836679,315,16,6520,0,6835,16,1
4710065,1670553,41,55,225,0,266,55,1
4417253,2996767,1130,169,68389,0,69519,169,1
4423184,2291275,384,34,29809,0,30193,34,1
1559783,4492264,204,179,1917,0,2121,179,1
1635215,663733,209,219,8253,0,8462,219,1
1533314,2624616,361,198,6007,0,6368,198,1
1533546,1803403,703,20,22095,0,22798,20,1
3361377,2024942,4841,2,761793,0,766634,2,1
501914,1177592,217,60,5217,0,5434,60,1
1103332,2130267,732,157,59415,0,60147,157,1
1844632,4693970,31,32,125,0,156,32,1
1677231,4006290,97,6,572,0,669,6,1
55855,4077117,245,376,5888,0,6133,376,1
425493,1786431,21,2,1128,0,1149,2,1
4209323,48388,1630,55,89460,0,91090,55,1
1580988,1160677,2821,43,400133,0,402954,43,1
3280389,4239683,1101,3,411419,0,412520,3,1
4319287,2993856,271,33,1522,0,1793,33,1
842476,203375,898,29,12479,0,13377,29,1
3361377,1845062,4841,24,761793,0,766634,24,1
4738916,3767706,1165,4,34124,0,35289,4,1
3361377,3526029,4841,2,761793,0,766634,2,1
3906136,3768360,387,11,41169,0,41556,11,1
1639434,3525700,587,156,8053,0,8640,156,1
2502456,4172520,719,35,50725,0,51444,35,1
2785182,3208636,55,79,231,0,286,79,1
4077562,3805038,433,51,2723,0,3156,51,1
3633019,1160499,746,186,32317,816,33063,1002,1
2468096,1329297,110,19,687,0,797,19,1
2713411,3818814,384,12,4637,0,5021,12,1
427805,4196867,483,43,156906,0,157389,43,1
3088102,698440,130,1,1091,0,1221,1,1
1580988,1919316,2821,2,400133,0,402954,2,1
3914135,1845748,2152,62,60084,0,62236,62,1
4022062,636687,157,32,3780,0,3937,32,1
1875,965044,656,1,61388,0,62044,1,1
3280389,2292217,1101,3,411419,0,412520,3,1
2882956,3827078,30,27,341,0,371,27,1
2193513,3406002,100,8,1276,0,1376,8,1
752618,3867671,169,84,5929,0,6098,84,1
3361377,4724215,4841,2,761793,0,766634,2,1
805360,3130198,1514,76,119306,0,120820,76,1
3949475,3298164,18,1,89,0,107,1,1
3229735,665164,283,396,1354,12610,1637,13006,1
2887240,3369153,1143,1,118405,0,119548,1,1
1741347,1856716,106,1,1850,0,1956,1,1
1321779,2132706,320,29,2517,0,2837,29,1
1580988,100222,2821,2,400133,0,402954,2,1
1652056,2194939,326,15,66845,0,67171,15,1
4180995,2419976,219,10,4470,0,4689,10,1
907654,520840,798,68,24575,0,25373,68,1
2894019,2127755,93,68,349,0,442,68,1
2263130,926657,712,15,14043,0,14755,15,1
427805,3134937,483,2,156906,0,157389,2,1
2961801,14404,1483,44,101962,0,103445,44,1
4272102,4159099,1608,30,104171,0,105779,30,1
3003950,4037452,127,110,2904,0,3031,110,1
4801471,1436750,585,6,17979,0,18564,6,1
2827436,3916531,882,2,271525,0,272407,2,1
4723320,3673267,250,124,915,249,1165,373,1
140459,1892599,114,30,945,0,1059,30,1
2772113,3637952,792,234,42907,0,43699,234,1
4768755,4189654,259,256,1579,927,1838,1183,1
2745433,2534638,36,1,1914,0,1950,1,1
3509903,3826539,1530,2,509445,0,510975,2,1
3361380,730834,342,21,2750,0,3092,21,1
755739,4008325,1117,4,58043,0,59160,4,1
1580988,4214608,2821,1,400133,0,402954,1,1
515290,1769327,285,32,34080,0,34365,32,1
4689808,4097075,280,6,14220,0,14500,6,1
3926490,1451320,132,62,1187,0,1319,62,1
2758517,3094136,48,26,1829,0,1877,26,1
4479581,4736301,601,49,19545,0,20146,49,1
1406120,3502068,109,378,817,2133,926,2511,1
2950311,3339912,807,143,85116,0,85923,143,1
1927974,4221230,107,113,9317,0,9424,113,1
3082104,571108,47,1,4343,0,4390,1,1
2988634,2446041,53,59,269,89,322,148,1
777257,4859653,93,4,1559,0,1652,4,1
3638272,2998338,2022,71,370904,0,372926,71,1
3115867,1622856,1350,9,61232,0,62582,9,1
4157321,191070,146,452,181,0,327,452,1
3280389,477162,1101,2,411419,0,412520,2,1
3361377,2592795,4841,2,761793,0,766634,2,1
3638272,4642430,2022,2,370904,0,372926,2,1
621115,2835882,66,1,6250,0,6316,1,1
805360,3972852,1514,125,119306,0,120820,125,1
2763877,4238451,77,1643,436,54,513,1697,1
2075015,3291181,2664,27,85781,0,88445,27,1
4077796,4582129,237,1231,301,10356,538,11587,1
3835618,416055,694,179,25433,0,26127,179,1
2793437,3412814,582,1,25447,0,26029,1,1
1875,2658621,656,65,61388,0,62044,65,1
4313572,3010032,930,24,16971,0,17901,24,1
2189067,633734,356,2,6408,0,6764,2,1
3114565,2116390,12,34,636,0,648,34,1
3294702,1848053,991,114,68888,0,69879,114,1
4656285,2487647,1446,25,35428,0,36874,25,1
1301815,4554775,752,34,48944,0,49696,34,1
907654,1105631,798,27,24575,0,25373,27,1
3361377,2053060,4841,2,761793,0,766634,2,1
4089181,633148,76,13,2696,0,2772,13,1
1521082,1302785,766,450,6562,0,7328,450,1
4656285,1735116,1446,503,35428,16146,36874,16649,1
458450,2931161,86,10,235,0,321,10,1
1567618,3710077,34,536,736,0,770,536,1
439557,3490278,2090,2,61744,0,63834,2,1
932720,2632829,1411,40,111323,0,112734,40,1
1927974,3859771,107,135,9317,0,9424,135,1
3517811,741429,60,1,11929,0,11989,1,1
4022062,4518111,157,98,3780,0,3937,98,1
1913445,1685122,564,9,47943,0,48507,9,1
393185,990035,591,84,7719,0,8310,84,1
427805,1677348,483,2,156906,0,157389,2,1
3509903,666090,1530,2,509445,0,510975,2,1
1103332,923659,732,36,59415,0,60147,36,1
3361377,2296838,4841,1,761793,0,766634,1,1
250102,2212074,189,54,4350,0,4539,54,1
4297315,1756726,195,3,7446,0,7641,3,1
1601507,2726926,129,3,6006,0,6135,3,1
3298300,564094,128,140,4498,0,4626,140,1
3638272,2475708,2022,47,370904,0,372926,47,1
3438895,3720283,235,50,486,257,721,307,1
607449,2765109,380,57,19369,0,19749,57,1
3824547,291761,1075,11,14337,0,15412,11,1
932720,1464582,1411,73,111323,0,112734,73,1
687713,575355,436,3,47160,0,47596,3,1
519175,1272389,173,52,7221,0,7394,52,1
4053059,3438576,74,3424,831,137753,905,141177,1
4451122,1012400,985,41,41669,0,42654,41,1
2961552,1771658,562,93,16546,0,17108,93,1
4318206,3323123,251,59,13123,0,13374,59,1
1234540,4694028,1071,59,75251,0,76322,59,1
3509903,1964412,1530,2,509445,0,510975,2,1
97028,1645263,619,84,8923,0,9542,84,1
2893334,3914018,889,13,30148,0,31037,13,1
3361377,488847,4841,2,761793,0,766634,2,1
3906136,4696712,387,10,41169,0,41556,10,1
3137585,4133268,1196,101,77354,0,78550,101,1
3764177,1958658,1036,50,64563,0,65599,50,1
3849054,1600222,417,19,13259,0,13676,19,1
1809440,4539073,48,1,1745,0,1793,1,1
1580988,3441073,2821,223,400133,0,402954,223,1
3935241,668364,12,551,273,76,285,627,1
1103332,551275,732,106,59415,0,60147,106,1
612025,2801578,203,34,3465,0,3668,34,1
1580988,3380350,2821,1,400133,0,402954,1,1
3157597,3679825,183,1,10247,0,10430,1,1
3438576,3443743,3424,15,137753,0,141177,15,1
3658381,3450448,238,81,1530,1892,1768,1973,1
1580988,2856958,2821,2,400133,0,402954,2,1
712607,2543102,29,1,1749,0,1778,1,1
2793437,1257474,582,4,25447,0,26029,4,1
2374539,3055218,92,94,3805,0,3897,94,1
1722972,1095695,235,4,3572,0,3807,4,1
4236325,630220,372,594,6103,2886,6475,3480,1
2106678,3570227,97,4,847,0,944,4,1
2981537,454332,1252,4,118718,0,119970,4,1
1022123,3832282,126,21,8212,0,8338,21,1
3835618,4790157,694,131,25433,0,26127,131,1
4361636,1842123,186,70,1867,0,2053,70,1
1764733,489654,23,4,249,0,272,4,1
2792349,4508738,25,9,1232,0,1257,9,1
4272102,80566,1608,59,104171,0,105779,59,1
3280389,1537076,1101,1,411419,0,412520,1,1
47194,1774584,148,2,4662,0,4810,2,1
471706,2984815,794,8,65616,0,66410,8,1
866357,2379331,825,136,18479,0,19304,136,1
1852553,2141874,68,5,1324,0,1392,5,1
360874,404100,124,171,4585,0,4709,171,1
1789632,271364,46,1541,2029,171,2075,1712,1
3569179,3007404,1064,3,40015,0,41079,3,1
2347608,4308480,138,9,1313,0,1451,9,1
1234540,113305,1071,130,75251,0,76322,130,1
1681576,829466,16,536,400,0,416,536,1
2339149,1888388,97,120,4258,0,4355,120,1
2702724,3474212,566,156,10448,0,11014,156,1
1159599,4252538,15,1,93,0,108,1,1
4258805,2649618,62,60,1527,0,1589,60,1
910231,3232895,155,11,2002,0,2157,11,1
2751572,1705899,481,20,44036,0,44517,20,1
4385783,134878,290,2,10995,0,11285,2,1
3645402,399138,153,19,7400,0,7553,19,1
3021570,2876499,22,51,64,49,86,100,1
4850593,4577474,169,98,4365,0,4534,98,1
1822719,3140571,285,238,22351,0,22636,238,1
2343253,4761331,1882,3,86401,0,88283,3,1
4653941,2573204,951,22,45883,0,46834,22,1
1580988,4099184,2821,1,400133,0,402954,1,1
3412172,3904615,227,5,2700,0,2927,5,1
805360,1159619,1514,60,119306,0,120820,60,1
1552745,4572935,151,9,1316,0,1467,9,1
2096270,3987039,970,2,26018,0,26988,2,1
1466231,2233149,408,140,3853,0,4261,140,1
595757,4668232,340,53,26738,0,27078,53,1
2895033,3271484,164,1507,2870,34093,3034,35600,1
4011264,1962033,1360,9,116777,0,118137,9,1
360598,1413670,68,39,1946,0,2014,39,1
4179343,1264801,119,78,9822,0,9941,78,1
2981537,2440531,1252,64,118718,0,119970,64,1
1179906,2568979,316,58,14467,0,14783,58,1
2851109,3909236,450,55,98552,0,99002,55,1
2962038,3774114,495,32,14236,0,14731,32,1
1638032,3972228,91,13,3942,0,4033,13,1
1927211,3555619,1668,22,113322,0,114990,22,1
2793423,1290234,122,26,1527,0,1649,26,1
3610598,4852752,380,33,17343,0,17723,33,1
3509903,4211981,1530,2,509445,0,510975,2,1
2343253,3608298,1882,3,86401,0,88283,3,1
1855999,649848,68,7,507,0,575,7,1
2210915,136101,325,134,1678,257,2003,391,1
3316576,1593851,669,13,7971,0,8640,13,1
1580988,761609,2821,1,400133,0,402954,1,1
4672319,877,483,258,9652,2455,10135,2713,1
3835978,3915057,45,35,143,0,188,35,1
1880135,1144094,810,18,71924,0,72734,18,1
1580988,3114335,2821,1,400133,0,402954,1,1
4272102,1906327,1608,22,104171,0,105779,22,1
2435388,1791876,50,17,408,0,458,17,1
1880135,4776488,810,54,71924,0,72734,54,1
2817817,4816549,11,70,147,0,158,70,1
2441425,3864431,803,179,18561,0,19364,179,1
1276253,4275046,407,1,46534,0,46941,1,1
3112136,2412209,406,1,41366,0,41772,1,1
1689502,1788068,63,2,3676,0,3739,2,1
441667,815786,198,9,14727,0,14925,9,1
1814709,508330,316,35,5746,0,6062,35,1
2998026,3050651,919,5,24182,0,25101,5,1
2791231,4797781,183,86,5221,0,5404,86,1
3638272,2421926,2022,1,370904,0,372926,1,1
3827240,3163290,356,27,7496,0,7852,27,1
974518,2942784,81,146,1365,0,1446,146,1
1960829,2223701,25,1,101,0,126,1,1
3836080,66074,1197,47,59457,0,60654,47,1
427805,686128,483,2,156906,0,157389,2,1
4233503,4006138,224,13,7867,0,8091,13,1
2093983,914880,119,122,1326,0,1445,122,1
26269,4336851,57,38,936,0,993,38,1
530200,4455753,2035,3,62809,0,64844,3,1
821089,180344,394,19,4820,0,5214,19,1
3147277,1563005,193,16,968,0,1161,16,1
4140712,2890514,106,37,235,0,341,37,1
386424,1159583,131,1,7871,0,8002,1,1
1575009,781497,429,11,37745,0,38174,11,1
3115867,479414,1350,132,61232,0,62582,132,1
2961801,4588856,1483,28,101962,0,103445,28,1
2851109,4684428,450,3,98552,0,99002,3,1
57574,2010598,289,231,4616,0,4905,231,1
3514277,1323718,1338,48,13269,0,14607,48,1
3509214,524322,263,473,14139,0,14402,473,1
1580988,4041721,2821,1,400133,0,402954,1,1
3449530,3353277,717,259,73648,0,74365,259,1
2405789,2151373,1010,38,93387,0,94397,38,1
3280389,1246741,1101,5,411419,0,412520,5,1
1705425,3044161,248,29,6280,0,6528,29,1
3235479,4240199,999,42,66486,0,67485,42,1
2613814,2453339,242,224,1818,0,2060,224,1
3742930,3165276,410,166,22242,0,22652,166,1
4479581,3921814,601,63,19545,0,20146,63,1
3906136,4520070,387,15,41169,0,41556,15,1
408965,1080364,903,91,38623,0,39526,91,1
4062175,1384578,248,149,8522,0,8770,149,1
3227850,3567824,191,405,641,0,832,405,1
3106700,4259949,157,315,1980,0,2137,315,1
3225310,3080152,320,102,10537,0,10857,102,1
3280389,2610984,1101,1,411419,0,412520,1,1
3128197,3671434,122,45,6176,0,6298,45,1
3214278,2004322,18,17,146,0,164,17,1
1580988,41231,2821,86,400133,0,402954,86,1
4073343,921470,88,21,285,0,373,21,1
2961801,3933915,1483,43,101962,0,103445,43,1
3125762,229603,254,39,8285,0,8539,39,1
2342664,1330326,1181,16,26502,0,27683,16,1
2981537,3552506,1252,1,118718,0,119970,1,1
2781817,1721406,704,13,24613,0,25317,13,1
4435816,2582491,262,6,8391,0,8653,6,1
550387,3312630,185,21,2453,0,2638,21,1
515290,470692,285,20,34080,0,34365,20,1
3513476,2128098,24,39,1746,0,1770,39,1
92352,3137170,1138,300,20575,0,21713,300,1
4191410,138542,1590,30,96434,0,98024,30,1
67454,2683334,515,173,5700,0,6215,173,1
2851109,2956153,450,2,98552,0,99002,2,1
6618,3641267,892,45,68849,0,69741,45,1
3379725,4586424,128,23,469,0,597,23,1
3361380,4382302,342,1,2750,0,3092,1,1
3906136,71167,387,88,41169,0,41556,88,1
3638272,1687283,2022,29,370904,0,372926,29,1
2202731,2740464,72,13,493,0,565,13,1
3071504,3498659,80,74,3797,0,3877,74,1
1539837,2623765,1127,91,62979,0,64106,91,1
611927,3586346,305,20,8695,0,9000,20,1
680662,4779921,365,73,5393,0,5758,73,1
502082,3942183,589,12,16428,0,17017,12,1
3509903,341698,1530,2,509445,0,510975,2,1
4815919,984671,367,17,3361,0,3728,17,1
2851109,2279259,450,4,98552,0,99002,4,1
4624595,4704493,722,73,53368,0,54090,73,1
1927211,2830942,1668,158,113322,0,114990,158,1
2265763,4210815,68,94,120,151,188,245,1
3257653,4050820,100,110,5222,0,5322,110,1
2261139,980468,2014,1,42851,0,44865,1,1
2446968,4102205,452,17,20110,0,20562,17,1
3987684,4173289,286,5,17372,0,17658,5,1
650944,3211105,3,32,344,0,347,32,1
1600857,2438834,324,6,10576,0,10900,6,1
628258,2224172,155,133,4650,0,4805,133,1
3280389,351668,1101,2,411419,0,412520,2,1
3672963,2858004,130,68,5192,0,5322,68,1
1564140,1865218,46,31,128,0,174,31,1
4417253,2444549,1130,67,68389,0,69519,67,1
3689183,4349341,5,24,249,1570,254,1594,1
1817799,582276,402,298,15932,10990,16334,11288,1
836594,4744679,194,247,1136,3462,1330,3709,1
2877907,2846458,508,477,16021,0,16529,477,1
2749438,3673605,114,26,1518,0,1632,26,1
3672238,3380250,518,148,12172,0,12690,148,1
2042569,2650412,358,931,1959,29038,2317,29969,1
2733969,1529738,143,7,372,0,515,7,1
1654099,646489,1180,93,26347,0,27527,93,1
1927211,1840956,1668,54,113322,0,114990,54,1
755739,249103,1117,98,58043,0,59160,98,1
1839283,2097245,765,19,36658,0,37423,19,1
3361377,2863968,4841,1,761793,0,766634,1,1
1250021,3632966,4637,114,85913,0,90550,114,1
805360,4315070,1514,22,119306,0,120820,22,1
841308,2101710,102,152,3967,6934,4069,7086,1
1839283,269935,765,43,36658,0,37423,43,1
209437,3603197,267,1,1876,0,2143,1,1
522588,1759376,496,1,20091,0,20587,1,1
4011264,3603072,1360,40,116777,0,118137,40,1
2711285,3750810,71,14,142,0,213,14,1
2668270,2342664,46,1181,117,26502,163,27683,1
1115885,951786,44,3,302,0,346,3,1
940526,2465296,475,9,20786,0,21261,9,1
3563811,787039,3,1,21,0,24,1,1
1875,3329146,656,3,61388,0,62044,3,1
1580988,2001109,2821,1,400133,0,402954,1,1
439557,4527688,2090,25,61744,0,63834,25,1
3361377,566192,4841,2,761793,0,766634,2,1
3058068,3528836,124,3,12734,0,12858,3,1
130129,4195756,38,13,442,0,480,13,1
940526,3814782,475,59,20786,0,21261,59,1
339563,1603899,1999,497,7561,5551,9560,6048,1
3278135,1249967,358,207,7252,11933,7610,12140,1
3671141,2039571,1444,41,48400,0,49844,41,1
3112136,4651877,406,38,41366,0,41772,38,1
2362241,4069991,324,385,7732,0,8056,385,1
3638272,2841702,2022,1,370904,0,372926,1,1
805360,976601,1514,21,119306,0,120820,21,1
4258870,3128158,336,183,4963,0,5299,183,1
3524438,4657367,51,8,2423,0,2474,8,1
765601,2387462,1485,43,101510,0,102995,43,1
2446968,3042168,452,36,20110,0,20562,36,1
3998060,738840,234,42,1827,0,2061,42,1
236630,146763,15,618,305,0,320,618,1
4761378,4073087,139,5,1284,0,1423,5,1
3840026,2700528,278,896,468,0,746,896,1
2853969,2753875,1051,74,42591,0,43642,74,1
3280389,1656766,1101,8,411419,0,412520,8,1
3509903,4185675,1530,3,509445,0,510975,3,1
1271928,2378406,101,21,137,0,238,21,1
3452706,1292588,245,208,2116,79,2361,287,1
1875,652657,656,4,61388,0,62044,4,1
932720,2468312,1411,116,111323,0,112734,116,1
2516076,4595882,1455,17,77782,0,79237,17,1
2348182,3041299,469,736,4747,0,5216,736,1
2655966,1702253,81,5,2804,0,2885,5,1
3509903,2767785,1530,1,509445,0,510975,1,1
3844858,4670242,1591,65,28974,0,30565,65,1
180517,2764243,118,284,4246,0,4364,284,1
4586549,1973595,68,86,497,0,565,86,1
419362,4101514,314,511,5584,1676,5898,2187,1
129567,1426174,65,42,932,0,997,42,1
3561502,1267562,1144,49,68800,0,69944,49,1
1471685,3820506,1681,31,25550,0,27231,31,1
4492248,2162405,237,6,17127,0,17364,6,1
4078514,3826626,12,1,1781,0,1793,1,1
2420758,4679313,17,2,1942,0,1959,2,1
1880135,2379326,810,3,71924,0,72734,3,1
354904,2683426,3193,3,105780,0,108973,3,1
2015479,4582297,232,5,740,0,972,5,1
4140279,997932,337,1,49384,0,49721,1,1
3638272,2670577,2022,1,370904,0,372926,1,1
2502456,3663979,719,37,50725,0,51444,37,1
3549558,38399,66,899,1155,0,1221,899,1
3765475,3944841,873,8,107914,0,108787,8,1
1580988,3186202,2821,5,400133,0,402954,5,1
2823179,1194621,505,94,6744,0,7249,94,1
687713,2670415,436,3,47160,0,47596,3,1
3140992,3268077,28,10,321,0,349,10,1
354904,1637592,3193,16,105780,0,108973,16,1
3225310,1453944,320,54,10537,0,10857,54,1
2881425,2363680,102,177,5272,0,5374,177,1
2096270,2095653,970,90,26018,0,26988,90,1
2906472,3316072,199,65,3865,0,4064,65,1
1588330,1275654,694,114,10280,0,10974,114,1
4727207,123518,925,6,84581,0,85506,6,1
2405789,3064620,1010,20,93387,0,94397,20,1
4798192,3770607,816,120,20426,0,21242,120,1
458350,2104523,242,2,1388,0,1630,2,1
1652056,228301,326,1,66845,0,67171,1,1
4485028,876252,445,340,14565,0,15010,340,1
2650412,1195317,931,50,29038,0,29969,50,1
1580988,2073715,2821,1,400133,0,402954,1,1
1301815,4254974,752,47,48944,0,49696,47,1
957197,1206621,614,8,37109,0,37723,8,1
3101239,2426529,125,58,1614,196,1739,254,1
873006,1893405,375,396,33630,0,34005,396,1
151693,3725752,436,132,12181,0,12617,132,1
1817799,4674249,402,82,15932,0,16334,82,1
3144238,2604385,326,237,28455,0,28781,237,1
4100923,14009,260,92,7743,0,8003,92,1
765601,1140813,1485,53,101510,0,102995,53,1
441667,4123758,198,216,14727,4336,14925,4552,1
2784961,1442838,221,82,3707,0,3928,82,1
2713411,2058204,384,4,4637,0,5021,4,1
378660,4228143,129,713,1225,0,1354,713,1
3361377,3259574,4841,2,761793,0,766634,2,1
2981537,1333150,1252,2,118718,0,119970,2,1
3509903,1212429,1530,3,509445,0,510975,3,1
4159765,1810302,23,27,1047,0,1070,27,1
2442398,2399369,66,71,185,857,251,928,1
1293807,1377546,1837,2,30865,0,32702,2,1
1914063,4543841,119,99,1809,0,1928,99,1
1212191,527918,58,7,218,0,276,7,1
283907,1713872,401,158,1992,0,2393,158,1
4353839,3168046,144,19,3320,0,3464,19,1
2887240,2129640,1143,1,118405,0,119548,1,1
544230,2347403,1532,59,60768,0,62300,59,1
3578463,4426570,240,44,4104,0,4344,44,1
1580988,2113656,2821,1,400133,0,402954,1,1
1534362,2052185,1531,20,105859,0,107390,20,1
326344,2728624,132,77,1123,0,1255,77,1
3468600,2467694,89,5,257,0,346,5,1
611781,4586016,110,285,1404,0,1514,285,1
3588630,2961482,351,2,7803,0,8154,2,1
1234540,3438801,1071,23,75251,0,76322,23,1
3338906,248368,140,291,6745,0,6885,291,1
1847461,2964,1211,6,51149,0,52360,6,1
837553,4634493,1249,90,61665,0,62914,90,1
3671141,2713284,1444,4,48400,0,49844,4,1
4789203,694343,355,2,11315,0,11670,2,1
3384159,3561502,415,1144,6659,68800,7074,69944,1
4011264,3919285,1360,42,116777,0,118137,42,1
3361377,3029534,4841,1,761793,0,766634,1,1
3676295,4445953,374,1,70881,0,71255,1,1
611781,3090713,110,14,1404,0,1514,14,1
414608,1195867,50,3,5531,0,5581,3,1
3361377,2222228,4841,1,761793,0,766634,1,1
2827436,1777619,882,3,271525,0,272407,3,1
2612638,3041221,125,9,347,0,472,9,1
3438576,4754539,3424,4,137753,0,141177,4,1
2148937,3829456,672,11,47361,0,48033,11,1
3361377,3373141,4841,5,761793,0,766634,5,1
4372962,3927547,53,26,771,0,824,26,1
3340239,439557,221,2090,922,61744,1143,63834,1
1534362,2532498,1531,54,105859,0,107390,54,1
4856623,313337,125,479,1815,0,1940,479,1
2260014,1754581,2466,7,98622,0,101088,7,1
2516076,1090500,1455,14,77782,0,79237,14,1
3392698,3920414,132,92,1402,0,1534,92,1
743326,2664044,38,18,569,0,607,18,1
402494,4197345,28,1,583,0,611,1,1
1292588,2568527,208,84,79,0,287,84,1
2985909,3685857,706,23,43348,0,44054,23,1
3361377,3483617,4841,1,761793,0,766634,1,1
354904,4636581,3193,545,105780,0,108973,545,1
1741497,139216,115,3,3909,0,4024,3,1
4013053,3354223,33,155,1781,0,1814,155,1
184734,2909660,68,49,1084,0,1152,49,1
4001849,2406215,176,461,1826,0,2002,461,1
1913445,58433,564,22,47943,0,48507,22,1
3685001,3321170,37,34,1779,0,1816,34,1
1134093,2331466,8,5,1000,0,1008,5,1
441667,4759720,198,47,14727,0,14925,47,1
2886330,3695666,415,138,10154,0,10569,138,1
3875080,903249,285,19,5153,0,5438,19,1
354904,2604267,3193,2,105780,0,108973,2,1
630220,4150880,594,125,2886,0,3480,125,1
2968963,126759,137,117,115,112,252,229,1
3361377,2909788,4841,13,761793,0,766634,13,1
687713,1067137,436,91,47160,0,47596,91,1
3367289,940008,553,16,765,0,1318,16,1
3167388,530389,203,153,9760,0,9963,153,1
1927211,2151386,1668,154,113322,0,114990,154,1
2851109,199600,450,98,98552,0,99002,98,1
919120,3027182,205,73,2831,0,3036,73,1
4006475,2160481,5,10,50,16,55,26,1
1293807,2419368,1837,60,30865,0,32702,60,1
165858,871149,177,69,1963,0,2140,69,1
155821,1835871,117,3,5678,0,5795,3,1
3361377,3739450,4841,1,761793,0,766634,1,1
2880930,1124578,60,51,558,332,618,383,1
3836080,4707631,1197,101,59457,0,60654,101,1
1924872,2461156,361,211,5715,0,6076,211,1
1652056,3612814,326,1,66845,0,67171,1,1
544230,4099861,1532,69,60768,0,62300,69,1
2827436,1053918,882,1,271525,0,272407,1,1
97450,3581845,165,360,1955,0,2120,360,1
4451491,4660761,817,130,8836,0,9653,130,1
4183784,327944,931,49,59894,0,60825,49,1
2464305,201249,107,323,1140,621,1247,944,1
1651260,4549907,321,7,2355,0,2676,7,1
3509903,4023329,1530,2,509445,0,510975,2,1
805360,1994048,1514,14,119306,0,120820,14,1
3633019,928265,746,47,32317,0,33063,47,1
4418645,2888232,176,2,169,0,345,2,1
3280389,1999943,1101,4,411419,0,412520,4,1
3845119,1805879,461,19,28609,0,29070,19,1
3023130,1488751,778,63,6402,0,7180,63,1
2050190,1286929,153,22,9156,0,9309,22,1
4192206,363196,468,113,18229,0,18697,113,1
1875,4162750,656,2,61388,0,62044,2,1
445996,3726675,1175,7,12828,0,14003,7,1
1503116,2918778,415,9,37079,0,37494,9,1
1301815,1999418,752,68,48944,0,49696,68,1
710313,1213507,101,107,696,115,797,222,1
3835618,3862134,694,27,25433,0,26127,27,1
2124547,4168036,56,10,839,0,895,10,1
354904,4816992,3193,120,105780,0,108973,120,1
4192206,4133331,468,175,18229,0,18697,175,1
870181,4702756,278,327,1377,2851,1655,3178,1
2702724,3095217,566,420,10448,0,11014,420,1
2281149,1656003,282,153,28082,0,28364,153,1
3189108,3982809,421,21,6767,0,7188,21,1
1196844,2113539,548,24,36289,0,36837,24,1
1225988,4636581,157,545,8881,0,9038,545,1
3449530,3451892,717,29,73648,0,74365,29,1
1697778,2911286,125,2,3760,0,3885,2,1
1847461,3748235,1211,10,51149,0,52360,10,1
1580988,1595375,2821,2,400133,0,402954,2,1
3361377,3079767,4841,1,761793,0,766634,1,1
3021112,3245547,472,50,6183,0,6655,50,1
4140279,3670305,337,23,49384,0,49721,23,1
3361377,4302069,4841,1,761793,0,766634,1,1
3995686,1196188,113,37,6154,0,6267,37,1
4080770,3968208,61,9,304,0,365,9,1
1588705,1524939,1000,120,11879,0,12879,120,1
708440,2994839,302,239,9329,0,9631,239,1
3638272,231099,2022,3,370904,0,372926,3,1
4397923,2471493,16,227,1228,0,1244,227,1
3280389,2857888,1101,2,411419,0,412520,2,1
1533314,3355185,361,36,6007,0,6368,36,1
3294702,283386,991,36,68888,0,69879,36,1
4642569,1921579,872,37,27586,0,28458,37,1
2272410,3199161,8,1,124,0,132,1,1
34273,747408,18,455,213,0,231,455,1
4149765,3695814,210,46,1961,0,2171,46,1
2109919,1381342,46,2,5772,0,5818,2,1
3765475,3782938,873,13,107914,0,108787,13,1
429195,352729,28,107,301,292,329,399,1
25593,3230634,1914,101,502,0,2416,101,1
3875157,651246,17,1,265,0,282,1,1
544230,1857745,1532,70,60768,0,62300,70,1
3509903,1693018,1530,26,509445,0,510975,26,1
1580988,2961208,2821,1,400133,0,402954,1,1
1302093,1137705,48,87,1219,0,1267,87,1
4360960,4732576,1642,7,110084,0,111726,7,1
6618,2469271,892,18,68849,0,69741,18,1
4493879,2743250,13,358,128,487,141,845,1
3722259,793550,284,6,1227,0,1511,6,1
333887,2599517,15,1,3610,0,3625,1,1
3765475,4251171,873,4,107914,0,108787,4,1
1466231,307456,408,132,3853,0,4261,132,1
4191727,4156742,463,104,26315,0,26778,104,1
4653941,4246830,951,65,45883,0,46834,65,1
3187565,3752436,97,113,4164,0,4261,113,1
422275,1530730,101,104,4142,0,4243,104,1
4512426,4189780,127,64,204,454,331,518,1
4408344,4292710,8,120,1042,0,1050,120,1
2343253,1279082,1882,2,86401,0,88283,2,1
2147720,4331230,1608,34,78786,0,80394,34,1
765601,817772,1485,15,101510,0,102995,15,1
1392958,2015479,91,232,241,740,332,972,1
4792065,3866209,81,449,162,2902,243,3351,1
3742930,3251624,410,810,22242,0,22652,810,1
4365751,1219267,133,238,549,1605,682,1843,1
4054733,1464228,217,1,1907,0,2124,1,1
2989372,2862597,88,2,684,0,772,2,1
976723,2956248,173,346,564,6702,737,7048,1
957197,2185205,614,1,37109,0,37723,1,1
748019,1943314,675,509,18480,0,19155,509,1
3676295,505247,374,2,70881,0,71255,2,1
2034451,4103612,32,932,90,5655,122,6587,1
3906136,4488187,387,36,41169,0,41556,36,1
2569009,2036626,424,23,13423,0,13847,23,1
3291396,4356499,195,14,11502,0,11697,14,1
1113613,2860172,94,7,3597,0,3691,7,1
2276175,4630770,262,78,4860,0,5122,78,1
1341178,3109250,899,10,16829,0,17728,10,1
3844858,1266471,1591,102,28974,0,30565,102,1
532681,4699465,433,70,35023,0,35456,70,1
1081925,4078755,14,239,55,833,69,1072,1
3638272,4850465,2022,2,370904,0,372926,2,1
4219479,2961723,158,72,4945,0,5103,72,1
3025154,2164178,183,574,1843,6134,2026,6708,1
4333770,3747062,100,101,4077,0,4177,101,1
1276253,1357091,407,1,46534,0,46941,1,1
3509903,3276422,1530,1,509445,0,510975,1,1
3873768,467366,449,446,35424,0,35873,446,1
4751453,590014,520,13,27570,0,28090,13,1
1276253,4166447,407,1,46534,0,46941,1,1
925252,246567,103,137,4005,0,4108,137,1
164044,1176871,31,1,390,0,421,1,1
4023687,3631059,69,63,7295,0,7364,63,1
18228,950184,122,94,3947,0,4069,94,1
3438576,223831,3424,1,137753,0,141177,1,1
832576,3987344,127,80,356,0,483,80,1
2122623,3686310,64,132,328,662,392,794,1
1580508,3961607,720,1,19611,0,20331,1,1
1966548,2833572,208,2,53149,0,53357,2,1
13190,1661296,38,15,271,0,309,15,1
1301815,4290423,752,54,48944,0,49696,54,1
2343253,1371828,1882,2,86401,0,88283,2,1
3408985,4853925,205,15,6002,0,6207,15,1
4289995,4351280,525,112,4959,0,5484,112,1
2887240,1384078,1143,53,118405,0,119548,53,1
4154740,697452,68,357,1352,0,1420,357,1
4295952,4865082,808,40,57369,0,58177,40,1
3361377,568421,4841,1,761793,0,766634,1,1
2751572,2099053,481,75,44036,0,44517,75,1
3560934,344850,28,2,1889,0,1917,2,1
3509214,2169456,263,3,14139,0,14402,3,1
3112136,240990,406,87,41366,0,41772,87,1
3509903,91307,1530,2,509445,0,510975,2,1
4040467,3674913,206,22,2565,0,2771,22,1
439557,1956791,2090,48,61744,0,63834,48,1
1196844,859746,548,108,36289,0,36837,108,1
2057864,4578387,307,37,3995,122,4302,159,1
1542757,1207696,283,206,5996,0,6279,206,1
1341178,242576,899,378,16829,0,17728,378,1
4751453,1658728,520,7,27570,0,28090,7,1
1615261,2817236,955,24,12715,0,13670,24,1
1301815,4391221,752,66,48944,0,49696,66,1
2522799,4840053,253,5,3062,0,3315,5,1
3280389,2086396,1101,2,411419,0,412520,2,1
1249227,1680545,621,181,7423,0,8044,181,1
2571842,3859644,147,31,896,0,1043,31,1
1508894,1741980,73,107,2758,0,2831,107,1
392709,2039500,93,25,565,0,658,25,1
3638272,2892699,2022,6,370904,0,372926,6,1
3668051,830306,89,148,3044,0,3133,148,1
1880135,4084526,810,52,71924,0,72734,52,1
2203506,3995571,134,13,2432,0,2566,13,1
3118804,48216,315,27,6025,0,6340,27,1
3010933,3750582,121,183,652,393,773,576,1
3936039,374340,799,2,23884,0,24683,2,1
1539837,927314,1127,69,62979,0,64106,69,1
2108878,4592122,78,1748,4399,8,4477,1756,1
2884705,1594106,649,55,10233,0,10882,55,1
530200,4026325,2035,55,62809,0,64844,55,1
3248738,1736054,102,21,4433,0,4535,21,1
3509903,1355171,1530,1,509445,0,510975,1,1
1534362,2594671,1531,17,105859,0,107390,17,1
3094886,3824547,675,1075,6621,14337,7296,15412,1
3509903,1348843,1530,2,509445,0,510975,2,1
837572,4233945,70,36,1973,0,2043,36,1
1124035,3494785,84,1253,3736,539,3820,1792,1
4582129,3549116,1231,56,10356,0,11587,56,1
1022123,1570530,126,12,8212,0,8338,12,1
2768957,2469379,65,1,689,0,754,1,1
489387,569352,42,6,693,0,735,6,1
2075015,4359101,2664,2,85781,0,88445,2,1
2482338,1313867,712,15,24222,0,24934,15,1
4624595,921684,722,6,53368,0,54090,6,1
2900246,181769,29,169,250,0,279,169,1
2893334,2804607,889,5,30148,0,31037,5,1
3638272,4757121,2022,11,370904,0,372926,11,1
2405789,3598709,1010,23,93387,0,94397,23,1
3638272,3655012,2022,2,370904,0,372926,2,1
4492248,1760197,237,98,17127,0,17364,98,1
515290,2385799,285,331,34080,0,34365,331,1
3758692,4962,711,145,34731,0,35442,145,1
1207753,4514167,533,110,9348,0,9881,110,1
2632134,2246955,60,7,428,0,488,7,1
2821086,651451,152,65,4157,0,4309,65,1
1847461,647470,1211,13,51149,0,52360,13,1
866357,1723506,825,733,18479,21835,19304,22568,1
1092204,1726215,13,34,555,0,568,34,1
859906,4506235,26,2,190,0,216,2,1
1539837,4157037,1127,22,62979,0,64106,22,1
2529661,4706346,493,39,27309,0,27802,39,1
1242778,4570929,163,3,2297,0,2460,3,1
1276253,3243678,407,56,46534,0,46941,56,1
159285,4776325,240,405,4650,0,4890,405,1
1876416,1892084,93,18,62,0,155,18,1
3280389,39333,1101,1,411419,0,412520,1,1
2985909,1706106,706,53,43348,0,44054,53,1
940526,2203123,475,3,20786,0,21261,3,1
3449530,2258209,717,3,73648,0,74365,3,1
3396719,4176700,660,18,8141,0,8801,18,1
2263130,2158101,712,25,14043,0,14755,25,1
4838376,2759173,606,159,26838,0,27444,159,1
3638272,4357940,2022,1,370904,0,372926,1,1
2883731,1870287,213,116,5217,0,5430,116,1
755739,1061667,1117,24,58043,0,59160,24,1
1580988,4152041,2821,3,400133,0,402954,3,1
1534362,1611178,1531,16,105859,0,107390,16,1
2945264,4558887,28,10,1524,0,1552,10,1
388875,1663034,112,39,3598,0,3710,39,1
1710856,2712521,311,119,3120,0,3431,119,1
2075015,1998036,2664,80,85781,0,88445,80,1
1436216,2428971,1068,2,68770,0,69838,2,1
409590,4022818,147,31,925,0,1072,31,1
2075015,1336552,2664,79,85781,0,88445,79,1
2230342,672231,30,2,3940,0,3970,2,1
765601,1974226,1485,3,101510,0,102995,3,1
2976684,3752172,257,115,3759,290,4016,405,1
338736,3402731,269,3654,148,18,417,3672,1
964291,4190284,139,79,1427,0,1566,79,1
2877907,318857,508,202,16021,0,16529,202,1
3638272,2948624,2022,1,370904,0,372926,1,1
4838376,4141789,606,6,26838,0,27444,6,1
4209323,2292258,1630,40,89460,0,91090,40,1
4423559,219375,77,130,1412,0,1489,130,1
1580988,3498186,2821,52,400133,393,402954,445,1
2851109,3843325,450,9,98552,0,99002,9,1
4358855,3876737,36,2951,2475,1921,2511,4872,1
1735116,4741843,503,63,16146,0,16649,63,1
4738916,4178404,1165,7,34124,0,35289,7,1
3384159,479695,415,44,6659,0,7074,44,1
3638272,4144889,2022,1,370904,0,372926,1,1
3632293,3530123,570,266,21294,0,21864,266,1
1676854,2987425,154,59,563,0,717,59,1
4289995,664308,525,27,4959,0,5484,27,1
584906,1431662,253,53,6639,0,6892,53,1
3361377,3262335,4841,3,761793,0,766634,3,1
3936039,407161,799,71,23884,0,24683,71,1
4089181,4855480,76,2921,2696,163,2772,3084,1
1962884,665307,404,11,3358,0,3762,11,1
4223938,1877793,55,369,258,0,313,369,1
4255453,3565712,327,241,3125,0,3452,241,1
1536341,4342817,53,266,1995,0,2048,266,1
55855,3577963,245,6,5888,0,6133,6,1
4547438,1770653,1291,16,25237,0,26528,16,1
4087774,1645242,578,28,10107,0,10685,28,1
1877044,995099,83,41,1566,0,1649,41,1
138599,2735549,5,37,64,0,69,37,1
4838376,2490209,606,44,26838,0,27444,44,1
2043252,3213789,39,123,274,679,313,802,1
4416945,4569005,417,40,33228,0,33645,40,1
1521082,3019972,766,168,6562,687,7328,855,1
514292,3027305,138,70,707,0,845,70,1
2314038,3588929,456,110,16347,0,16803,110,1
3294702,145960,991,6,68888,0,69879,6,1
4653941,4781351,951,3,45883,0,46834,3,1
2067060,976847,81,140,716,0,797,140,1
4462091,271364,9,1541,232,171,241,1712,1
493062,2014006,34,690,2722,0,2756,690,1
2516076,427051,1455,36,77782,0,79237,36,1
805360,1268909,1514,27,119306,0,120820,27,1
3216427,3683235,262,311,6471,23110,6733,23421,1
3844858,2160351,1591,33,28974,0,30565,33,1
2035351,1155467,32,1,795,0,827,1,1
1875,2723428,656,641,61388,0,62044,641,1
3280389,3001231,1101,1,411419,0,412520,1,1
725773,3547527,12,19,31,0,43,19,1
1550824,4742460,165,18,3841,0,4006,18,1
4619326,2522789,539,237,22721,0,23260,237,1
253352,1818053,237,27,10413,0,10650,27,1
1654099,2168322,1180,24,26347,0,27527,24,1
657387,3020898,47,41,2455,0,2502,41,1
3115867,2406300,1350,1,61232,0,62582,1,1
572189,2301548,21,33,306,0,327,33,1
847782,4613024,364,105,1411,0,1775,105,1
1234540,1749083,1071,49,75251,0,76322,49,1
1882506,2547211,94,30,1999,0,2093,30,1
2824797,2217987,83,5,4829,0,4912,5,1
3676295,653240,374,3,70881,0,71255,3,1
593740,2969198,1107,60,62807,0,63914,60,1
2872979,3465030,341,91,28510,0,28851,91,1
2851109,3894410,450,2,98552,0,99002,2,1
1325245,673101,144,102,5103,0,5247,102,1
3190749,1572699,116,68,291,0,407,68,1
309423,4732147,38,16,577,0,615,16,1
6618,4733423,892,93,68849,0,69741,93,1
283009,1023681,51,1,633,0,684,1,1
1436216,4089041,1068,15,68770,0,69838,15,1
2853969,83532,1051,21,42591,0,43642,21,1
954784,3346033,567,320,14450,9541,15017,9861,1
483251,1194222,154,88,5257,0,5411,88,1
3509903,2241631,1530,2,509445,0,510975,2,1
3845119,4541079,461,1,28609,0,29070,1,1
1201348,3071444,194,184,487,257,681,441,1
2441425,1585656,803,80,18561,0,19364,80,1
3157597,4695213,183,106,10247,0,10430,106,1
2477256,3816371,1124,4,7025,0,8149,4,1
2388735,4457614,403,145,4921,0,5324,145,1
1847461,441443,1211,26,51149,0,52360,26,1
2241519,1675400,23,508,460,140,483,648,1
2092359,470833,421,1,26936,0,27357,1,1
2209136,4028412,620,7,33789,0,34409,7,1
408965,1301704,903,99,38623,0,39526,99,1
2263130,3548626,712,76,14043,0,14755,76,1
3989108,581059,372,17,7033,0,7405,17,1
1580988,4488798,2821,1,400133,0,402954,1,1
36972,968351,55,3,2372,0,2427,3,1
3408985,171401,205,326,6002,0,6207,326,1
932720,3454625,1411,22,111323,0,112734,22,1
1534362,700860,1531,35,105859,0,107390,35,1
1577010,594200,373,31,2746,0,3119,31,1
3509903,3592098,1530,5,509445,0,510975,5,1
4624595,2032154,722,8,53368,0,54090,8,1
2624450,923454,97,125,836,2422,933,2547,1
1591435,2797270,387,125,31245,0,31632,125,1
4417253,4031461,1130,5,68389,0,69519,5,1
3206499,2713890,1337,167,32033,0,33370,167,1
1494665,284318,668,109,37638,0,38306,109,1
3206499,830253,1337,5,32033,0,33370,5,1
2715611,2436695,73,6,1227,0,1300,6,1
3361377,2829053,4841,4,761793,0,766634,4,1
1623359,4609653,95,18,1002,0,1097,18,1
765601,1007590,1485,5,101510,0,102995,5,1
4624595,979965,722,6,53368,0,54090,6,1
4661499,4228387,121,16,432,0,553,16,1
1580988,3136176,2821,1,400133,0,402954,1,1
159285,196975,240,235,4650,0,4890,235,1
3817695,2494733,49,30,1299,0,1348,30,1
1927211,4725197,1668,65,113322,0,114990,65,1
363750,4859925,1001,8,10994,0,11995,8,1
4864495,51111,36,54,189,0,225,54,1
1580988,3526398,2821,3,400133,0,402954,3,1
2961801,133205,1483,17,101962,0,103445,17,1
1652056,1871503,326,2,66845,0,67171,2,1
544230,3521274,1532,109,60768,0,62300,109,1
3585698,4495318,15,1,77,0,92,1,1
991610,1396945,281,50,1539,0,1820,50,1
4091129,1436216,15,1068,51,68770,66,69838,1
913320,2593817,60,304,866,0,926,304,1
3899905,4158092,47,23,481,0,528,23,1
708290,4716629,317,16,5975,0,6292,16,1
765601,4012442,1485,130,101510,0,102995,130,1
4467395,2325002,2084,6,14574,0,16658,6,1
2343253,3718196,1882,1,86401,0,88283,1,1
1934836,3110070,284,1,2471,0,2755,1,1
1887669,3448261,733,2,23145,0,23878,2,1
1544168,3538288,114,6,3348,0,3462,6,1
3526269,289593,85,50,710,0,795,50,1
862958,123690,87,13,4203,0,4290,13,1
932720,3550289,1411,55,111323,0,112734,55,1
318045,80587,107,12,758,0,865,12,1
3081778,4097884,211,441,1969,0,2180,441,1
873006,248368,375,291,33630,0,34005,291,1
4538456,1208908,94,9,2432,0,2526,9,1
3137585,4227066,1196,179,77354,0,78550,179,1
4272102,2871572,1608,50,104171,0,105779,50,1
3082812,462381,22,28,220,0,242,28,1
3746972,3056533,71,1117,323,25,394,1142,1
1055530,514318,415,16,14969,0,15384,16,1
4372942,2562875,4,17,97,0,101,17,1
2950311,4249721,807,16,85116,0,85923,16,1
4011264,120375,1360,86,116777,0,118137,86,1
1870921,1888608,182,1,8739,0,8921,1,1
1287372,4810864,120,1,216,0,336,1,1
978797,1796351,599,24,12421,0,13020,24,1
4505464,4754289,99,20,2637,0,2736,20,1
3276610,2365600,38,66,53,121,91,187,1
4043108,1250578,77,19,2001,0,2078,19,1
530200,2067503,2035,7,62809,0,64844,7,1
765601,243032,1485,17,101510,0,102995,17,1
1331940,3420402,802,113,32617,0,33419,113,1
3361377,791506,4841,2,761793,0,766634,2,1
4922,4327941,200,15,5946,0,6146,15,1
4479581,732923,601,127,19545,0,20146,127,1
3361377,3227786,4841,3,761793,0,766634,3,1
4560313,2352492,284,2,4566,0,4850,2,1
796130,3918666,22,3,1456,0,1478,3,1
3676295,2018689,374,1,70881,0,71255,1,1
1234540,722634,1071,51,75251,0,76322,51,1
4013601,2291145,653,221,14886,3037,15539,3258,1
996752,420919,173,25,3538,0,3711,25,1
2150686,2301321,69,49,983,0,1052,49,1
4711523,160338,115,288,1069,393,1184,681,1
4342519,901913,138,14,11317,0,11455,14,1
3768366,2326073,334,56,12403,0,12737,56,1
2318588,4087774,104,578,1272,10107,1376,10685,1
439557,4106974,2090,2,61744,0,63834,2,1
4304056,3184713,164,43,12698,0,12862,43,1
3906136,1810994,387,82,41169,0,41556,82,1
595757,3531785,340,22,26738,0,27078,22,1
4238001,2633261,869,7,61161,0,62030,7,1
3257465,864218,541,66,27614,0,28155,66,1
3742930,1991122,410,78,22242,0,22652,78,1
2755798,2100959,494,3,24862,0,25356,3,1
4423184,2639132,384,1,29809,0,30193,1,1
4360960,1555240,1642,141,110084,0,111726,141,1
3300452,3387349,114,20,1992,0,2106,20,1
3530334,1085911,74,2,77,0,151,2,1
2690953,2898368,81,602,246,208,327,810,1
1877681,1602020,166,15,1823,192,1989,207,1
3438576,66912,3424,29,137753,0,141177,29,1
781211,609970,976,4,51781,0,52757,4,1
1086912,1397226,907,3,33396,0,34303,3,1
2529661,3107603,493,102,27309,0,27802,102,1
1927211,3868163,1668,10,113322,0,114990,10,1
4853234,14091,1256,7,29554,0,30810,7,1
1621187,2545216,165,1197,1812,0,1977,1197,1
4220190,1265437,320,33,15994,0,16314,33,1
530200,557722,2035,6,62809,0,64844,6,1
173493,1089629,46,121,1959,0,2005,121,1
3065808,725161,1235,54,82317,0,83552,54,1
3956129,1355603,32,58,93,0,125,58,1
3320279,1230910,312,36,2691,0,3003,36,1
627727,3925015,56,49,2488,0,2544,49,1
1163180,1759068,606,21,5885,0,6491,21,1
4390289,3885066,7,41,197,0,204,41,1
1580988,1721028,2821,1,400133,0,402954,1,1
3361377,1487203,4841,1,761793,0,766634,1,1
2341838,2986930,75,4,3932,0,4007,4,1
4525011,3221043,172,367,6076,0,6248,367,1
3438576,4002279,3424,46,137753,0,141177,46,1
3361377,3317797,4841,2,761793,0,766634,2,1
2571454,2046122,13,8,199,0,212,8,1
2035351,1551230,32,4,795,0,827,4,1
2031305,3147977,396,73,23435,0,23831,73,1
3280389,803114,1101,4,411419,0,412520,4,1
856564,46736,68,18,376,0,444,18,1
2075015,4526724,2664,10,85781,0,88445,10,1
2343253,1493423,1882,8,86401,0,88283,8,1
2405789,452807,1010,18,93387,0,94397,18,1
3294702,1091470,991,32,68888,0,69879,32,1
1478080,381498,593,7,7009,0,7602,7,1
1539837,4376508,1127,15,62979,0,64106,15,1
3235479,2554448,999,32,66486,0,67485,32,1
1151593,2627854,231,9,5501,0,5732,9,1
1875,2355574,656,24,61388,0,62044,24,1
2827436,1531419,882,2,271525,0,272407,2,1
1913445,1915156,564,6,47943,0,48507,6,1
3705070,573101,740,781,14938,12750,15678,13531,1
873006,1289967,375,34,33630,0,34005,34,1
3835618,3387035,694,110,25433,0,26127,110,1
2887240,1177494,1143,3,118405,0,119548,3,1
1966548,3916009,208,1,53149,0,53357,1,1
3361377,4004112,4841,1,761793,0,766634,1,1
3361377,2047012,4841,1,761793,0,766634,1,1
2260014,2440036,2466,1,98622,0,101088,1,1
4238001,4049171,869,7,61161,0,62030,7,1
580157,3556423,194,18,4890,0,5084,18,1
3683235,2212862,311,18,23110,0,23421,18,1
898068,3002200,138,637,3174,510,3312,1147,1
2464401,3201717,577,17,23681,0,24258,17,1
2646792,4860983,86,54,2420,0,2506,54,1
2686984,4342519,30,138,436,11317,466,11455,1
60980,165003,649,1,20708,0,21357,1,1
2961801,2505701,1483,70,101962,0,103445,70,1
646587,3043598,122,719,5819,0,5941,719,1
4519069,2282081,387,3,20799,0,21186,3,1
1503116,162970,415,142,37079,0,37494,142,1
4750855,1219440,355,22,18880,0,19235,22,1
3449530,615249,717,21,73648,0,74365,21,1
922827,3984512,103,151,448,0,551,151,1
765601,3780918,1485,159,101510,0,102995,159,1
2885394,3094682,174,239,3481,0,3655,239,1
515290,4186033,285,31,34080,0,34365,31,1
4184779,3674018,240,43,427,0,667,43,1
433459,542486,435,5,821,0,1256,5,1
2812015,3227292,110,261,411,0,521,261,1
3836080,383077,1197,65,59457,0,60654,65,1
4011264,287769,1360,191,116777,0,118137,191,1
3280389,4141432,1101,4,411419,0,412520,4,1
471706,708677,794,52,65616,0,66410,52,1
3561502,1353587,1144,7,68800,0,69944,7,1
4202576,4438074,600,242,10697,0,11297,242,1
3509903,1949833,1530,1,509445,0,510975,1,1
3116723,2978882,194,213,4798,0,4992,213,1
1234540,1245705,1071,22,75251,0,76322,22,1
4149765,3808239,210,45,1961,0,2171,45,1
4708835,3383689,190,27,7539,0,7729,27,1
2827436,1552769,882,1,271525,0,272407,1,1
4560210,897758,177,7,6565,0,6742,7,1
3836080,4553071,1197,47,59457,0,60654,47,1
4040467,1174285,206,23,2565,0,2771,23,1
3930937,4035224,225,31,8777,0,9002,31,1
4519298,2031762,577,1,14443,0,15020,1,1
4069373,234812,97,49,3470,0,3567,49,1
870181,4742515,278,32,1377,0,1655,32,1
1548012,3211566,73,9,1957,0,2030,9,1
3509903,4271045,1530,57,509445,0,510975,57,1
3509903,4658391,1530,1,509445,0,510975,1,1
1856969,4726377,34,772,582,17,616,789,1
3236599,2374004,36,2,197,0,233,2,1
4689808,2308300,280,173,14220,0,14500,173,1
3438576,3023879,3424,3,137753,0,141177,3,1
638753,2239013,88,6,1817,0,1905,6,1
1745824,3750421,68,42,708,0,776,42,1
2827436,3403764,882,50,271525,0,272407,50,1
1880135,2536673,810,4,71924,0,72734,4,1
2161635,4396612,124,16,1394,0,1518,16,1
3835618,382104,694,95,25433,0,26127,95,1
4624595,1617607,722,81,53368,0,54090,81,1
2827436,665866,882,359,271525,0,272407,359,1
408965,499444,903,88,38623,0,39526,88,1
2343253,775170,1882,1,86401,0,88283,1,1
4649206,3619514,566,119,31367,0,31933,119,1
2906370,965633,271,55,4802,0,5073,55,1
155821,2093993,117,2,5678,0,5795,2,1
3632293,4260629,570,270,21294,0,21864,270,1
1526503,1501259,29,85,999,0,1028,85,1
3361377,2639932,4841,1,761793,0,766634,1,1
679540,913669,396,110,8028,0,8424,110,1
2851109,2457059,450,6,98552,0,99002,6,1
2344012,54057,85,77,423,0,508,77,1
4835245,2636278,3,70,8,0,11,70,1
4301252,570367,118,16,2905,0,3023,16,1
4302043,3777264,61,11,464,0,525,11,1
408965,768569,903,40,38623,0,39526,40,1
2261139,76683,2014,15,42851,0,44865,15,1
4360799,4108715,910,632,10476,1257,11386,1889,1
860473,1408751,751,3,20450,0,21201,3,1
3509903,1996023,1530,1,509445,0,510975,1,1
4666726,1626288,64,61,406,0,470,61,1
3980547,4262373,29,33,405,0,434,33,1
474172,1632765,471,14,38713,0,39184,14,1
2827436,3124205,882,1,271525,0,272407,1,1
1179906,1086874,316,140,14467,0,14783,140,1
64357,4128311,309,10,6329,0,6638,10,1
1958096,3218473,80,52,1029,1041,1109,1093,1
3235479,3538016,999,113,66486,0,67485,113,1
1880135,770591,810,76,71924,0,72734,76,1
1751669,1431141,860,1,9825,0,10685,1,1
4653941,1310515,951,47,45883,535,46834,582,1
4411870,3458992,948,305,60517,0,61465,305,1
3198742,2394845,551,329,5252,0,5803,329,1
544230,3583761,1532,101,60768,747,62300,848,1
1880135,1933188,810,12,71924,0,72734,12,1
1913445,1572270,564,23,47943,159,48507,182,1
1790294,551442,54,5,1246,0,1300,5,1
4619326,943962,539,17,22721,0,23260,17,1
1747884,831310,263,129,71,0,334,129,1
1973082,4014090,1036,97,18915,0,19951,97,1
2949409,2339267,175,5,2185,0,2360,5,1
2827436,781209,882,1,271525,0,272407,1,1
3650069,4843360,217,355,4118,7866,4335,8221,1
4370819,3527105,403,107,6519,0,6922,107,1
1927780,1601530,420,72,6230,0,6650,72,1
671026,1277807,421,85,8079,0,8500,85,1
3280389,98885,1101,1,411419,0,412520,1,1
2405789,3001997,1010,59,93387,0,94397,59,1
2044668,3187986,112,72,1553,0,1665,72,1
25871,3648371,214,4,1848,0,2062,4,1
1580988,123597,2821,5,400133,0,402954,5,1
1609659,694513,523,65,29763,0,30286,65,1
2804074,2576336,115,2,2343,0,2458,2,1
4330391,1042426,773,67,32759,0,33532,67,1
3242275,3357455,551,81,17400,0,17951,81,1
1580474,386189,67,10,5377,0,5444,10,1
1201711,4136868,357,439,15948,0,16305,439,1
3845119,955383,461,164,28609,0,29070,164,1
117040,1626412,87,34,504,0,591,34,1
4423184,2664107,384,5,29809,0,30193,5,1
1154180,2425837,248,26,2361,0,2609,26,1
517189,2552459,115,68,1511,0,1626,68,1
2496454,3863474,320,437,2769,2592,3089,3029,1
4251247,3483753,47,148,524,77,571,225,1
1520840,2534150,155,49,2950,0,3105,49,1
2850994,4081047,113,55,2548,0,2661,55,1
1591435,1902824,387,55,31245,0,31632,55,1
2375878,4397188,248,54,14925,0,15173,54,1
892512,1039932,1505,147,11757,813,13262,960,1
2267633,1392279,422,47,13247,0,13669,47,1
4140279,625762,337,28,49384,0,49721,28,1
4183784,1110136,931,5,59894,0,60825,5,1
2485529,2387438,358,29,1375,0,1733,29,1
2859702,4053266,149,40,1471,0,1620,40,1
2823179,27625,505,31,6744,0,7249,31,1
1875,1069155,656,21,61388,0,62044,21,1
3280389,887460,1101,2,411419,0,412520,2,1
1652056,4500542,326,2,66845,0,67171,2,1
1628275,4799682,97,28,2967,0,3064,28,1
3938928,581535,271,1283,318,8414,589,9697,1
4451491,3424896,817,154,8836,0,9653,154,1
591176,3099578,711,53,300,231,1011,284,1
4547438,4654136,1291,157,25237,0,26528,157,1
1356121,1723506,61,733,959,21835,1020,22568,1
3361377,1454438,4841,1,761793,0,766634,1,1
3361377,2282973,4841,1,761793,0,766634,1,1
3361377,1267031,4841,13,761793,0,766634,13,1
2281580,673946,309,102,1051,341,1360,443,1
2863066,103103,56,5,1342,0,1398,5,1
3280389,3743807,1101,3,411419,0,412520,3,1
489584,2520816,421,288,12098,0,12519,288,1
4140279,3758503,337,1,49384,0,49721,1,1
280171,917833,232,32,3378,0,3610,32,1
4011264,2048060,1360,21,116777,0,118137,21,1
1201711,211654,357,55,15948,0,16305,55,1
574509,2158773,68,158,234,431,302,589,1
2694929,2708039,186,13,4613,0,4799,13,1
6618,513927,892,61,68849,0,69741,61,1
25871,1848611,214,14,1848,0,2062,14,1
1753063,1532016,73,110,654,227,727,337,1
325060,4262055,173,1,922,0,1095,1,1
3509903,3669827,1530,2,509445,0,510975,2,1
459115,3807207,75,39,757,0,832,39,1
1497278,881084,1869,30,35111,0,36980,30,1
940526,3573238,475,56,20786,0,21261,56,1
3824547,1656173,1075,2,14337,0,15412,2,1
4365938,3484071,250,195,10362,0,10612,195,1
932720,4410329,1411,38,111323,0,112734,38,1
4656285,3516066,1446,15,35428,0,36874,15,1
2940588,941859,554,318,9477,0,10031,318,1
3361377,3043646,4841,1,761793,0,766634,1,1
2092359,1446331,421,4,26936,0,27357,4,1
2727581,4749098,757,90,7394,0,8151,90,1
3405059,3920146,261,66,9604,0,9865,66,1
2827436,928208,882,1,271525,0,272407,1,1
4451122,2164782,985,119,41669,0,42654,119,1
4011264,1586473,1360,34,116777,0,118137,34,1
1927211,1018866,1668,78,113322,0,114990,78,1
1676854,3344325,154,6,563,0,717,6,1
1927211,910862,1668,17,113322,0,114990,17,1
2516076,2669956,1455,11,77782,0,79237,11,1
1633022,4504852,246,340,23530,0,23776,340,1
3561502,1092226,1144,148,68800,0,69944,148,1
2512911,307250,14,919,132,35588,146,36507,1
2261139,1783897,2014,13,42851,0,44865,13,1
3438576,3544533,3424,10,137753,0,141177,10,1
2343253,891712,1882,3,86401,0,88283,3,1
3128197,3103978,122,4,6176,0,6298,4,1
12882,4717522,10,913,117,395,127,1308,1
4272102,2085343,1608,5,104171,0,105779,5,1
2465641,4063306,383,2,2507,0,2890,2,1
2498087,4669188,1630,113,32582,0,34212,113,1
307250,2492299,919,121,35588,0,36507,121,1
3509903,4510858,1530,1,509445,0,510975,1,1
2941459,913835,21,42,371,150,392,192,1
2677334,442875,377,4,6774,0,7151,4,1
4257751,4245103,109,1,8420,0,8529,1,1
1504506,3629409,551,51,1317,0,1868,51,1
1730984,1322161,5,5,43,0,48,5,1
3361377,446573,4841,147,761793,0,766634,147,1
3993347,1923473,434,186,3778,0,4212,186,1
3438576,1082241,3424,15,137753,0,141177,15,1
2405789,576937,1010,18,93387,0,94397,18,1
1054871,3839688,59,234,279,1361,338,1595,1
3907996,3282989,485,4,18964,0,19449,4,1
3633019,1580116,746,73,32317,0,33063,73,1
1249967,311418,207,106,11933,0,12140,106,1
805360,3908435,1514,50,119306,0,120820,50,1
4140279,1481252,337,1,49384,0,49721,1,1
3514277,223486,1338,23,13269,0,14607,23,1
3768176,4190897,167,7,1980,0,2147,7,1
2307868,3577970,1131,2,38777,0,39908,2,1
4653941,1296233,951,1,45883,0,46834,1,1
4451122,2655640,985,65,41669,0,42654,65,1
1311307,3914286,358,51,10864,0,11222,51,1
3638272,3726867,2022,2,370904,0,372926,2,1
2877907,4728518,508,19,16021,0,16529,19,1
2163657,52970,12,21,236,0,248,21,1
3140664,3230772,268,12,16099,0,16367,12,1
3873768,902623,449,59,35424,0,35873,59,1
2705481,1257354,85,62,472,0,557,62,1
2662809,3024030,303,3,10704,0,11007,3,1
3518336,3275433,9,202,683,0,692,202,1
1559720,2884711,96,53,817,0,913,53,1
1663945,3716623,477,184,772,0,1249,184,1
2002261,3782063,119,4,135,36,254,40,1
2148937,556112,672,1,47361,0,48033,1,1
2018881,3022018,1284,28,451,0,1735,28,1
2853969,4164132,1051,1,42591,0,43642,1,1
2818749,2231978,92,284,3797,0,3889,284,1
2260014,4263486,2466,8,98622,0,101088,8,1
3361377,3065348,4841,1,761793,0,766634,1,1
3449530,3361134,717,147,73648,0,74365,147,1
1465606,2818346,14,1,296,0,310,1,1
1392958,3907752,91,21,241,0,332,21,1
3638272,98813,2022,3,370904,0,372926,3,1
2579149,3146408,87,12,610,0,697,12,1
2281149,3655971,282,23,28082,0,28364,23,1
466667,3633377,442,319,4239,4662,4681,4981,1
1953988,3271198,51,165,203,0,254,165,1
1207753,580716,533,2,9348,0,9881,2,1
3361377,1999541,4841,1,761793,0,766634,1,1
2961801,35581,1483,35,101962,0,103445,35,1
3174860,2156393,61,7,76,0,137,7,1
1469880,2555952,275,2,3409,0,3684,2,1
3167388,2730512,203,6,9760,0,9963,6,1
2887240,4336044,1143,3,118405,0,119548,3,1
2075015,3777216,2664,38,85781,0,88445,38,1
3361377,158681,4841,3,761793,0,766634,3,1
3280389,2521921,1101,2,411419,0,412520,2,1
2827436,1849198,882,6,271525,0,272407,6,1
1580988,1490209,2821,1,400133,0,402954,1,1
1637447,2697634,555,113,8549,0,9104,113,1
3522049,2185934,301,117,12347,0,12648,117,1
3462300,3143933,342,10,2917,0,3259,10,1
907654,2242182,798,82,24575,0,25373,82,1
3995686,1358039,113,1,6154,0,6267,1,1
259575,3697794,260,56,13949,0,14209,56,1
2472397,304856,116,20,1031,0,1147,20,1
3508618,3118804,215,315,3577,6025,3792,6340,1
1301815,583284,752,25,48944,0,49696,25,1
731671,1019648,45,60,1296,0,1341,60,1
499414,3688175,316,260,3543,0,3859,260,1
499918,4627563,36,10,311,0,347,10,1
1966548,690714,208,3,53149,0,53357,3,1
2851109,4058910,450,4,98552,0,99002,4,1
2317782,3824547,788,1075,2668,14337,3456,15412,1
3112136,312843,406,7,41366,0,41772,7,1
307250,4369202,919,8,35588,0,36507,8,1
2950311,4153635,807,52,85116,0,85923,52,1
2961801,3184951,1483,46,101962,0,103445,46,1
1880135,449686,810,7,71924,0,72734,7,1
2886330,2477373,415,645,10154,0,10569,645,1
1817799,3601439,402,21,15932,0,16334,21,1
669845,2127266,14,5,411,0,425,5,1
1927211,3523708,1668,45,113322,0,114990,45,1
2981537,4307759,1252,3,118718,0,119970,3,1
4209323,2380737,1630,39,89460,0,91090,39,1
2776135,437681,7,1,24,0,31,1,1
1436216,1245932,1068,2,68770,0,69838,2,1
3387987,2130707,268,12,19035,0,19303,12,1
2760655,2247463,403,388,2250,2747,2653,3135,1
2482338,468326,712,64,24222,0,24934,64,1
3361377,1885387,4841,3,761793,0,766634,3,1
4747661,1835614,436,128,4377,0,4813,128,1
2705886,2078080,179,88,4447,0,4626,88,1
687713,2113806,436,10,47160,0,47596,10,1
360598,3126850,68,178,1946,135,2014,313,1
3112136,1918567,406,9,41366,0,41772,9,1
593740,2918603,1107,52,62807,0,63914,52,1
4462091,1736710,9,163,232,0,241,163,1
2887240,1304600,1143,3,118405,0,119548,3,1
471706,67693,794,1,65616,0,66410,1,1
765601,2948168,1485,185,101510,0,102995,185,1
3549674,1474988,602,62,38542,0,39144,62,1
1591435,635966,387,2,31245,0,31632,2,1
3765475,2531868,873,1,107914,0,108787,1,1
3764177,3533597,1036,70,64563,0,65599,70,1
4018742,2792544,115,22,3140,0,3255,22,1
4789203,4234991,355,158,11315,0,11670,158,1
4762830,2752937,1043,9,2352,0,3395,9,1
3361377,490354,4841,1,761793,0,766634,1,1
3765475,3391726,873,21,107914,0,108787,21,1
2482338,4460355,712,69,24222,0,24934,69,1
3509903,1352185,1530,82,509445,0,510975,82,1
3448868,3742891,248,65,833,0,1081,65,1
4220190,608927,320,28,15994,0,16314,28,1
1968010,4586346,786,144,10371,0,11157,144,1
3280389,3533369,1101,1,411419,0,412520,1,1
354904,3083383,3193,13,105780,0,108973,13,1
680015,2325503,485,73,9502,0,9987,73,1
4238001,3515761,869,257,61161,0,62030,257,1
4077562,677385,433,58,2723,0,3156,58,1
4314111,2596090,110,805,1951,0,2061,805,1
3881566,2660423,781,15,14176,0,14957,15,1
17330,3317782,154,9,972,0,1126,9,1
3509903,2401472,1530,32,509445,0,510975,32,1
4035655,3771724,913,119,5979,0,6892,119,1
1652056,4076667,326,1,66845,0,67171,1,1
414608,1498243,50,2,5531,0,5581,2,1
3139742,2152607,87,2,1476,0,1563,2,1
3636190,3629556,119,832,4195,0,4314,832,1
2529661,2614442,493,55,27309,0,27802,55,1
2631627,2983533,183,6,3743,0,3926,6,1
4604311,2147741,29,2,7472,0,7501,2,1
2502456,4152731,719,28,50725,0,51444,28,1
2120140,3115867,453,1350,6305,61232,6758,62582,1
3764177,1399248,1036,51,64563,0,65599,51,1
3638272,1579036,2022,31,370904,0,372926,31,1
3509903,4142801,1530,3,509445,0,510975,3,1
62950,1804817,137,131,1590,0,1727,131,1
1178793,393185,146,591,1343,7719,1489,8310,1
2827436,3261600,882,9,271525,0,272407,9,1
471706,1710070,794,18,65616,0,66410,18,1
3280389,4349924,1101,1,411419,0,412520,1,1
2779329,2910742,217,109,6021,0,6238,109,1
2092359,3443690,421,6,26936,0,27357,6,1
4629569,4028836,152,2,1698,0,1850,2,1
1063358,4207225,1350,115,63494,0,64844,115,1
2182339,2879304,55,66,503,0,558,66,1
2394976,2825725,335,129,10973,0,11308,129,1
3214227,2547366,27,5,1890,0,1917,5,1
1445380,4482284,40,142,4396,0,4436,142,1
4209323,3706682,1630,92,89460,0,91090,92,1
3280389,1839987,1101,1,411419,0,412520,1,1
1633100,260843,163,3,8737,0,8900,3,1
805360,4256612,1514,50,119306,0,120820,50,1
2348182,859525,469,58,4747,0,5216,58,1
3065808,4778101,1235,186,82317,0,83552,186,1
3509903,228444,1530,39,509445,1802,510975,1841,1
2981537,2474367,1252,7,118718,0,119970,7,1
860473,1146319,751,24,20450,0,21201,24,1
1591435,4166877,387,61,31245,0,31632,61,1
22100,585212,93,54,836,0,929,54,1
3361377,2040167,4841,1,761793,0,766634,1,1
3884904,3542923,61,7,1946,0,2007,7,1
2650412,1402545,931,28,29038,0,29969,28,1
3668051,1931532,89,47,3044,0,3133,47,1
3370656,451191,74,132,820,1659,894,1791,1
151693,1727687,436,38,12181,0,12617,38,1
354788,3253613,203,86,5964,0,6167,86,1
1486758,355994,337,77,11346,0,11683,77,1
4191410,974869,1590,45,96434,0,98024,45,1
3638272,3392899,2022,120,370904,0,372926,120,1
2375878,2483208,248,46,14925,0,15173,46,1
1580988,2424623,2821,1,400133,0,402954,1,1
3157597,760656,183,353,10247,0,10430,353,1
3509903,1179810,1530,2,509445,0,510975,2,1
3454888,4106128,162,7,7886,0,8048,7,1
911192,2680873,106,6,6327,0,6433,6,1
4191410,2673747,1590,26,96434,0,98024,26,1
4180995,2340125,219,161,4470,2601,4689,2762,1
3361377,4093781,4841,8,761793,0,766634,8,1
4095026,823447,71,215,1175,0,1246,215,1
2961801,3342533,1483,72,101962,0,103445,72,1
4416945,1529901,417,2,33228,0,33645,2,1
4782707,1313166,513,14,31665,0,32178,14,1
3509903,3336152,1530,2,509445,0,510975,2,1
1040560,2422000,57,61,306,250,363,311,1
765601,569896,1485,241,101510,0,102995,241,1
3257465,1373186,541,2,27614,0,28155,2,1
1580988,2436728,2821,1,400133,0,402954,1,1
4360960,3403717,1642,122,110084,0,111726,122,1
3294702,1183755,991,34,68888,0,69879,34,1
2981537,838367,1252,4,118718,0,119970,4,1
501914,2204624,217,61,5217,0,5434,61,1
3235479,767503,999,10,66486,0,67485,10,1
2381857,761612,79,210,669,0,748,210,1
3140664,4649324,268,3,16099,0,16367,3,1
1761428,751552,112,82,2469,0,2581,82,1
1927780,3752912,420,177,6230,0,6650,177,1
2075015,3835016,2664,12,85781,0,88445,12,1
3368608,1679990,190,100,976,0,1166,100,1
3629404,1812123,185,35,6681,0,6866,35,1
805360,948406,1514,75,119306,0,120820,75,1
4219659,277412,28,166,463,0,491,166,1
2715343,4731757,9,19,101,0,110,19,1
805360,3465172,1514,9,119306,0,120820,9,1
4117726,658157,136,42,751,0,887,42,1
1539837,1150210,1127,22,62979,0,64106,22,1
4313572,2406911,930,14,16971,95,17901,109,1
4656285,4455550,1446,41,35428,0,36874,41,1
755739,2030100,1117,81,58043,0,59160,81,1
3980540,14323,152,142,1918,0,2070,142,1
2369849,3727669,298,9,371,0,669,9,1
593740,2421767,1107,87,62807,0,63914,87,1
2595727,272167,125,6,1928,0,2053,6,1
805360,985564,1514,8,119306,0,120820,8,1
1153522,1687496,78,60,911,0,989,60,1
180302,478803,26,1,1997,0,2023,1,1
517497,3639235,117,53,2068,0,2185,53,1
4295952,89891,808,41,57369,0,58177,41,1
3765475,2093713,873,5,107914,0,108787,5,1
1135323,1762544,169,205,12240,0,12409,205,1
2781817,1588604,704,28,24613,0,25317,28,1
691798,4055331,16,8,201,0,217,8,1
3397281,3876737,743,2951,15050,1921,15793,4872,1
1202593,4325225,93,4,5131,0,5224,4,1
1591435,1278451,387,46,31245,0,31632,46,1
3361377,1218203,4841,1,761793,0,766634,1,1
3147347,627549,172,171,1534,0,1706,171,1
3759853,3814299,451,78,16330,0,16781,78,1
226540,3687499,463,32,10650,0,11113,32,1
1644171,4098491,1071,25,3690,0,4761,25,1
4750855,1834286,355,2,18880,0,19235,2,1
2283171,56793,51,3,443,0,494,3,1
1425049,3100873,41,5,315,0,356,5,1
479208,3076220,20,3,2337,0,2357,3,1
259575,1065585,260,1,13949,0,14209,1,1
4629176,2528054,2058,92,9211,0,11269,92,1
1028920,1405861,194,43,1053,121,1247,164,1
3979972,2096168,407,84,2364,0,2771,84,1
6618,1400824,892,4,68849,0,69741,4,1
3509903,2901345,1530,1,509445,0,510975,1,1
813554,629336,252,11,17214,0,17466,11,1
4370378,314294,243,15,1075,0,1318,15,1
427805,3225286,483,1,156906,0,157389,1,1
3914135,2109304,2152,145,60084,0,62236,145,1
3872736,492976,258,457,12660,0,12918,457,1
1855859,1243368,76,319,527,5045,603,5364,1
2464401,1139873,577,670,23681,10236,24258,10906,1
1022123,3018942,126,3,8212,0,8338,3,1
4731849,2310177,455,32,10886,0,11341,32,1
3549674,3075343,602,31,38542,0,39144,31,1
1838158,2008255,180,8,1634,0,1814,8,1
2793437,1186528,582,2,25447,0,26029,2,1
2092359,1239713,421,1,26936,0,27357,1,1
1243368,4451550,319,26,5045,0,5364,26,1
613620,60301,141,30,2512,0,2653,30,1
378943,837126,340,122,12563,0,12903,122,1
2755798,4609829,494,22,24862,0,25356,22,1
2343253,3775554,1882,2,86401,0,88283,2,1
4624595,3535150,722,72,53368,0,54090,72,1
1588330,94157,694,65,10280,0,10974,65,1
2827436,3381345,882,1,271525,0,272407,1,1
1966548,4282529,208,1,53149,0,53357,1,1
913320,3294317,60,5,866,0,926,5,1
4822675,1571087,35,112,443,722,478,834,1
2749438,4820772,114,48,1518,191,1632,239,1
1968010,3852106,786,53,10371,0,11157,53,1
1262939,1841785,134,7,894,0,1028,7,1
500188,2768371,92,250,343,0,435,250,1
3633377,429902,319,23,4662,0,4981,23,1
1098252,911624,216,26,596,0,812,26,1
2148937,965727,672,3,47361,0,48033,3,1
3509903,3958268,1530,3,509445,0,510975,3,1
3065808,1832210,1235,8,82317,0,83552,8,1
3765475,2997818,873,9,107914,0,108787,9,1
530200,900427,2035,1,62809,0,64844,1,1
596012,3480953,192,25,3561,0,3753,25,1
2887973,2481072,109,335,1259,0,1368,335,1
1544048,3160924,206,4,4200,0,4406,4,1
2206348,3778227,16,36,139,0,155,36,1
1588705,1990615,1000,441,11879,0,12879,441,1
427805,3102234,483,1,156906,0,157389,1,1
4853234,506983,1256,9,29554,0,30810,9,1
3676295,905867,374,1,70881,0,71255,1,1
1560049,665641,1121,18,12468,0,13589,18,1
3252058,3628370,26,2,1860,0,1886,2,1
2627841,3228413,418,79,12342,0,12760,79,1
3257465,4495360,541,149,27614,0,28155,149,1
3569179,3606566,1064,11,40015,0,41079,11,1
3734245,1551004,915,10,34965,0,35880,10,1
2897926,1893542,565,87,25983,0,26548,87,1
3765475,3692373,873,4,107914,0,108787,4,1
577580,4455856,187,16,3831,0,4018,16,1
3922194,2138449,175,368,1847,0,2022,368,1
78836,4196015,86,86,3525,0,3611,86,1
344052,3480257,88,3,514,0,602,3,1
1293807,1506328,1837,16,30865,0,32702,16,1
4499811,1809926,15,2452,113,130,128,2582,1
3873768,4798939,449,73,35424,0,35873,73,1
2822651,4134843,25,3,3794,0,3819,3,1
4193551,2713118,314,60,1572,71,1886,131,1
2369663,2782367,24,83,128,0,152,83,1
3289742,4038014,143,53,578,0,721,53,1
805360,3718110,1514,22,119306,0,120820,22,1
1341178,499290,899,167,16829,0,17728,167,1
2464401,2610874,577,29,23681,0,24258,29,1
2940588,2199352,554,88,9477,0,10031,88,1
1913445,3529087,564,8,47943,0,48507,8,1
2314038,1549078,456,46,16347,0,16803,46,1
3449530,1948613,717,44,73648,0,74365,44,1
1839283,3592839,765,12,36658,0,37423,12,1
3294702,3768778,991,181,68888,0,69879,181,1
4361636,1869800,186,63,1867,0,2053,63,1
1234540,1554818,1071,26,75251,0,76322,26,1
4183784,1406537,931,95,59894,0,60825,95,1
2281149,2122839,282,244,28082,0,28364,244,1
1792816,4253538,246,1412,1522,1533,1768,2945,1
439557,4617419,2090,521,61744,0,63834,521,1
3206499,1440131,1337,1,32033,0,33370,1,1
1539837,4063559,1127,38,62979,0,64106,38,1
3835618,3991986,694,55,25433,0,26127,55,1
2981537,3027289,1252,2,118718,0,119970,2,1
1847461,3951603,1211,7,51149,0,52360,7,1
1031334,3517207,459,71,16840,0,17299,71,1
3144238,288229,326,104,28455,0,28781,104,1
471706,3869715,794,1,65616,0,66410,1,1
4060074,1837453,178,228,7305,0,7483,228,1
4365938,1947130,250,133,10362,0,10612,133,1
3361377,2508289,4841,3,761793,0,766634,3,1
3144238,3953363,326,5,28455,0,28781,5,1
4011264,1482820,1360,146,116777,0,118137,146,1
3734245,2073400,915,220,34965,0,35880,220,1
1927211,749262,1668,21,113322,0,114990,21,1
3787495,1077306,9,11,381,0,390,11,1
4678614,1929153,452,44,16881,0,17333,44,1
1539837,3543078,1127,49,62979,0,64106,49,1
1330432,3830822,12,22,1926,0,1938,22,1
2107861,1829591,535,1,25743,0,26278,1,1
3257465,71238,541,13,27614,0,28155,13,1
1539837,569337,1127,27,62979,0,64106,27,1
3795221,1861395,332,503,5749,0,6081,503,1
1556337,4431909,1177,33,585,0,1762,33,1
3271484,703472,1507,234,34093,0,35600,234,1
2887240,2190943,1143,4,118405,0,119548,4,1
471706,4026277,794,3,65616,0,66410,3,1
837553,1252031,1249,51,61665,0,62914,51,1
1497278,4052866,1869,45,35111,0,36980,45,1
3675474,1015115,46,516,1953,0,1999,516,1
3235479,3734625,999,37,66486,0,67485,37,1
4558459,4226284,1,755,112,82,113,837,1
765601,3471229,1485,11,101510,0,102995,11,1
3965832,3824547,31,1075,159,14337,190,15412,1
2527654,4146825,39,2,1740,0,1779,2,1
805360,722019,1514,7,119306,0,120820,7,1
2465230,3628875,88,5,663,0,751,5,1
679540,1486646,396,725,8028,0,8424,725,1
2516076,1302813,1455,50,77782,0,79237,50,1
1436216,9290,1068,2,68770,0,69838,2,1
752618,4584956,169,7,5929,0,6098,7,1
445996,2341256,1175,85,12828,0,14003,85,1
1345777,3494568,187,13,1667,0,1854,13,1
112616,3944761,36,590,220,138,256,728,1
1031334,4394980,459,21,16840,0,17299,21,1
3449530,1907322,717,63,73648,0,74365,63,1
860473,238896,751,1,20450,0,21201,1,1
2827436,842583,882,1,271525,0,272407,1,1
4209323,1811834,1630,32,89460,0,91090,32,1
3257465,1791353,541,17,27614,0,28155,17,1
3641600,3770892,751,19,9269,0,10020,19,1
2827436,3189002,882,2,271525,0,272407,2,1
4451491,2952838,817,64,8836,0,9653,64,1
4209323,2958134,1630,28,89460,0,91090,28,1
2851109,1072106,450,1,98552,0,99002,1,1
2809094,867674,143,6,1851,0,1994,6,1
653164,3502047,106,1,1488,0,1594,1,1
3835618,956648,694,384,25433,0,26127,384,1
4183784,3763846,931,64,59894,0,60825,64,1
4169303,1307767,93,4,1967,0,2060,4,1
4519069,2474367,387,7,20799,0,21186,7,1
4272102,3891580,1608,10,104171,0,105779,10,1
4417382,3394675,477,9,512,0,989,9,1
1493489,3682817,523,314,17512,0,18035,314,1
3112136,2156148,406,100,41366,0,41772,100,1
3280389,1711249,1101,1,411419,0,412520,1,1
4656285,770547,1446,53,35428,0,36874,53,1
2285283,2442411,279,25,6799,0,7078,25,1
3361377,861330,4841,1,761793,0,766634,1,1
680662,1325591,365,63,5393,0,5758,63,1
1880135,526921,810,4,71924,0,72734,4,1
3280389,2607167,1101,7,411419,0,412520,7,1
1984622,3489789,145,1,20659,0,20804,1,1
2956957,2436781,79,689,655,9972,734,10661,1
1961449,2112626,53,14,129,0,182,14,1
3438576,2477648,3424,2,137753,0,141177,2,1
4534401,3971734,103,117,4125,0,4228,117,1
1805743,2494173,316,8,3694,0,4010,8,1
4078144,1721804,22,8,998,125,1020,133,1
4714664,2019442,150,20,908,0,1058,20,1
3137585,1843531,1196,80,77354,0,78550,80,1
1491183,2308770,67,652,1191,435,1258,1087,1
4209323,3756997,1630,211,89460,0,91090,211,1
3091232,4697355,82,9,261,0,343,9,1
3310125,4451905,90,6,330,0,420,6,1
1000106,2753652,972,1,2608,0,3580,1,1
1057351,962214,44,6,2235,0,2279,6,1
1816385,2430370,272,83,2945,0,3217,83,1
2851109,3789447,450,3,98552,0,99002,3,1
3603010,1418631,24,14,607,0,631,14,1
2198120,2758691,21,1,3083,0,3104,1,1
2687552,3641069,238,53,25574,0,25812,53,1
1788439,4745308,6,6,31,0,37,6,1
544230,462231,1532,86,60768,0,62300,86,1
3480239,1041558,9,31,292,0,301,31,1
3280389,2823438,1101,1,411419,0,412520,1,1
2654633,2686006,151,41,2699,0,2850,41,1
2337678,3832364,44,1353,352,0,396,1353,1
3294702,3942269,991,72,68888,0,69879,72,1
2981537,823218,1252,3,118718,0,119970,3,1
4460528,2270782,8,2,864,0,872,2,1
2516076,3902140,1455,31,77782,0,79237,31,1
1494665,3179648,668,89,37638,0,38306,89,1
792409,3162033,2,1,39,0,41,1,1
4234577,2814755,58,25,131,0,189,25,1
3438576,831770,3424,16,137753,0,141177,16,1
2826379,3218555,26,8,212,0,238,8,1
1353265,512254,128,1,6709,0,6837,1,1
1923250,1486483,23,3,177,0,200,3,1
2715611,4602520,73,50,1227,0,1300,50,1
1787075,135114,894,39,28305,0,29199,39,1
3473048,3177663,23,129,250,296,273,425,1
4272102,1878558,1608,43,104171,0,105779,43,1
2950311,1418718,807,1,85116,0,85923,1,1
1653268,1240019,183,177,5919,0,6102,177,1
2462345,3377792,68,1,1047,0,1115,1,1
2055544,1297144,141,4,2577,0,2718,4,1
3610598,2899721,380,3,17343,0,17723,3,1
2018499,755037,141,60,1786,0,1927,60,1
1890385,1785162,3,710,52,50,55,760,1
3691520,2120043,533,59,9121,0,9654,59,1
3531730,2113883,334,53,9763,0,10097,53,1
419362,100034,314,49,5584,0,5898,49,1
1534362,2803725,1531,82,105859,0,107390,82,1
2851109,3125342,450,1,98552,0,99002,1,1
379565,3842079,46,1,2516,0,2562,1,1
6618,855414,892,68,68849,1268,69741,1336,1
4238001,3827370,869,34,61161,0,62030,34,1
427805,104368,483,2,156906,0,157389,2,1
3361377,3483300,4841,1,761793,0,766634,1,1
1127093,173649,554,26,6014,0,6568,26,1
2674718,2474351,136,426,5233,0,5369,426,1
1207753,804204,533,44,9348,0,9881,44,1
4395662,2196769,77,2,407,0,484,2,1
46697,1847461,363,1211,3359,51149,3722,52360,1
4656285,2288718,1446,21,35428,0,36874,21,1
3438576,1088700,3424,4,137753,0,141177,4,1
2961801,4145158,1483,25,101962,0,103445,25,1
4106906,1331940,119,802,1068,32617,1187,33419,1
2163640,2872121,129,4,5750,0,5879,4,1
2441425,3823502,803,185,18561,0,19364,185,1
3881634,3157809,641,397,8471,1176,9112,1573,1
1436216,2768792,1068,419,68770,0,69838,419,1
1615854,3344781,286,34,2590,0,2876,34,1
3922910,3537563,36,109,275,0,311,109,1
2032442,2464959,109,47,10458,0,10567,47,1
1580988,1264584,2821,3,400133,0,402954,3,1
2445500,2051104,68,1,3239,0,3307,1,1
3235479,363126,999,75,66486,0,67485,75,1
4426843,4283654,39,551,148,206,187,757,1
3638272,4256275,2022,1,370904,0,372926,1,1
1735116,4825426,503,100,16146,0,16649,100,1
4619326,2922589,539,121,22721,0,23260,121,1
2911269,3363554,740,61,20606,0,21346,61,1
3438576,2866470,3424,22,137753,0,141177,22,1
1086912,428883,907,4,33396,0,34303,4,1
3734245,830537,915,20,34965,0,35880,20,1
4272102,3423840,1608,14,104171,0,105779,14,1
3065808,1721037,1235,177,82317,0,83552,177,1
4707650,286083,257,139,6619,0,6876,139,1
3995817,459123,34,15,231,0,265,15,1
4569293,1359970,191,79,5084,0,5275,79,1
907654,4408574,798,22,24575,0,25373,22,1
4153509,1094800,138,17,833,0,971,17,1
1216656,966122,244,23,798,0,1042,23,1
1601507,1855029,129,8,6006,0,6135,8,1
3764316,3260435,53,16,1015,0,1068,16,1
3127312,4137020,110,14,1528,0,1638,14,1
2348248,3094303,63,17,432,0,495,17,1
1533546,23402,703,219,22095,0,22798,219,1
4642569,1811242,872,1,27586,0,28458,1,1
4518123,1577354,300,79,6419,0,6719,79,1
2040749,821237,596,29,3834,0,4430,29,1
1580988,2612093,2821,6,400133,0,402954,6,1
560760,2893432,30,2,160,0,190,2,1
3438576,4561385,3424,5,137753,0,141177,5,1
527963,1019011,44,13,426,0,470,13,1
2666134,1637572,291,1,4395,0,4686,1,1
4731849,3858283,455,57,10886,0,11341,57,1
2260014,2032698,2466,41,98622,0,101088,41,1
3066330,4183784,97,931,2081,59894,2178,60825,1
2426489,504269,521,70,2911,0,3432,70,1
1494665,780562,668,1315,37638,1558,38306,2873,1
2405789,3547707,1010,76,93387,0,94397,76,1
1310598,4566691,111,10,1375,0,1486,10,1
2881894,3257424,211,8,7468,0,7679,8,1
2887240,2865767,1143,2,118405,0,119548,2,1
3873768,699401,449,68,35424,0,35873,68,1
3144238,4442238,326,447,28455,0,28781,447,1
4547438,423436,1291,211,25237,0,26528,211,1
3501482,1909998,522,2,28046,0,28568,2,1
4451491,4536929,817,533,8836,0,9653,533,1
4043216,2465437,24,5,1977,0,2001,5,1
530200,385062,2035,7,62809,0,64844,7,1
1580988,3179340,2821,10,400133,0,402954,10,1
1494665,243791,668,37,37638,0,38306,37,1
1128304,504676,80,921,292,2940,372,3861,1
3280389,3214648,1101,1,411419,0,412520,1,1
2454881,390709,11,47,621,0,632,47,1
4311646,3109206,55,762,415,0,470,762,1
21944,4675372,317,12,9419,0,9736,12,1
4423184,2210686,384,30,29809,0,30193,30,1
4330391,1272635,773,18,32759,0,33532,18,1
3271484,2573526,1507,222,34093,539,35600,761,1
3280389,3558404,1101,1,411419,0,412520,1,1
439557,921587,2090,1,61744,0,63834,1,1
4635332,4092635,90,1,2326,0,2416,1,1
3298300,4745767,128,108,4498,0,4626,108,1
2886330,485628,415,147,10154,0,10569,147,1
2405789,2474338,1010,28,93387,0,94397,28,1
2075015,2962017,2664,66,85781,0,88445,66,1
1884174,1745171,25,14,472,0,497,14,1
4653941,3629817,951,19,45883,0,46834,19,1
4866488,4261998,117,54,1117,462,1234,516,1
3235479,4181601,999,193,66486,0,67485,193,1
4115960,4097061,172,948,1656,0,1828,948,1
4295952,3883853,808,35,57369,0,58177,35,1
2309976,3635952,458,1,2527,0,2985,1,1
3441479,815975,97,36,810,0,907,36,1
4727207,3773495,925,82,84581,0,85506,82,1
3291396,2474351,195,426,11502,0,11697,426,1
2495609,1788177,103,32,2169,0,2272,32,1
2209136,3478130,620,29,33789,0,34409,29,1
2950311,760346,807,23,85116,0,85923,23,1
1189314,3514088,229,20,2366,0,2595,20,1
4247559,253756,47,165,1311,0,1358,165,1
3248738,4409105,102,64,4433,0,4535,64,1
4708835,1879371,190,3,7539,0,7729,3,1
3671141,4152886,1444,12,48400,0,49844,12,1
4272102,542767,1608,17,104171,0,105779,17,1
1261156,932181,153,22,1944,0,2097,22,1
2896906,1421686,1193,530,7172,0,8365,530,1
2774493,618961,551,11,12712,0,13263,11,1
121280,3128708,5,2,194,0,199,2,1
580157,418731,194,497,4890,0,5084,497,1
1503116,2989197,415,34,37079,0,37494,34,1
3021112,61047,472,21,6183,0,6655,21,1
593740,4211046,1107,32,62807,0,63914,32,1
1706005,176013,31,795,446,2,477,797,1
3280389,563886,1101,1,411419,0,412520,1,1
3638272,3413663,2022,1,370904,0,372926,1,1
1196844,3885921,548,111,36289,0,36837,111,1
2948092,3629817,412,19,18486,0,18898,19,1
3271484,3000894,1507,2,34093,0,35600,2,1
1887148,2074264,189,75,672,0,861,75,1
408965,701216,903,16,38623,0,39526,16,1
1250021,3827402,4637,6,85913,0,90550,6,1
4750855,413253,355,184,18880,0,19235,184,1
3361377,344783,4841,1,761793,0,766634,1,1
2653751,558854,18,118,78,0,96,118,1
2307868,2935094,1131,1,38777,0,39908,1,1
3849054,3183916,417,52,13259,0,13676,52,1
3638272,125847,2022,1,370904,0,372926,1,1
4577918,591176,54,711,993,300,1047,1011,1
1847461,1728630,1211,258,51149,0,52360,258,1
3387987,209857,268,77,19035,0,19303,77,1
3676295,3289315,374,2,70881,0,71255,2,1
4541993,92920,347,55,3610,0,3957,55,1
2314038,4335409,456,40,16347,0,16803,40,1
3873768,1837548,449,114,35424,0,35873,114,1
2388338,807640,8,51,169,0,177,51,1
2490914,4504027,570,20,22965,0,23535,20,1
144465,2150442,204,571,1758,0,1962,571,1
4238001,4593676,869,43,61161,0,62030,43,1
2578900,372033,143,21,1004,0,1147,21,1
4624595,4837630,722,7,53368,0,54090,7,1
781211,1306035,976,97,51781,0,52757,97,1
1984622,2748023,145,1,20659,0,20804,1,1
813554,3234416,252,3,17214,0,17466,3,1
3323519,1977324,133,21,4787,0,4920,21,1
2179466,4769528,158,469,863,0,1021,469,1
352729,17876,107,14,292,0,399,14,1
1075646,59603,21,283,280,12,301,295,1
4050480,1989026,422,1,4311,0,4733,1,1
52666,3883660,66,305,139,1465,205,1770,1
1207753,3544755,533,101,9348,0,9881,101,1
474172,4742682,471,9,38713,0,39184,9,1
4416945,2436918,417,30,33228,0,33645,30,1
1875,1337136,656,305,61388,0,62044,305,1
1092045,1220895,242,79,9359,0,9601,79,1
3633019,1128095,746,37,32317,0,33063,37,1
2343253,4200475,1882,4,86401,0,88283,4,1
1242778,2029980,163,2,2297,0,2460,2,1
3750255,3249749,18,16,176,0,194,16,1
3734245,3408727,915,43,34965,0,35880,43,1
4458957,166080,58,152,424,0,482,152,1
4191410,76116,1590,15,96434,0,98024,15,1
4108836,2629142,97,80,4234,0,4331,80,1
1580988,3356022,2821,20,400133,0,402954,20,1
3112136,3826847,406,31,41366,0,41772,31,1
2309976,44767,458,1,2527,0,2985,1,1
3552008,3237259,13,212,265,0,278,212,1
3650069,204193,217,121,4118,0,4335,121,1
2757495,3242976,6,63,234,161,240,224,1
1580988,37130,2821,65,400133,0,402954,65,1
513938,2929653,87,66,950,0,1037,66,1
1879936,983984,281,1,6786,0,7067,1,1
3361377,2395985,4841,1,761793,0,766634,1,1
3361377,183716,4841,1,761793,0,766634,1,1
1103332,2630002,732,37,59415,0,60147,37,1
4838376,1182709,606,11,26838,0,27444,11,1
2897926,624111,565,105,25983,0,26548,105,1
1086912,3386328,907,13,33396,0,34303,13,1
4440160,274855,736,26,20522,0,21258,26,1
3517811,321947,60,1,11929,0,11989,1,1
4221094,953695,63,40,658,0,721,40,1
1839283,2753676,765,50,36658,0,37423,50,1
2077019,3427057,38,1,1764,0,1802,1,1
1580988,2281863,2821,33,400133,0,402954,33,1
3510354,4126838,112,174,1842,0,1954,174,1
2405789,130626,1010,17,93387,0,94397,17,1
4117427,4195722,329,66,9639,0,9968,66,1
2569009,4262061,424,31,13423,0,13847,31,1
1086912,2524417,907,16,33396,0,34303,16,1
4526732,3973592,24,11,148,0,172,11,1
3707999,2069614,92,4,971,0,1063,4,1
4068910,1542479,131,164,1470,0,1601,164,1
3280389,1031860,1101,1,411419,0,412520,1,1
380998,421933,200,38,8943,0,9143,38,1
2028435,1352724,157,20,4516,0,4673,20,1
2260014,2000492,2466,18,98622,0,101088,18,1
1927211,1592750,1668,41,113322,0,114990,41,1
2793437,3436073,582,2,25447,0,26029,2,1
2042569,2407168,358,115,1959,0,2317,115,1
184734,4341858,68,15,1084,0,1152,15,1
1580508,1722897,720,64,19611,0,20331,64,1
4220190,4692495,320,26,15994,0,16314,26,1
354904,3072586,3193,39,105780,0,108973,39,1
4295952,4263817,808,7,57369,0,58177,7,1
4191727,123464,463,91,26315,0,26778,91,1
519175,2744350,173,108,7221,0,7394,108,1
1880135,103933,810,57,71924,0,72734,57,1
3280389,2851254,1101,2,411419,0,412520,2,1
1497278,1780738,1869,60,35111,0,36980,60,1
471706,2115380,794,25,65616,0,66410,25,1
4144037,1542080,36,35,779,0,815,35,1
2108878,2136227,78,56,4399,0,4477,56,1
3639118,852813,268,16,974,98,1242,114,1
3294702,4682767,991,46,68888,0,69879,46,1
4479158,2962391,185,2532,1447,241,1632,2773,1
805360,2521469,1514,51,119306,0,120820,51,1
3361377,1487745,4841,3,761793,0,766634,3,1
4676944,828165,35,25,1314,0,1349,25,1
1219267,4405333,238,18,1605,0,1843,18,1
4567264,3245687,47,1,456,0,503,1,1
3438576,2927690,3424,3,137753,0,141177,3,1
1178789,3808839,21,63,103,151,124,214,1
1151593,1346050,231,20,5501,0,5732,20,1
2159244,764497,102,230,1434,0,1536,230,1
3361377,1555245,4841,4,761793,0,766634,4,1
3509903,360281,1530,1,509445,0,510975,1,1
4781147,1259401,161,226,2894,0,3055,226,1
1817799,511075,402,40,15932,0,16334,40,1
3361377,3302531,4841,2,761793,0,766634,2,1
1339861,2195894,200,133,1212,0,1412,133,1
2416388,3854832,77,23,465,219,542,242,1
2022081,4015021,143,14,1466,0,1609,14,1
1346115,41600,119,256,1292,582,1411,838,1
3438576,405180,3424,8,137753,0,141177,8,1
1471685,3205512,1681,7,25550,0,27231,7,1
4304056,2659942,164,244,12698,0,12862,244,1
3691520,2563456,533,91,9121,0,9654,91,1
3361377,2049248,4841,1,761793,0,766634,1,1
1654099,4255715,1180,81,26347,0,27527,81,1
1575009,359620,429,19,37745,0,38174,19,1
3051212,3607252,957,142,8349,0,9306,142,1
3460849,4442827,216,83,2518,0,2734,83,1
3765475,1147918,873,7,107914,0,108787,7,1
4087774,44841,578,37,10107,0,10685,37,1
3206499,2537798,1337,1,32033,0,33370,1,1
6618,1261241,892,2,68849,0,69741,2,1
3361377,5109,4841,1,761793,0,766634,1,1
1100354,137423,163,1,24439,0,24602,1,1
1377457,4480352,111,88,675,622,786,710,1
2405789,2018318,1010,108,93387,0,94397,108,1
273363,1890346,768,88,11045,0,11813,88,1
607449,4523954,380,30,19369,0,19749,30,1
1567043,1400153,40,2,1448,0,1488,2,1
4416945,3942341,417,96,33228,0,33645,96,1
1787075,687154,894,51,28305,0,29199,51,1
2261139,604438,2014,4,42851,0,44865,4,1
837553,4264611,1249,31,61665,0,62914,31,1
4191410,1589586,1590,49,96434,0,98024,49,1
2981537,2278609,1252,9,118718,0,119970,9,1
3361377,3516084,4841,1,761793,0,766634,1,1
3638272,4235480,2022,45,370904,0,372926,45,1
3280389,4449928,1101,1,411419,0,412520,1,1
3638272,2391885,2022,1,370904,0,372926,1,1
805360,4202586,1514,70,119306,0,120820,70,1
283907,2539323,401,367,1992,0,2393,367,1
4069776,1610352,64,6,1955,0,2019,6,1
4451122,2616477,985,268,41669,0,42654,268,1
462298,876360,414,83,10933,0,11347,83,1
649105,2712521,152,119,1548,0,1700,119,1
4853234,2300424,1256,14,29554,0,30810,14,1
3280389,2249300,1101,3,411419,0,412520,3,1
4295952,1585381,808,33,57369,0,58177,33,1
4754953,28690,98,1,497,0,595,1,1
948768,2359852,587,60,14768,0,15355,60,1
2827436,304843,882,2,271525,0,272407,2,1
986349,547435,13,1,268,0,281,1,1
2981537,4684078,1252,10,118718,0,119970,10,1
269982,1074056,351,84,9019,0,9370,84,1
854182,3502126,79,1,1148,0,1227,1,1
3854592,571513,108,4,3483,0,3591,4,1
2356664,1349178,273,272,6808,0,7081,272,1
1588330,461794,694,93,10280,0,10974,93,1
802229,1927737,168,38,3140,0,3308,38,1
2107861,100652,535,8,25743,0,26278,8,1
646475,2466638,210,1,3552,0,3762,1,1
4125527,1836934,305,53,1880,317,2185,370,1
3361377,3058019,4841,15,761793,0,766634,15,1
631204,2388859,126,89,1746,0,1872,89,1
2261139,3293124,2014,23,42851,0,44865,23,1
4110535,2842911,395,320,7311,0,7706,320,1
2212117,3603092,43,7,6252,0,6295,7,1
2498895,3173224,401,137,1909,0,2310,137,1
2593461,1425245,27,7,1262,0,1289,7,1
232646,4125081,321,69,1741,0,2062,69,1
422275,874472,101,83,4142,0,4243,83,1
2881894,2007682,211,132,7468,0,7679,132,1
3280389,2287649,1101,1,411419,0,412520,1,1
4236325,2009870,372,1,6103,0,6475,1,1
1301815,202864,752,4,48944,0,49696,4,1
1927780,3688311,420,67,6230,0,6650,67,1
2168218,4192921,404,25,3126,0,3530,25,1
3066330,2809360,97,148,2081,0,2178,148,1
4708539,276600,37,27,331,0,368,27,1
2454128,4549248,130,280,802,907,932,1187,1
3438576,1053416,3424,10,137753,0,141177,10,1
17330,1802616,154,48,972,0,1126,48,1
4249983,552722,679,10,16076,0,16755,10,1
3517811,3763884,60,9,11929,0,11989,9,1
3242275,813835,551,14,17400,0,17951,14,1
3031885,3852493,2,1,291,0,293,1,1
3280389,2502293,1101,1,411419,0,412520,1,1
2260014,141657,2466,52,98622,0,101088,52,1
2887240,610432,1143,1,118405,0,119548,1,1
3765475,628616,873,10,107914,0,108787,10,1
2107861,1545398,535,11,25743,0,26278,11,1
2692067,2193141,98,55,1704,0,1802,55,1
3514277,1224001,1338,457,13269,0,14607,457,1
1422134,1318959,41,47,534,0,575,47,1
3916976,2940588,188,554,6098,9477,6286,10031,1
4485028,4572340,445,145,14565,0,15010,145,1
2405789,1264433,1010,67,93387,0,94397,67,1
1163500,3627361,398,30,9540,0,9938,30,1
2887240,1415077,1143,94,118405,0,119548,94,1
692267,4340682,52,18,38,0,90,18,1
4209323,1492807,1630,22,89460,0,91090,22,1
3638272,774322,2022,2,370904,0,372926,2,1
2827436,3282457,882,21,271525,0,272407,21,1
354904,3350913,3193,8,105780,0,108973,8,1
3539650,4201649,194,33,2264,0,2458,33,1
1534362,1513589,1531,312,105859,0,107390,312,1
1927211,939772,1668,63,113322,0,114990,63,1
388875,2113629,112,112,3598,0,3710,112,1
4526614,1496812,162,4,750,0,912,4,1
3614938,2232723,955,15,641,0,1596,15,1
2276175,953816,262,102,4860,0,5122,102,1
4011264,2309753,1360,48,116777,0,118137,48,1
1559783,1539837,204,1127,1917,62979,2121,64106,1
4011264,212279,1360,24,116777,0,118137,24,1
3280389,947179,1101,4,411419,0,412520,4,1
3638272,2946184,2022,3,370904,0,372926,3,1
3280389,4439742,1101,1,411419,0,412520,1,1
2757156,4701919,237,94,8153,0,8390,94,1
3144238,3582973,326,2,28455,0,28781,2,1
2147720,3715735,1608,26,78786,0,80394,26,1
161946,2862019,107,903,834,57,941,960,1
2751572,4623104,481,234,44036,0,44517,234,1
2222138,2739852,94,65,2357,0,2451,65,1
2399369,247860,71,8,857,0,928,8,1
3361377,2623592,4841,105,761793,0,766634,105,1
690098,3976289,261,14,2591,0,2852,14,1
3638272,1599210,2022,1,370904,0,372926,1,1
318999,4074721,134,4,394,0,528,4,1
3683235,2437923,311,61,23110,0,23421,61,1
1575009,3272040,429,167,37745,0,38174,167,1
1053177,1934493,293,197,3060,0,3353,197,1
2861639,2633801,481,7,10848,0,11329,7,1
3765475,589718,873,87,107914,0,108787,87,1
2827436,416019,882,3,271525,0,272407,3,1
4272102,1194667,1608,61,104171,0,105779,61,1
1330325,1755215,63,73,95,0,158,73,1
849756,670587,91,651,531,9779,622,10430,1
2950311,2660469,807,62,85116,0,85923,62,1
3361377,1442523,4841,1,761793,0,766634,1,1
2230342,1128431,30,2,3940,0,3970,2,1
607449,2361536,380,88,19369,0,19749,88,1
1392192,1722056,18,10,194,0,212,10,1
3561502,2762199,1144,9,68800,0,69944,9,1
1591435,1811908,387,104,31245,0,31632,104,1
1276253,1520261,407,3,46534,0,46941,3,1
4191410,225179,1590,16,96434,0,98024,16,1
1580988,4019001,2821,2,400133,0,402954,2,1
3759853,4632767,451,53,16330,0,16781,53,1
3298299,280883,181,97,4843,0,5024,97,1
4272102,3790415,1608,65,104171,0,105779,65,1
873006,3492580,375,48,33630,0,34005,48,1
3387987,2464278,268,148,19035,0,19303,148,1
2105917,3471102,59,120,348,0,407,120,1
2625403,3132939,117,1196,682,481,799,1677,1
3206499,4439813,1337,92,32033,0,33370,92,1
1392121,3961433,904,334,3808,0,4712,334,1
1318501,3150409,117,10,1335,0,1452,10,1
2755798,2552549,494,2,24862,0,25356,2,1
3157597,3831349,183,222,10247,0,10430,222,1
2092359,4195832,421,19,26936,0,27357,19,1
3280389,881181,1101,35,411419,0,412520,35,1
3578463,3687404,240,115,4104,0,4344,115,1
802229,1143779,168,28,3140,0,3308,28,1
2687552,3106839,238,204,25574,0,25812,204,1
2260014,1392289,2466,16,98622,0,101088,16,1
4689740,3361553,50,9,686,0,736,9,1
431709,2161961,205,182,5602,0,5807,182,1
471706,3071998,794,156,65616,0,66410,156,1
537240,3484071,131,195,779,0,910,195,1
3506612,3502696,119,147,1034,1165,1153,1312,1
2885394,3672315,174,55,3481,0,3655,55,1
1633022,1759441,246,3,23530,0,23776,3,1
2887240,2746169,1143,2,118405,0,119548,2,1
4785101,4036838,150,31,1988,0,2138,31,1
1539837,4266757,1127,62,62979,0,64106,62,1
2887240,3051584,1143,2,118405,0,119548,2,1
2212117,259794,43,3,6252,0,6295,3,1
2823179,2246438,505,50,6744,0,7249,50,1
1903752,3178983,506,88,10494,0,11000,88,1
567973,1608093,91,27,442,0,533,27,1
3561502,3504995,1144,28,68800,0,69944,28,1
787416,1363305,115,1,9954,0,10069,1,1
1431076,3046865,167,22,1978,0,2145,22,1
2666134,1196403,291,363,4395,2062,4686,2425,1
3509903,1490583,1530,1,509445,0,510975,1,1
4417253,1043592,1130,33,68389,0,69519,33,1
2482338,1039523,712,26,24222,0,24934,26,1
3719638,112337,5,57,133,58,138,115,1
3517811,3796285,60,1,11929,0,11989,1,1
2886092,2892143,42,31,437,0,479,31,1
1325245,4057434,144,66,5103,0,5247,66,1
2337375,3541074,143,213,1815,0,1958,213,1
3347565,3316702,144,54,1425,0,1569,54,1
584906,4413137,253,309,6639,0,6892,309,1
3509903,2918324,1530,6,509445,0,510975,6,1
1302685,1826786,237,113,2420,0,2657,113,1
1903981,4119288,113,12,2678,0,2791,12,1
1977657,3635924,141,21,1990,0,2131,21,1
2348093,3138154,335,8,12064,0,12399,8,1
3836080,2849710,1197,92,59457,0,60654,92,1
2662809,4341841,303,2,10704,0,11007,2,1
474172,1064889,471,30,38713,0,39184,30,1
687713,3478443,436,16,47160,0,47596,16,1
4668431,3239789,8,3,40,0,48,3,1
3304218,2769604,127,202,447,0,574,202,1
1086912,3426794,907,35,33396,0,34303,35,1
2772113,1424416,792,46,42907,0,43699,46,1
2981537,4441697,1252,3,118718,0,119970,3,1
4417253,3673556,1130,13,68389,0,69519,13,1
1331940,2139977,802,300,32617,0,33419,300,1
4295952,576700,808,33,57369,0,58177,33,1
3765475,376122,873,5,107914,0,108787,5,1
3361377,1929636,4841,1,761793,0,766634,1,1
2950311,3057622,807,2,85116,0,85923,2,1
457215,4459038,223,20,1057,0,1280,20,1
1992385,4563684,186,277,399,1011,585,1288,1
1633022,2167888,246,1,23530,0,23776,1,1
3987684,423682,286,59,17372,0,17658,59,1
2781817,4680013,704,38,24613,0,25317,38,1
445996,1053179,1175,2,12828,0,14003,2,1
1326428,167635,153,4,2569,0,2722,4,1
4467395,2079607,2084,349,14574,0,16658,349,1
1717922,3309373,432,12,6340,72,6772,84,1
401947,1978107,367,9,7890,0,8257,9,1
2391232,4685898,9,1,172,0,181,1,1
2261139,1655924,2014,23,42851,0,44865,23,1
2261139,4506135,2014,91,42851,0,44865,91,1
1927974,4741001,107,38,9317,0,9424,38,1
544230,855479,1532,201,60768,0,62300,201,1
572390,4309505,91,3,3173,0,3264,3,1
2827436,1884851,882,2,271525,0,272407,2,1
2851109,487614,450,5,98552,0,99002,5,1
4254735,3378063,29,92,341,759,370,851,1
4727207,963765,925,9,84581,0,85506,9,1
3361377,4612002,4841,2,761793,0,766634,2,1
2884705,2886167,649,56,10233,0,10882,56,1
1580988,2196823,2821,5,400133,0,402954,5,1
1875,1378800,656,14,61388,0,62044,14,1
2887240,4829352,1143,3,118405,0,119548,3,1
389487,1331335,217,2,411,0,628,2,1
3405059,1179548,261,33,9604,0,9865,33,1
3588630,3192416,351,49,7803,0,8154,49,1
427805,2784269,483,1,156906,0,157389,1,1
580157,2312765,194,50,4890,0,5084,50,1
3672238,1762904,518,203,12172,0,12690,203,1
4360960,2833103,1642,70,110084,0,111726,70,1
3736196,3456488,159,122,1349,0,1508,122,1
1064989,654377,140,35,1201,0,1341,35,1
1735116,1078218,503,77,16146,0,16649,77,1
4295952,1748570,808,42,57369,0,58177,42,1
2718230,1745698,417,45,2462,0,2879,45,1
504676,3092943,921,352,2940,2435,3861,2787,1
3802719,3442768,91,363,3170,0,3261,363,1
2516076,3465218,1455,41,77782,0,79237,41,1
3638272,3746035,2022,1,370904,0,372926,1,1
3438576,3980417,3424,46,137753,0,141177,46,1
1262549,4653398,40,432,1220,0,1260,432,1
1249227,2350333,621,8,7423,0,8044,8,1
3906136,920609,387,113,41169,0,41556,113,1
3846144,3599967,40,3,208,0,248,3,1
2886626,4529320,192,41,6077,0,6269,41,1
3638272,4591728,2022,3,370904,0,372926,3,1
3280389,3873267,1101,2,411419,0,412520,2,1
3509903,4139304,1530,1,509445,0,510975,1,1
2627841,1445600,418,13,12342,0,12760,13,1
354904,3042868,3193,228,105780,0,108973,228,1
3280389,677094,1101,1,411419,0,412520,1,1
4318206,2357676,251,93,13123,0,13374,93,1
3361377,1761327,4841,1,761793,0,766634,1,1
1927211,4107553,1668,2,113322,0,114990,2,1
3280389,3879656,1101,2,411419,0,412520,2,1
2031305,1058450,396,156,23435,0,23831,156,1
3509903,2364661,1530,2,509445,0,510975,2,1
1377,2040393,92,57,788,0,880,57,1
4019064,3613290,70,37,1398,0,1468,37,1
2772113,1235945,792,325,42907,0,43699,325,1
2092359,4395805,421,4,26936,0,27357,4,1
3472348,3538258,71,45,203,60,274,105,1
245479,585084,473,874,4348,0,4821,874,1
1880135,1840161,810,48,71924,0,72734,48,1
2677230,1730583,90,38,1208,0,1298,38,1
3288730,860952,117,130,4627,0,4744,130,1
439557,3588907,2090,116,61744,0,63834,116,1
3638272,2564369,2022,21,370904,0,372926,21,1
253352,1683237,237,121,10413,0,10650,121,1
153871,3398161,333,101,3892,0,4225,101,1
4738916,731241,1165,4,34124,0,35289,4,1
1769943,4332606,553,30,7901,0,8454,30,1
3633019,1873664,746,72,32317,0,33063,72,1
2405789,282721,1010,110,93387,0,94397,110,1
3509903,3967469,1530,3,509445,0,510975,3,1
2861639,3574841,481,92,10848,0,11329,92,1
3069382,3053692,113,18,5201,0,5314,18,1
4123758,105495,216,225,4336,0,4552,225,1
3765475,4712315,873,3,107914,0,108787,3,1
3280389,2989023,1101,1,411419,0,412520,1,1
3509903,3850075,1530,1,509445,0,510975,1,1
3316788,2771626,20,1,1710,0,1730,1,1
4451122,362296,985,28,41669,0,42654,28,1
3361377,1416047,4841,1,761793,0,766634,1,1
2751572,3047518,481,56,44036,0,44517,56,1
1234540,3901236,1071,82,75251,0,76322,82,1
3280389,1982325,1101,26,411419,0,412520,26,1
1353265,3872491,128,5,6709,0,6837,5,1
2827436,3810215,882,1,271525,0,272407,1,1
1341178,791906,899,29,16829,0,17728,29,1
474172,2446635,471,13,38713,0,39184,13,1
4257751,3175019,109,2,8420,0,8529,2,1
3438576,3310093,3424,18,137753,0,141177,18,1
1637447,1497872,555,35,8549,0,9104,35,1
1534362,4527078,1531,48,105859,0,107390,48,1
3280389,3208638,1101,4,411419,0,412520,4,1
3280389,3314392,1101,3,411419,0,412520,3,1
3936176,2941874,207,27,283,0,490,27,1
3137487,1106938,55,66,675,0,730,66,1
837572,865624,70,106,1973,0,2043,106,1
3361377,4345465,4841,2,761793,0,766634,2,1
3384159,791021,415,15,6659,0,7074,15,1
307250,3047536,919,24,35588,0,36507,24,1
1086912,4501053,907,7,33396,0,34303,7,1
3361377,2475119,4841,1,761793,0,766634,1,1
767753,3137585,12,1196,74,77354,86,78550,1
2617350,2674549,256,22,6547,0,6803,22,1
1086912,2011899,907,26,33396,0,34303,26,1
4330391,237457,773,43,32759,0,33532,43,1
1087655,3549053,451,52,3037,0,3488,52,1
3971661,2086284,148,173,529,630,677,803,1
4515355,4604582,21,1,8176,0,8197,1,1
3134846,3157183,69,601,5634,0,5703,601,1
2361583,3352587,116,54,295,0,411,54,1
3361377,1370461,4841,5,761793,0,766634,5,1
3361377,1801389,4841,1,761793,0,766634,1,1
4599198,1330694,44,14,2081,0,2125,14,1
4624595,3420934,722,130,53368,0,54090,130,1
4330391,10490,773,29,32759,0,33532,29,1
2778813,703059,111,96,4665,0,4776,96,1
1769943,1717452,553,29,7901,0,8454,29,1
1927211,4243788,1668,31,113322,0,114990,31,1
932720,4802989,1411,72,111323,0,112734,72,1
4148104,294165,19,36,1379,0,1398,36,1
4370551,1478053,31,2,730,0,761,2,1
1927974,777925,107,61,9317,0,9424,61,1
1537492,504388,175,1,6621,0,6796,1,1
2906370,735103,271,7,4802,0,5073,7,1
577580,1315689,187,114,3831,0,4018,114,1
2887240,202593,1143,2,118405,0,119548,2,1
4744878,180594,68,22,1896,0,1964,22,1
2309618,2405451,980,124,5354,2161,6334,2285,1
2877907,2724495,508,29,16021,0,16529,29,1
1063358,2691187,1350,24,63494,0,64844,24,1
2147720,3319242,1608,144,78786,0,80394,144,1
4653941,3411169,951,37,45883,0,46834,37,1
315254,2358902,99,103,3983,0,4082,103,1
3280389,4282721,1101,3,411419,0,412520,3,1
4653941,1315724,951,16,45883,0,46834,16,1
3569617,3420239,160,165,3695,0,3855,165,1
2827436,2279169,882,18,271525,0,272407,18,1
1063358,3813425,1350,116,63494,0,64844,116,1
932720,1240482,1411,157,111323,0,112734,157,1
3438576,3852979,3424,14,137753,0,141177,14,1
1861462,4585391,768,46,601,0,1369,46,1
3524073,3234490,157,33,3319,0,3476,33,1
2075015,31183,2664,44,85781,0,88445,44,1
4825760,3439447,111,320,1979,0,2090,320,1
3691520,4652948,533,58,9121,0,9654,58,1
4624595,133851,722,38,53368,0,54090,38,1
2950311,2008645,807,89,85116,0,85923,89,1
4721617,2488010,307,208,12885,0,13192,208,1
3501482,3499351,522,251,28046,0,28568,251,1
2394976,2343935,335,1,10973,0,11308,1,1
135188,128099,51,57,5860,0,5911,57,1
1863381,4814108,208,275,1885,0,2093,275,1
4183784,772716,931,42,59894,0,60825,42,1
64321,1263199,263,5,959,0,1222,5,1
2045898,3500435,87,254,531,0,618,254,1
4157437,3249563,87,70,564,0,651,70,1
2887240,4559066,1143,1,118405,0,119548,1,1
1451829,909298,44,59,473,0,517,59,1
1734954,1686458,369,6,5786,0,6155,6,1
3501136,4060393,89,3,492,0,581,3,1
2497238,4430338,251,6,2806,0,3057,6,1
2950311,44902,807,29,85116,0,85923,29,1
2107861,3956902,535,10,25743,0,26278,10,1
805360,776980,1514,5,119306,0,120820,5,1
1103332,3811858,732,8,59415,0,60147,8,1
3676295,4213483,374,1,70881,0,71255,1,1
1711479,1836958,116,48,1032,0,1148,48,1
4181760,4121518,359,276,7855,0,8214,276,1
4527016,2916844,187,37,1921,0,2108,37,1
